----------------------------------------------------------------------------------------------------------------------------------------------------------------------------------------------------------
----------------------------------------------------------------------------------------------------------------------------------------------------------------------------------------------------------
----------------------------------------------------------------------------------------------------------------------------------------------------------------------------------------------------------
----------------------------------------------------------------------------------------------------------------------------------------------------------------------------------------------------------
----------------------------------------------------------------------------------------------------------------------------------------------------------------------------------------------------------
----------------------------------------------------------------------------------------------------------------------------------------------------------------------------------------------------------
-------S!!S------------------------------------------------S!!S------------------------------------------------S!!S------------------------------------------------S!!S-----------------------------------
----------------------------------------------------------------------------------------------------------------------------------------------------------------------------------------------------------
----------------------------------------------------------------------------------------------------------------------------------------------------------------------------------------------------------
----------------------------------------------------------------------------------------------------------------------------------------------------------------------------------------------------------
--------SS------#--#----------##--#------------SS!S---------SS------#--#----------##--#------------SS!S---------SS------#--#----------##--#------------SS!S---------SS------#--#----------##--#-----------
---------------##--##--------###--##-------------------------------##--##--------###--##-------------------------------##--##--------###--##-------------------------------##--##--------###--##----------
--------------###--###------####--###-----tt----------------------###--###------####--###-----tt----------------------###--###------####--###-----tt----------------------###--###------####--###-----tt--
-M-gg-g-g----####--####----#####--####----tt---------gggg-g-g----####--####----#####--####----tt---------gggg-g-g----####--####----#####--####----tt---------gggg-g-g----####--####----#####--####----tt--
XXXXXXXXXXXXXXXXXXXXXXXXXXXXXXXX--XXXXXXXXXXXXXXXXXXXXXXXXXXXXXXXXXXXXXXXXXXXXXXXXXX--XXXXXXXXXXXXXXXXXXXXXXXXXXXXXXXXXXXXXXXXXXXXXXXXXX--XXXXXXXXXXXXXXXXXXXXXXXXXXXXXXXXXXXXXXXXXXXXXXXXXX--XXXXXXXXXXXX
XXXXXXXXXXXXXXXXXXXXXXXXXXXXXXXX--XXXXXXXXXXXXXXXXXXXXXXXXXXXXXXXXXXXXXXXXXXXXXXXXXX--XXXXXXXXXXXXXXXXXXXXXXXXXXXXXXXXXXXXXXXXXXXXXXXXXX--XXXXXXXXXXXXXXXXXXXXXXXXXXXXXXXXXXXXXXXXXXXXXXXXXX--XXXXXXXXXXXX
