-------------------------------------------------------------------------------------------------------------------------
-------------------------------------------------------------------------------------------------------------------------
-------------------------------------------------------------------------------------------------------------------------
-------------------------------------------------------------------------------------------------------------------------
-------------------------------------------------------------------------------------------------------------------------
-------------------------------------------------------------------------------------------------------------------------
----!----------------------------------------------------------------------------------------------!---------------------
----------------------------------------------------------------------------1--------------------------------------------
---------------------------------------------------------------------tt------------#-------------------------------------
--------------------------------------------------------!---S@S!S----tt------------##------------------------------------
--!---S@S----tt!----------------!-----------tt------------------------------C------###-----SS----------------------------
-------------tt-----------------------------tt------tt-------------###------------####-------------------####------------
-------------tt---tt------------------------tt-#----tt-------------###------------####---------------tt--####-tt-#-------
-M--g--------ttk--tt---gg-g-----g-g---------tt------g-----gg-------####gg-g--g----####---------------tt--####-tt##-------
XXXXXXXXXXXXXXXXXXXXXXXXXXXXXXXXXXXXXXXXXXXXXXXXXXXXXXXXXXXXXXXXXXXXXXXXXXXXXXXXXXXXXXXXXXXXX-XXXXXXXXXXXXXXXXXXXXXXXXX--
XXXXXXXXXXXXXXXXXXXXXXXXXXXXXXXXXXXXXXXXXXXXXXXXXXXXXXXXXXXXXXXXXXXXXXXXXXXXXXXXXXXXXXXXXXXXX-XXXXXXXXXXXXXXXXXXXXXXXXX--
