---------------------------------------------------------------------------------------------------------------------------------
---------------------------------------------------------------------------------------------------------------------------------
------------------------------------------S!!S-----------------------------------------------------------------------------------
-------------------------g-------------------------------------------------------------------------------------------------------
-----------------------SSSSSSSS--------------------------------------------------------------------------------------------------
---------------------------------------------------------------------------------------------------------------------------------
----------------------g--------------------SS---------------------------------------@--------------------------------------------
----------------------------------------------------------------------------#----------------------------------------------------
------------g---------------------------------------------------------------#--------------------------!-------------##----------
----------SSSSSSSS----------SS----------------------------------------##----#---------------------------------------###----------
-------------------------------------!-!---S@S!S---#-----------------###---S@-----tt!--!---------------------------####----------
---------g-----------------------------------------##---------------####-----#----tt---------------------###--##--#########------
-----#---------------------------------------------###-------tt-#--#####-------tt------------------------###--##-##########------
-M--------gg-g-g----#----------------k---g-g-------###-------tt##-######-------tt----------------k-------###--####-----####------
XXXXXXXXXXXXXXXXXXXXXXXXXXXXXXXXX-XXXXXXXXXXXXXXX--XXX-XXXXXXXXXXXXXXXXXXXXXXXXXXXXXXXXXXXXXXXXXXXXXXXXXXXXXXXXXXXXXXXXXXXX-XXXXX
XXXXXXXXXXXXXXXXXXXXXXXXXXXXXXXXX-XXXXXXXXXXXXXXX--XXX-XXXXXXXXXXXXXXXXXXXXXXXXXXXXXXXXXXXXXXXXXXXXXXXXXXXXXXXXXXXXXXXXXXXX-XXXXX
