-----------------------------------------------------------------------------------------------------------------------------------------------------------
-----------------------------------------------------------------------------------------------------------------------------------------------------------
-----------------------------------------------------------------------------------------------------------------------------------------------------------
-----------------------------------------------------------------------------------------------------------------------------------------------------------
-----------------------------------------------------------------------------------------------------------------------------------------------------------
--------SU--!---S------------------------------------------------------------------------------------------------------------------------------------------
-----------------------------------------------------------------------------------------------------------------------------------------------------------
-----------------------------------------------------------------------------------------------------------------------------------------------------------
-------------------------------------SU--------------------------------------------------------------------------------------------------------------------
-!---S@S!S--------------!--------------------------------------------------------------------------------------SSS-----------------S!!S----------!---------
------------S@S-----------------------------------------S!!S-----------SS-----------------!-----------------t----------------------------------------------
----------------------------------###---!---S@S!S-----------------------------------------------------------t----------------------------------------------
---------------------------------####-----------------------------------------------------------------------t----------------------------------------------
-M--------------g-g--------------####------------------------------------------------####-------g-g---------tt-####---#--#------!---S@S!S------------------
XXXXXXXXXX-XXXXXXXXXXXXXXXX-XXXXXXXXXXXXXXXXXXXXXXXXXXXXXXXXXX-XXXXX-XXXXXXXXXX-XXXXXXXXX-XXXXXXXXXXXXXXXXXXXXXXXXX--##--##--------------------------------
XXXXXXXXXX-XXXXXXXXXXXXXXXX-XXXXXXXXXXXXXXXXXXXXXXXXXXXXXXXXXX-XXXXX-XXXXXXXXXX-XXXXXXXXX-XXXXXXXXXXXXXXXXXXXXXXXXX-###--###-------------------------------
