-----------------------------------------------------------------------------------------------------------------------------
--------------------------C--------------------------------------------------------------------------------------------------
-----------------------------------------------------------------------------------------------------------------------------
-----------------------------------------------------------------------------------------------------------------------------
------------------------------------------------SSS!-------------------------------------------------------------------------
----------------------!---S@S------------------------------------------------------------------------------------------------
--------------------------------------------------------------------@----!---------------------------------------------------
------------------SSS--------------------------------------------------------------------------------------------------------
--------##---------------S@S-----------------------C-------------------------------------------------------------------------
-------###-------------------------------------------------------------------------------------------------------------------
------####--------------------------tt------------------------------!--!-C-----------------------!---------------------------
-----#####----gg---g----------------tt---tt--###--####-----------------------------------------------------------------------
----######---XXXXXXXXXXXXXXXXXXXXXXXXXXX-tt--###--####----------tt-------------------tt-#-------------tt------------tt---F---
-M-####g----#XXXXXXXXXXXXXXXXXXXXXXXXXXX-tt-g###--####-----#----tt--------g-----gg---tt##--------k----tt------------tt---#---
XXXXXXXXXXXXX---------------------------XXXXXXXXXXXXXXXXXXX---------XXXXXXXXXXXXXXXXXXXXXXXXXXXXXXXXXXXXXXXXXXXXX-XXXXXXXXXXX
XXXXXXXXXXXXX---------------------------XXXXXXXXXXXXXXXXXXX--XXXXXXXXXXXXXXXXXXXXXXXXXXXXXXXXXXXXXXXXXXXXXXXXXXXX-XXXXXXXXXXX
