-------------------------------------------------------------------------------------------------------------------------------------------
-------------------------------------------------------------------------------------------------------------------------------------------
-----------------------------------------------------------------------------------------------------------------------------------SSS!----
-------------------------------------------------------------------------------------------------------------------------------------------
-------------------------------------------------------------------------------------------------------------------------------------------
-------------------------------------------------------------------------------------------------------------------------------------------
--------------------------------------------------------------------------------------------------------------------------------------C----
-------------------------------------------------------------------------------------------------------------------------------------------
-------------------------------------------------------------------------------------------------------------------------------------------
-----SSS----------------------------------1------S--#-------------------##--------------------------------------##-------------------------
---------------------------------#-tt---------------##-----------------###-----------------------!-------SU----###-------------------------
--------###---------------------##-tt---tt----------###---------------####-----tt-----------------------------####-------tt----------------
--------###-----------------tt-###-gg-g-tt----------###------------g----###----tt--gg------------------------#####--#----tt------------tt--
-M------###------------#----tt-###-XXXXXXXXXXXXXXX--XXXXXXXXXXXXX--XXXXXX------g--XXXXX---gg-----k----------######---###-g-------------tt--
XXXXXXXXXXXXXXXXXXXXXXX-----g-gXXXXXXXXXXXXXXXXXXX--XXXXXXXXXXXXX--XXXXXXXXXXXXXXXXXXXXXXXXXXXXXXXXXXXXXXXXXXXXXXXX--XXXXXXXXXXXXXXXXXXXXXX
XXXXXXXXXXXXXXXXXXXXXXX----XXXXXXXXX----------------------------------XXXXXXXXXXXXXXXXXXXXXXXXXXXXXXXXXXXXXXXXXXXXX--XXXXXXXXXXXXXXXXXXXXXX
