--------------------------------------------------------------------------------------------------------------------------------------------
---------------------------------------------------tt--------------------S!-----------------------------------------------------------------
---------------------------------------------------tt---------------------------------------------------------------------------------------
---------------------------------------------------tt---------------------------------------------------------------g----------####---------
-----------------------------------------------###----------------------------------------------------------------SSSSSSS-----#####---------
-------------------#------S@S!S-S@------------####-----!--!--------!S-----C---##---------------------------------------------######---------
-------------------##------------------------#####---------------------------###-----------------------------#--#-----------#######---------
-------------------###----------------------######---------------------------###----------------------------##--#---------#####-------------
-------------------####----g-----g-------k--g----#-----------g---------gg--g-###---------------------------###--#---tt-g--#####-------------
--------------------####----------XXXXXXXXXXXXXXXXXXXXXXXXXXXXXXXXXXXXXXXXXXXXXX-XXXX--XXXXX---XXXXXXXXXXXXXXXXXXXXXXXXXXXXXXXX------XXXXXXX
----------S!!S-----#####--S@S-----XXXXXXXXXXXXXXXXXXXXXXXXXXXXXXXXXXXXXXXXXXXXXX-XXXX--XXXXX---XXXXXXXXXXXXXXXXXXXXXXXXXXXXXXXX-gg-g-XXXXXXX
------------------######-------------------------------------------------------------------------------------------------------XXXXXX-------
-----------------#######------F------------------------------------------------------------------------------------------------XXXXXX-------
-M-------------g--------------#-------------------------------------------------------------------------------------------------------------
XXXXXXXXXXXXXXXXXXXXXXXXXXXXXXXXXX----------------------------------------------------------------------------------------------------------
XXXXXXXXXXXXXXXXXXXXXXXXXXXXXXXXXX----------------------------------------------------------------------------------------------------------
