----------------------------------------------------------------------------------------------------------------------------------------------------------
----------------------------------------------------------------------------------------------------------------------------------------------------------
----------------------------------------------------------------------------------------------------------------------------------------------------------
----------------------------------------------------------------------------------------------------------------------------------------------------------
----------------------------------------------------------------------------------------------------------------------------------------------------------
----------------------------------------------------------------------------------------------------------------------#-----------------------------------
----------------------------------------------------------------------------------------------------------------------##----------------------------------
----------------------------------------------------------------------------------------------------------------------###---------------------------------
---------------------------------------------------------------------------------------------g------------------------####--------------------------------
-------------------------------------------------------------------------------------------SSSSSSS--------------------------------------------------------
-----------------!----------S-----------------SU---!S----------!S---------------------------------------------------S@S!S----SU-------------SS---------!--
---#------------------------------------------------------------------------#----------------------------#------------------------------------------------
---##----t-###--------------------------------------------------------------##------#--------------------##------tt---------------tt---tt-----#####-------
-M-###---t####---k--------g-g-tt-----------------------gg----------gg-tt-g--###----##-------###--#-------###-----tt--g------------tt---tt-----#####----k--
XXXXXXXXXXXXXXXXXXXXXXXXXXXXXXXXXXXXXXXXXXXXXXXXXXXXXXXXXXXXXXXXXXXXXXXXXXXXXXXXXXXXXXXXXXXXXXXXXX--XXXXXXXXXXXXXXX--t-###-----------XXXXXXXXXXXXXXXXXXXXX
XXXXXXXXXXXXXXXXXXXXXXXXXXXXXXXXXXXXXXXXXXXXXXXXXXXXXXXXXXXXXXXXXXXXXXXXXXXXXXXXXXXXXXXXXXXXXXXXXX--XXXXXXXXXXXXXXX--t####---XXXX----XXXXXXXXXXXXXXXXXXXXX
