---------------------------------------------------------------------------------------------------------------------------
-----------------------------------------------------------------------------------------------------!--!-----S------------
---------------------------------------------------------------------------------------------------------------------------
---------------------------------------------------------------------------------------------------------------------------
------------------------------------------------------------------------------------------------gg-g-----------------------
-----------------------------------------------------------------------------------------------XXXXXXXXXXXX-S@S!S----------
-------S!--------------------------------------------------------------------------------------XXXXXXXXXXXX----------------
------------------------------g-------------------------------------------------------------------------------------tt-----
----------------------------SSSSSSSS----------------------------------tt-----------S-------------------------g------tt-----
--------------------g-----------------##-----tt------SSS--------------tt---------------!-----!-----!-----S------####-------
----S---C---------SSSSS--------------###-----tt-----------------------tt----tt---------------------------------#####-------
-----------#-----------#-------------###-----tt-----------------------------tt--------------------------------######---F---
-----------##----------##----t-###--####---g-g-tt-----------------------------tt-g-----------k---------------#######---#---
-M-------g-###---------###---t#XXXXXXXXX-XXXXXXXXXXXXXXXXXXXXXXXXXXXXXXXXXXXXXXXXXXXXXXXXXXXXXXXXXXXXXXXXXXXXXXXXXXXXXXXXXX
XXXXXXXXXXXXXXXXXXXXXXXXXXXXXXXXXXXXXXXX-XXXXXXXXXXXXXXXXXXXXXXXXXXXXXXXXXXXXXXXXXXXXXXXXXXXXXXXXXXXXXXXXXXXXXXXXXXXXXXXXXX
XXXXXXXXXXXXXXXXXXXXXXXXXXXXXXXXXX-----------------------------------------------------------------------------------------
