---------------------------------------------------------------------------------------------------------------------------------------
---------------------------------------------------------------------------------------------------------------------------------------
---------------------------------------------------------------------------------------------------------------------------------------
---------------------------------------------------------------------------------------------------------------------------------------
---------------------------------------------------------------------------------------------------------------------------------------
---------------------------------------------------------------------------------------------------------------------------------------
------------------------------------------S!----------------------------#--#------SSS--------------------------------------------------
-----------------------------------------------------------------------##--#-----------------------------------------------------------
----------------------------------------------------------------------###--#-----------------------------------------------------------
------------------------------g-------------------------------------------------------------------------S!!----------------------SSS---
--------------!------------#SSSSSSSS-------C----------------------##--S@S!S----S----tt-------#--#---!----------------------------------
--------------------------##-------------------------------------###--------------XXXXXXX---##--#--------------------------------------
-------------------------###-------------#-----------------------###--------------XXXXXXX--###--#--------------------------------------
-M----------g-g-tt-------g-g------------##--g--------------------###-###--#--g-g-tt--tt-g--t-###----k------------#--#---SU----S--###--#
XXX--XXXXXXXXXXXXXXXXXXXXXXXXXXX-XXXXXXXXXXXXXXXXXX--XXXXX---XXXXXXX-XXXXXXXXXXXXXXXXXXXXXXt####-XXXXXXXXXXXXXXXX#--#------------XXXXXX
XXX--XXXXXXXXXXXXXXXXXXXXXXXXXXX-XXXXXXXXXXXXXXXXXX--XXXXX---XXXXXXX-XXXXXXXXXXXXXXXXXXXXXXXXXXX-XXXXXXXXXXXXXXXX#--#------------XXXXXX
