---------------------------------------------------------------------------------------------------------------------------------------------
---------------------------------------------------------------------------------------------------------------------------------------------
--------------------------------------------------------------------------------------------SSS----------------------------------------------
---------------------------------------------------------------------------------------------------------------------------------------------
---------------------------------------------------------------------------------------------------------------------------------------------
---------------------------------------------------------------------------------------------------------------------------------------------
--------!--------------------------------S!----------------------------------------------------------#--#------------------------------------
------------------------------------------------##--------------------------------------------------##--#------------------------------------
-----------------------------------------------###-------------------------------------------------###--#------------------------------------
----------------------------------------------------1--------------------------------------------##t-###-------------------------------------
----tt--C--------------------------##-----C--S!S----------##-----1-----------!------------------###t####-------------------------------!S----
----tt--------------------SU------###--------------------###-----------------------------------####XXXXX-------------------------------------
----tt----------------------------###---t----------------###-------------------------t--#-----#####XXXXX-------------------------------------
-M-------g------------------------###---t--g------g-g-tt-###-------------------------t-##--------------tt-g----------tt-g--###--#----------gg
XXXXXXXXXXX--XXXXXXXXXXXXXXXXXXXXXXXX-XXXXXXX-XXXXXXXXXXXXXX-XXXXXXXXXXXXXXXXXXXXXXXXXXXXXXXXXXXXXXXXXXXXXXXX---XXXXXXXXXXXXXXXXXXXXXXXXXXXXX
XXXXXXXXXXX--XXXXXXXXXXXXXXXXXXXXXXXX-XXXXXXX-XXXXXXXXXXXXXX-XXXXXXXXXXXXXXXXXXXXXXXXXXXXXXXXXXXXXXXXXXXXXXXX---XXXXXXXXXXXXXXXXXXXXXXXXXXXXX
