-------------------------------------------------------------------------------------------------------------------------------------------
-------------------------------------------------------------------------------------------------------------------------------------------
-------------------------------------------------------------------------------------------------------------------------------------------
-------------------------------------------------------------------------------------------------------------------------------------------
-------------------------------------------g-----------------------------------------------------------------------------------------------
-----------------------------------------SSSSSSSS-----g------------------------------------------------------------------------------------
----------------------------------------------------SSSSSSSS----S!-------------------------------------------------------------------------
-------------------------------------------------------------------------------------------------------------------------------------------
--------------------------g------------------------------------------------------------------------------------1---------------------------
-------1----------------SSSSSSSS---------------------------------------------------------------------------------------!-------------------
----------------------------------------##----!---------S@S------C-------------------------##----------S-----------------------------------
------------#--------------------------###------------------------------------------------###----------------------------------------------
------------##------#--------------t--####------------------------------------------------###-----------------##-------k-------------------
-M----------###----##------tt------t-#####------------------------g-----------------g----####----------XXXXXXXXXXXXXXXXXXXXXXXXXXXXX---XXXX
XXXXXXXXXXXXXXXXXXXXXXXXXXXXXXXXXXXXXXXXXX-XXXXXXXXXXXXXXXXXXXXXXXXX---XXXXXXXXXXXXXXXXXXXXXX-XXXXXXXX-XXXXXXXXXXXXXXXXXXXXXXXXXXXXX---XXXX
XXXXXXXXXXXXXXXXXXXXXXXXXXXXXXXXXXXXXXXXXX-XXXXXXXXXXXXXXXXXXXXXXXXX---XXXXXXXXXXXXXXXXXXXXXX-XXXXXXXXXX-----------------------------------
