---------------------------------------------------------------------------------------------------------------------------
---------------------------------------------------------------------------------------------------------------------------
---------------------------------------------------------------------------------------------------------------------------
---------------------------------------------------------------------------------------------------------------------------
---------------------------------------------------------------------------------------------------------------------------
---------------------------------------------------------------------------------------------------------------------------
----------------------------!--------------------------------------------------------------------S-------------------------
---#--#--------------------------------------------------------------------------------------------------------------------
--##--#----------------------------------------------------------!--!------------------------------------------------------
-###--#-------------------------------------------tt----1-------------------------------------------------SSS--------------
------------!---------------!------S-----------------------------------------------------------S@S!S----SU-----------------
----------------SU-------------------------------------------#---------------------------------------------------#---------
------------------------#-------------#----t-###-------------##--XXXXXX#----------t--#---t--tt-------------------##------tt
-M--gg-g---------------##------###--####---t####-gg-g---tt---###-XXXXXX#----------t-##---t--tt--g-------tt-------###-----tt
XXXXXXXXXXXXXXX-XXXXXXXXXXXXXXXXXXXXXXXXXXXXXXXXXXXXXXXXXXXXXXXXXXXXXXXXXXXXXXXXXXXXXXXXXXXXXX-g------XXXXXXXXXXXXXXXXXXXXX
XXXXXXXXXXXXXXX-XXXXXXXXXXXXXXXXXXXXXXXXXXXXXXXXXXXXXXXXXXXXXXXXXXXXXXXXXXXXXXXXXXXXXXXXXXXXXX-XXXXXX-XXXXXXXXXXXXXXXXXXXXX
