---------------------------------------------------------------------------------------------------------------------------------------------
---------------------------------------------------------------------------------------------------------------------------------------------
---------------------------------------------------------------------------------------------------------------------------------------------
---------------------------------------------------------------------------------------------------------------------------------------------
---------------------------------------------------------------------------------------------------------------------------------------------
-----SSS-------------------------------------g----------------g------------------------------------------------------------------------------
-------------------------------------------SSSSSSSS---------SSSSSSSS-------------------------S!----------------------------------------------
------------------------------------tt-------------------------------------------------------------------------------------------------------
------------------------------------tt------------------------------------------------------------g------------------------------------------
------------------------------------tt----------------------------------------------------------SSSSSSSS-------------------------------------
-----S@S!S--------!--!--!---------------S@S-----------------------###---S-----------SU----!---C-----------------------!-----------!--!-------
---------------------------------------------------##------------####-------------------------------------#--------------#-------------------
-------------tt-----------------------------------###-----------#####--------tt---------------------------##------#------##------#-----------
-M----g------tt------------------------------------------------#######--tt---tt-----------k----g----------###----##------###----##-----------
XXXXXXXXXXXXXXXXXXXXXXXXXXX--XXXXXXXXXXXXXXXXXXXXXXXXXXXXXXXXXXXXXXXXXXXXXXXXXXXX------XXXXXXXXXXXXXXXXXXXXXXXXXXXXXXXXXXXXXXXXXXXXXXXXXXXXXX
XXXXXXXXXXXXXXXXXXXXXXXXXXX--XXXXXXXXXXXXXXXXXXXXXXXXXXXXXXXXXXXXXXXXXXXXXXXXXXXX------XXXXXXXXXXXXXXXXXXXXXXXXXXXXXXXXXXXXXXXXXXXXXXXXXXXXXX
