-----------------------------------------------------------------------------------------------------------------------------------------
-----------------------------------------------------------------------------------------------------------------------------------------
-----------------------------------------------------------------------------------------------------------------------------------------
-----------------------------------------------------------------------------------------------------------------------------------------
-----------------------------------------------------------------------------------------------------------------------------------------
------------------------------------------------------------------------------------------------------####-------------------------------
-----------------tt--------------------------S!!S----------------------------------------------------#####-------------------------------
-----------------tt--------------------------------------------!------------------------------------######------------tt-----------------
-----------------tt----tt--------------------------------------------------------------------------#######------------tt-----------------
-----------------------tt---------------------------------------------------------------------------------------------tt-----------------
------------------S@S--------##-----!-----S@S---------#--#----S@S-!--!--------------------------------!---------S@S----------#--#---S----
----------!-----------------###----------------------##--#XXXX-------------------------------------------------------XXXX---##--#--------
----------------------------###---------------------###--#XXXX-------------------------------------------------------XXXX--###--#--------
-M---------------------gg-g-###-----------------g-g-tt-g-------------------------------------tt-g--------g----#----------------------tt--
XXX-XXXXXXXXXXXXXXXXXXXXXXXXXXX-XXXXXXXXXXXXXXXXXXXXXXXXXXXXXXXXXXXXXXXXXXXXXXXXXXXXX---XXXXXXXXXXXXXXXXXXXXXXXXXXXXXXXXXXXXXXXXXXXXXXXXX
XXX-XXXXXXXXXXXXXXXXXXXXXXXXXXX-XXXXXXXXXXXXXXXXXXXXXXXXXXXXXXXXXXXXXXXXXXXXXXXXXXXXX---XXXXXXXXXXXXXXXXXXXXXXXXXXXXXXXXXXXXXXXXXXXXXXXXX
