-------------------------------------------------------------------------------------------------------------------------------------------------------------
-------------------------------------------------------------------------------------------------------------------------------------------------------------
-------------------------------------------------------------------------------------------------------------------------------------------------------------
-------------------------------------------------------------------------------------------------------------------------------------------------------------
-------------------------------------------------------------------------------------------------------------------------------------------------------------
-----------------------------------------------------------------------------------------------------S!------------------------------------------------------
---S!---------------------------------------------------------------------------------------------------------g----------------------------------------------
------------------------------------------------------------------------------------------------------------SSSSSSSS-----------------------------------------
--------------------------------------------------------#--#---SU------------------------------------------------------------------!---##---------------tt---
------------------------------------------!-----SS-----##--#---------tt------t-----------tt-----------C-----------------#--#----------###---------------tt---
----C-------------------!-----------------------------###--#---------tt------t-----------tt----------------------------##--#----------###---tt----------tt---
--------------------------------------------------------------###----tt------t-----------tt--------------#####--------###--#----------###---tt---------------
--------------------------------------------------------------#####-----g----#---------g-g-tt----------g-#####---g-gXXXXXXXXXXXXXXXXXXXXX-XXXXXXXXXXXXXXXXXX-
-M---g--------------XXXXXXXXXXXX--XXXXXXXXXXXXXXXXXXXXXXXXXXXXXXXXXXXXXXXXXXXXXXXXXXXXXXXXXXXX--XXXXXXXXXXXXXXXXXXXXXXXXXXXXXXXXXXXXXXXXX-XXXXXXXXXXXXXXXXXX-
XXXXXXX--XXXXXXXXXXXXXXXXXXXXXXX--XXXXXXXXXXXXXXXXXXXXXXXXXXXXXXXXXXXXXXXXXXXXXXXXXXXXXXXXXXXX--XXXXXXXXXXXXXXXXXXXXXXXX-------------------------------------
XXXXXXX--XXXXXXXXXXXXXX--------------------------------------------------------------------------------------------------------------------------------------
