-----------------------------------------------------------------------------------------------------------------------------------------------------------
-----------------------------------------------------------------------------------------------------------------------------------------------------------
-----------------------------------------------------------------------------------------------------------------------------------------------------------
-----------------------------------------------------------------------------------------------------------------------------------------------------------
-----------------------------------------------------------------------------------------------------------------------------------------------------------
-----------------------------------------------------------------------------------------------------------------------------------------------------------
----------S!----------------------------------------------------------------------------------------------------------------------####---------------------
---------------------------------------------------------------------------------------------------------------------------------#####---------------------
----------------------------------------------------------------------------g------g------------------------------------1-------######---------------------
-----------------------------!--!----------------------------------------SSSSSSSSSSSSSSSS--------------------------------------#######---------------------
-----------C---------S@S------------------------------------------------------------------------------------!S--------------------------!--!---------------
-------------------------------------tt--------------------tt-------------------------------------------------------------XXXXXXXXX------------------------
-------------------------------------tt--------------------tt--------------------------------------------------------tt-##XXXXXXXXX------------------------
-M----------g----------------XXXXXXtt----------------------tt---------------------g-g-tt-###--#-----------------gg---tt####--tt----gg-g--------------------
XXX---XXXXXXXXXXXXXXXXXXXXXXXXXXXXXXXXXXXXXXXXXXXXXXXXXXXXXXXXXXXXXXXXXXXXXXXXXXXXXXXXXXXXXXXXXXXXXXXXXXXXXXXXXXXXXXXXXXXXXXXXXXXXXXXXXXXXXXXXXXXXXXXXXXXXX
XXX---XXXXXXXXXXXXXXXXXXXXXXXXXXXXXXXXXXXXXXXXXXXXXXXXXXXXXXXXXXXXXXXXXXXXXXXXXXXXXXXXXXXXXXXXXXXXXXXXXXXXXXXXXXXXXXXXXXXXXXXXXXXXXXXXXXXXXXXXXXXXXXXXXXXXX
