----------------------------------------------------------------------------------------------tt----------------------------
----------------------------------------------------------------------------------------------tt----------tt----------------
----------------------------------------------------------------------------------------------------------tt----------------
----------------------------------------------------------------------------------------------------------------------------
----------------------------------------------------------------------------------------------------S@S!S-------------------
--------------------------------------tt------------------------------------------------------------------------------------
--------------------------------------tt--------------------------------------------------------------------tt--------------
--------------------------------------tt-------------------------------------------------------------g------tt--------------
-----------------------------------------------------------------------------------g----------------------------------------
----------------------------------S@S!S---g--------------------------------------SSSSSSSS-------------S@S!S---------g-------
---!--!-----!-------------------#-------SSSSS----#--#---!-----------------------------------##--------------------SSSSSSSS--
-------------------------------##---------------##--#--------------------#-----------------###----------------tt------------
-----------------tt------------##--g-----------###--#----------------t--###----t-----------###---------g------tt------------
-M---------------tt------g----####-###------------------k---tt-g-----t-#####---t####--tt---###----------g-g-tt--------------
XXXXXXXXXXXXXXXXXXXXXXXXXXXXXXXXXX-XXXXXXXXXXXXXXXXXXXXXXXXXXXXXXXXXXXXXXXXXXXXXXXXXXXXXXXXXXX-XXXXXXXXXXXXXXXX-XXXX--------
XXXXXXXXXXXXXXXXXXXXXXXXXXXXXXXXXX-XXXXXXXXXXXXXXXXXXXXXXXXXXXXXXXXXXXXXXXXXXXXXXXXXXXXXXXXXXX-XXXXXXXXXXXXXXXX-XXXXXXXXXXXX
