--------------------------------------------------------------------
--------------------------------------------------------------------
-----------S!!S-----------------------------------------------------
@S!S----------------------------------------------------------------
--------------------------------------------------------------------
------------------------------------------g-------------------------
g-------------------#--#---!-------S!---SSSSSSSS--------------------
XXXXXXXXXXXXXX-----##--#--------------------------------------------
XXXXXXXXXXXXXX----###--#--------------------------------------------
---------------------------k-----------------------------SSS--------
--------------------!---XXXXXX-!----C------------------#------------
------------------------XXXXXX---------XXXX-----------##------------
---------------------------------------XXXX----------###--------F---
-M--tt-g-----------------tt----------g-g------gg-g---g-g-tt-----#---
XXXXXXXXXX--XXXXXXXXXXXXXXXXXXXXXXXXXXXXXXXXXXXXXXXXXXXXXXXXXXXXXXXX
XXXXXXXXXX--XXXXXXXXXXXXXXXXXXXXXXXXXXXXXXXXXXXXXXXXXXXXXXXXXXXXXXXX
