---------------------------------------------------------------------------------------------------------------------------------------------------------
---------------------------------------------------------------------------------------------------------------------------------------------------------
---------------------------------------------------------------------------------------------------------------------------------------------------------
---------------------------------------------------------------------------------------------------------------------------------------------------------
---------------------------------------------------------------------------------------------------------------------------------------------------------
---------------------------------------------------------------------------------------------------------------------------------------------------------
---------------------------------------------------------------------------------------------------------------------------------------------------------
----------------------------------------------------------------tt---------------------------------------------------------------------------------------
----------------------------------------------------------------tt---------------------------------------------------------------------------------------
-----------------------------------------------------------S----tt---------------------------------------------------------------------------------------
-----------tt----S-----!-----SS!S-------------------------------------------------------SU------------------#----------------##--------------------------
-----------tt---------------------------------------------------------#--------------------------#--#------##---------------###--------------------------
-----------tt---------------------------t--#---t--tt------#####-------##------tt----------------##--#-----###---------------###--------------------------
-M--tt-g------g--------------------gg---t-##---t--tt------#####--gg-g-###-----tt------###--#---###--#----tt-g---------------###--------------------g----#
XXXXXXXXXXXXXXXXXXXXXXXXXXXXXXXXXXXXXXXXXXXXXXXXXXXXXXXXXXXXXXXXXXXXXXXXXXXXXXXXXXXXXXXXXXXXXXXXXXXXXXXXXXXXXXX---XXXXXXXXXXXXX-XXXXXXXXXXXXXXXXXXXXXXXXX
XXXXXXXXXXXXXXXXXXXXXXXXXXXXXXXXXXXXXXXXXXXXXXXXXXXXXXXXXXXXXXXXXXXXXXXXXXXXXXXXXXXXXXXXXXXXXXXXXXXXXXXXXXXXXXX---XXXXXXXXXXXXX-XXXXXXXXXXXXXXXXXXXXXXXXX
