----------------------------------------------------------------------------------------------------------------------------------
----------------------------------------------------------------------------------------------------------------------------------
----------------------------------------------------------------------------------------------------------------------------------
----------------------------------------------------------------------------------------------------------------------------------
-----------------------------------g----------------------------------------------------------------------------------------------
----------------------------------SSSSSSS-----------------------------------------------------------------------------------------
------------------------------------------------------------------S-------!-------------------------------------------------------
-----------------------------------------------------------------------------------------------##---------------------------------
-------------------------------------------------1--------------------------------------------###---------------------------------
------------------------------tt-------------------------------------------####--------------####---------------------------------
------------------------------tt------!------------------!----S@S!S-------#####-----S-------#####-!--!------------------##--#-----
----------#-------------------tt-----------------------------------------######------------######-----------#----------###--##----
----------##----t-###---------------------------#####-------------------#######-----------#######-----------##----t-######--###---
-M--------###---t####--------tt-g---------------#####-g--------g--------g-----------tt---tt--g-tt-----------###---t#######--####--
XXXXXXXXXXXXXXXXXXXXX--XXXXXXXXXXXXXXXXXX---XXXXXXXXXXXXXXXXXXXXXXXXXXXXXXXXXXXXXXXXXXXXXXXXXXXXXXXXXXXXXXXXXXXXXXXXXXX------####-
XXXXXXXXXXXXXXXXXXXXX--XXXXXXXXXXXXXXXXXX---XXXXXXXXXXXXXXXXXXXXXXXXXXXXXXXXXXXXXXXXXXXXXXXXXXXXXXXXXXXXXXXXXXXXXXXXXXX-----#####-
