--------------------------------------------------------------------------------------------------------------------------------------
--------------------------------------------------------------------------------------------------------------------------------------
--------------------------------------------------------------------------------------------------------------------------------------
---------------------------------------------------------------------------------------SSS--------------------------------------------
--------------------------------------------------------------------------------------------------------------------------------------
--------------------------------------------------------------------------------------------#-----------------------------------------
--------------------------------------------------------------------------------------------##----------------------------------------
------------!-------------------------tt--------------------------------------------S-------###---------------------------------------
--------------------------------------tt--------------------------------g---------------XXXXXXXXXX------------------------------------
--------------------------------------tt------------------------------SSSSSSSS----------XXXXXXXXXX------------------------------------
------!--------------tt---------S@S---------------------------------SS------------------------------!--!------------------#--------##-
---------------------tt---------------------------------------------------------------------------------------##----------##------###-
---------------------tt-------------------------------------t--tt--------------------------------------------###-------tt-###-----###-
-M----k---gg-g-------tt----------------------------tt-g-----t--tt-----g----#-gg-g-------tt-g---------------------------tt-####----###-
XXXXXXXXXXXXXXXXXXXXXXXXXXXXXXXXXXXX---XXXXXXXXXXXXXXXXXXXXXXXXXXXXXXXXXXXXXXXXXXXXXXXXXXXXXXXXXXXXXXXXXXXXXXX-XXXXXXXXXXXXXXXXXXXXXX-
XXXXXXXXXXXXXXXXXXXXXXXXXXXXXXXXXXXX---XXXXXXXXXXXXXXXXXXXXXXXXXXXXXXXXXXXXXXXXXXXXXXXXXXXXXXXXXXXXXXXXXXXXXXX-XXXXXXXXXXXXXXXXXXXXXX-
