-------------------------------------------------------------------------------------------------------------------------------------------
-------------------------------------------------------------------------------------------------------------------------------------------
--------------------------------------------------------------------SSS--------------------------------------------------------------------
-------------------------------------------------------------------------------------------------------------------------------------------
-------------------------------------------------------------------------------------------------------------------------------------------
-------------------------------------------S!!S--------------------------------------------------------------------------------------------
-----------------------------------------------------------------S-------------------------------------------------------------------------
-------------------------------------------------------------------------------------------------------------------------------------------
--g----------------------------------------------------------------------------------------------------------------------------------------
SSSSSSSS------------------------1---------####------------------####-----------------------------------------------------------------------
---------------------------!-------------#####---------tt------#####----------tt----------------------------------------!-----------!------
----------------------------------------######---tt----tt-----######----------tt--#----------------S---------------##----------------------
---------------------------------------#######---tt----tt----#######-----#----tt--##------tt---------------#------###----------------------
-M---tt-------------------------tt----------------g----#-tt-g----tt-----###--#----###-----tt--------------##--g-g-tt----k------------------
XXXXXXXXXX---XXXX--XXXXXXXXXXXXXXXXXXXXXXXXXXXXXXXXXXXXXXXXXXXXXXXXXXXXXXXXXXXXXXXXXXXXXXXXXXXXXXX-XXXXXXXXXXXXXXXXXXXXXXXXXXXXXXXXXXXXXXXX
XXXXXXXXXX---XXXX--XXXXXXXXXXXXXXXXXXXXXXXXXXXXXXXXXXXXXXXXXXXXXXXXXXXXXXXXXXXXXXXXXXXXXXXXXXXXXXX-XXXXXXXXXXXXXXXXXXXXXXXXXXXXXXXXXXXXXXXX
