----------------------------------------------------------------------------------------------------SSS--------------
---------------------------------------------------------------------------------------------------------------------
---------------------------------------------------------------------------------------------------------------------
--------------------------------SSS----------------------------------------------------------------------------------
---------------------------------------------------------------------------------------------------------------------
------------------------------------------------------------------------------------------------------#--------------
-------------------------S---------------------------------------------------------------------------##--------------
-----------------------------S-----------#--#-------------------------------------------------------###--------------
----------------------------------------##--##-----------------------------------------------------XXXX--------------
------------------------##-------------###--###------------------------------------S------#------S@XXXX---SU-SS------
---------------!-------####-------------S@S--###---1--------------------------------------##----------------------!--
----tt----------------#####------------------XXX---------------------------#--------------###------------------------
----tt----t-###------######------------------XXX---------t-###-------------##----t-###----####----g------------------
----tt----t####------g----------------------###----------t####-------g----####---t####--g-g-tt-----------g--------k--
XXX-XXXXXXXXXXXXXXXXXXXXXXXXXXXXXXXXXXXXXXXXXXXXXX-XXXXXXXXXXX--XXXXXXXXXXXXXXXXXXXXXXXXXXXXXXX-XXXXXXXXXXXXXXXXXXXXX
XXX-XXXXXXXXXXXXXXXXXXXXXXXXXXXXXXXXXXXXXXXXXXXXXX-XXXXXXXXXXX--XXXXXXXXXXXXXXXXXXXXXXXXXXXXXXX-XXXXXXXXXXXXXXXXXXXXX
