-------------------------------------------------------------------------------------------------------------------------
-------------------------------------------------------------------------------------------------------------------------
-------------------------------------------------------------------------------------------------------------------------
---------------------------------------------------------------g-----------g---------------------------------------------
-------------------------------------------------------------SSSSSSSS----SSSSSSSS----------------------------------------
-------------------------------------------------------------------------------------------------------S!----------------
----------S!-------------------tt-------------------------------------------------------------------S--------------------
-------------------------------tt----------------------------------------------------------------------------------------
-------------------------------tt---------------------------##-----------------------------------------------------------
-----------------------------------------------------------###--S@S!S-------S@S!S----SU-@S--------------C----------------
-----------C-----!-------@S!S--------------#--------------####-----------------------------------------------------------
--------------------tt---------------------##------#-----#####----------tt--------------------t--#-----------------------
--------------------tt----------gg-g-------###----##--g-g-tt-#X--g------tt---g----------------t-##-------g--------g-g-tt-
-M----------g----k--tt---g-----XXXXXXXXXXXXXXXXXXXXXXXXXXXXXXXXXXXX-XXXXXXXXXXXXXXXXXXXXXXXXXXXXXXXXXXXXXXXXXXXXXXXXXXXXX
XXXXXXXXXXXXXXXXXXXXXXXXXX-XXXXXXXXXXXXXXXXXXXXXXXXXXXXXXXXXXXXXXXX-XXXXXXXXXXXXXXXXXXXXXXXXXXXXXXXXXXXXXXXXXXXXXXXXXXXXX
XXXXXXXXXXXXXXXXXXXXXXXXXX-XXXXXX----------------------------------------------------------------------------------------
