---------------------------------------------------------------------------------------------------------------------------------------------------
---------------------------------------------------------------------------------------------------------------------------------------------------
---------------------------------------------------------------------------------------------------------------------------------------------------
----------------------------------------------------SSS--------------------------------------------------------------------------------------------
---------------------------------------------------------------------------------------------------------------------------------------------------
---------------------------------------------------------------------------------------------------------------------------------------------------
---------------------------------------------------------------------------------------------------------------------------------------------------
---------------------------------------------------------------------------------------------------------------------------------------------------
-----------------------------------------------------------------#------------------------1--------------------------------------------------------
-----------------------------------------------------------------##--------------!--!------------------------------1-------------------------------
---!S----!--!-----------------------##----SS-------##--S@S-------###-----tt-!--!------------------!---S@S!---SU---------------------tt-------------
-----------------------------------###------------###------#-----XXXX----tt---------------------------------------------------------tt---#---------
-----------------------------------###------------###------##----t-##----tt--------------#####--------------------------------------tt---##------tt
-M-----gg--------------------g-----###------------###------###---t####g----#-----XXXXXX--#####----k----g---------###--#------###----tt---###-----tt
XXXXXXXXXXXXXXX--XXXXX---XXXXXXXXXXXXX-XXXXXXXXXXXXXX-XXXXXXXXXXXXXXXXXXXXXXXXXXXXXXXXXXXXXXXXXXXXXXXXXXXXXXXXXXXXXXXXXXXXXXXXXXXXXXXXXXXXXXXXXXXXX
XXXXXXXXXXXXXXX--XXXXX---XXXXXXXXXXXXX-XXXXXXXXXXXXXX-XXXXXXXXXXXXXXXXXXXXXXXXXXXXXXXXXXXXXXXXXXXXXXXXXXXXXXXXXXXXXXXXXXXXXXXXXXXXXXXXXXXXXXXXXXXXX
