---------------------------------------------------------------------------------------------------------------------------------------------------
---------------------------------------------------------------------------------------------------------------------------------------------------
---------------------------------------------------------------------------------------------------------------------------------------------------
---------------------------------------------------------------------------------------------------------------------------------------------------
---------------------------------------------------------------------------------------------------------------------------------------------------
----------------------------------------g----------------------------------------------------S-----------------------------------------------------
--------------------------------------SSSSSSSS--------------------S!-------------------tt-------S!--------S!---------------------------------------
---------------------------------------------------------------------------------------tt----------------------------------------------------------
---------------------------------------------------------------------------------------t-----------------------------------------------------------
-----------------------------------------------------------------------------------------S@S!S-----------------------------------------------------
---------------------------S!!S------##------------------------!---C---S---------------!---------C-----!---C-------S@S-----------------------!-----
------------------------------------###-------------------------------------##----------------------------------------------SU---------------------
------------------------------------###------------------------------------###------------g--------------------------------------------------------
-M----------------------------------###--gg-g------------------k----g---------g----#------###--#--g---------g------------------------g-g-tt--------
XXXXXXXXXXXXX---XXXXXXXXXXXXXXXXXXXXXXX-XXXXXX---XXXXXXXXXXXXXXXXXXXXXXXXXXXXXXXXXXXXXXXXXXXXXXXXXXXXXXXXXXXXXXXXXXXXXXXXXXXXXXXXXXXXXXXXXXXXXXXXXX
XXXXXXXXXXXXX---XXXXXXXXXXXXXXXXXXXXXXX-XXXXXX---XXXXXXXXXXXXXXXXXXXXXXXXXXXXXXXXXXXXXXXXXXXXXXXXXXXXXXXXXXXXXXXXXXXXXXXXXXXXXXXXXXXXXXXXXXXXXXXXXX
