----------------------------------------------------------------------------------------------------------------------------------
----------------------------------------------------------------------------------------------------------------------------------
------------------------------------------------------------------------------!---------------------------------------------------
-----------------------------------------------------------------tt-------------------------------------g----------------------tt-
-----------------------------------------------------------------tt-----------------------------------SSSSSSSS-----------------tt-
---#--#----------------------------------------------------------tt-------------------S!!S----------------------------------####--
--##--#---------------------------SSS---------!------S----------S@S-----------!---------S@S--------------------------------#####--
-###--#-------------------------------------------------------------------------------------#-----------------------------######--
-----------------------------------------------------------t--#-----------------------------##----t-###------------------#######--
-S@S!S-------------------------------------g----#--tt------t-##------------------g----#-----###---t####--tt----------g----g-g-tt--
-------#-----------------------XXXXXXXXXXXXXXXXXXXXXXXXXXXXXXXXXXXXX--XXXXXXXXXXXXXXXXXXXXXXXXXXXXXXXXXXXXXXXX--XXXXXXXXXXXXXXXXX-
-------##------#---------------XXXXXXXXXXXXXXXXXXXXXXXXXXXXXXXXXXXXX--XXXXXXXXXXXXXXXXXXXXXXXXXXXXXXXXXXXXXXXX--XXXXXXXXXXXXXXXXX-
--g----###----##------------------------------------------------------------------------------------------------------------------
-M-----XXXXXXXXXXXXXXXX--XXXXX-XXXXXX---------------------------------------------------------------------------------------------
XXXXXXXXXXXXXXXXXXXXXXX--XXXXX-XXXXXX---------------------------------------------------------------------------------------------
XXXXXXX---------------------------------------------------------------------------------------------------------------------------
