------------------------------------------------------------------------------------------------------------------------------------------
-------------------------------------------####-------------------------------------------------------------------------------------------
------------------------------------------#####-------------------------------------------------------------------------------------------
-----------------------------------------######-------------------------------------------------------------------------------------------
----------------------------------------#######-------------------------------------------------------------------------------------------
------------------------------------------------------------------------------------------------------------------------------------------
-----------------------------------------S@S!S--------------------------------------------------------------------------------------------
------------------------------------------------XXXXXXX-----------------------------------------------------------------------------------
----------------------------g-------------------XXXXXXX-----------------------------------------------------------------------------------
--------------------------SSSSSSSS--------g-----------------------------------------------------------------------------------------####--
----------!S-----##------------------S@S-------------------------------------------------------------SSS----------#----------------#####--
----------------###-----------------------------------#--------#--------#-----------------------------------------##--------------######--
----------------###-----------------------------------##------###------###------#---t--tt----------------------tt-###-----tt-----#######--
-M------------gg###---g-g-tt---tt---------gg-g--tt-g--###----#####----#####----##---t--tt----------------------tt-####----tt--------XXXXXX
XXX--XXXXXXXXXXXXXX-XXXXXXXt#XXXXXXXXXXXXXXXXXXXXXXXXXXXXXXXXXXXXXXXXXXXXXXXXXXXXXXXXXXXXXXXXXX--XXXXX-XXXXXXXXXX-------XXXXXXXXXXX-XXXXXX
XXX--XXXXXXXXXXXXXX-XXXXXXXXXXXXXXXXXXXXXXXXXXXXXXXXXXXXXXXXXXXXXXXXXXXXXXXXXXXXXXXXXXXXXXXXXXX--XXXXX-XXXXXXXXXX-------XXXXXXXXXXXXX-----
