---------------------------------------------------------------------------------------------------------------------------------
---------------------------------------------------------------------------------------------------------------------------------
-------------------------------------------------------------------------------------------------------------------#--#---!------
------------------------------------------------------------------------------------------------------------------##--#----------
-----------------------------------------------------------------------------------------------------------------###--#----------
--------------------------------------------------------------------------------------------------------------------------k------
---S!-------------------------------------------------------------------------------------------------------S@S!S------XXXXXXXXXX
-----------------------------------------------------------------------------------------------------------------------XXXXXXXXXX
---------------------------------------------------------####-------------------------------------------------------tt-----------
--------------------------------------------------------#####------------------------------------------------g------tt-g---------
----C------------------#--#-------------------!--------######---------------------------------------!-----##--S@S----SSSSSSSS----
----------------------##--#---------------------------#######-------#--#---SU----S-----------------------###---------------------
---------------------###--#-----------------------------#####------##--#-----------------#---------------###---------------------
-M---g----------g-g-tt-----gg---------g-g-tt-###--#-----#####-----###--#----------------##g----#---------###---------------------
XXXXXXX---XXXXXXXXXXXXXXXXXXX--XXXXXXXXXXXXXXXXXXXXXXXXXXXXXXX-XXX###---tt-gg----XXXXXXXXXXXXXXXXXXXXXXXXXXX-XXXXX-XXXX----------
XXXXXXX---XXXXXXXXXXXXXXXXXXX--XXXXXXXXXXXXXXXXXXXXXXXXXXXXXXX-XXXXXXXXXXXXXXXXX-XXXXXXXXXXXXXXXXXXXXXXXXXXX-XXXXX-XXXX----------
