---------------------------------------------------------------------------------------------------------------------------------------------------------
---------------------------------------------------------------------------------------------------------------------------------------------------------
---------------------------------------------------------------------------------------------------------------------------------------------------------
---------------------------------------------------------------------------------------------------------------------------------------------------------
---------------------------------------------------------------------------------------------------------------------------------------------------------
------------------------------------------------------------------------------------------------------------------g--------------------------------------
----------------------------------------------------------------------------------------------------------------SSSSSSSS---------------------------------
---------------------------------------------------------------------------------------------------------------------------------------------------------
-------------------------------------------------------g--------------------------------------------------------------------------------g----------------
-----------------#---------------------------------#-SSSSSSSS-------------------------------------------------------------------------SSSSSSSS-----------
-----------##----##----------!----!--!-------------##---------------!---------SSS-----------------!-----------------S@S----------------------------------
----------###----###-------------------------------##----------------------------------------------------------------------------------------------------
----------###----###-------------------------------##---------------------t-##----------#--------------tt----------------------#####--------------------t
-M--------###-g--------------tt-----------------tt-g--###--#--tt----------t###---------##g-------------tt----------------------#####---g-g-tt-----------t
XXXXXXXXXXXXX-XXXXXXXXXXXXXXXXXXXXXXXXXXXXXXXXXXXXXXXXXXXXXXXXXXXXX-XXXXXXXXXXX-XXXXXXXXXXXXXXXXXXXXXXXXXXXXXXXXXXXXXXXX--XXXXXXXXXXXXXXXXXXXXXXXXXXXXXXX
XXXXXXXXXXXXX-XXXXXXXXXXXXXXXXXXXXXXXXXXXXXXXXXXXXXXXXXXXXXXXXXXXXX-XXXXXXXXXXX-XXXXXXXXXXXXXXXXXXXXXXXXXXXXXXXXXXXXXXXX--XXXXXXXXXXXXXXXXXXXXXXXXXXXXXXX
