-------------------------------------------------------------------------------------------------------------------------------------
-------------------------------------------------------------------------------------------------------------------------------------
-------------------------------------------------------------------------------------------------------------------------------------
-------------------------------------------------------------------------------------------------------------------------------------
-------------1-----------------------------------------------------------------------------------------------------------------------
-------SU----------------------------------------------------------------------------------------------------------------------------
------------------------------------------SU--------S--------------------------------------------------------------------------------
-------------------------------------------------------------------------------------------------------------------------------------
-------------------------------------------------------------------------------------------------------------g-----------------------
-----------S@S!S---SU----------------------####------------------------------------------------------------SSSSSSSS----------SS------
-----------------------------!S-----S-----#####--S@S-------------!-------------------------------------------------------------------
------------------------tt---------------######---------------------#---------------#----------------------------------tt------------
------------g-----------tt--------------#######---------tt-###------##------tt------##------######---------------------tt------g----#
-M--tt-g---------------g---------gg---------------------tt####------###-----tt------###----#######-----------------tt-----XXXXXXXXXXX
XXXXXXXXXXXXXXXXXXXXXXXXXXXXXXXXXXXXXXXXXXXXXXXXXXXXXXXXXXXXXXXXXXXXXXXXXXXXXXXXXXXXXXXXXXXXXXXXXXXXXXXXXXXXXXXXXXXXXXXX--XXXXXXXXXXX
XXXXXXXXXXXXXXXXXXXXXXXXXXXXXXXXXXXXXXXXXXXXXXXXXXXXXXXXXXXXXXXXXXXXXXXXXXXXXXXXXXXXXXXXXXXXXXXXXXXXXXXXXXXXXXXXXXXXXXXX-------------
