--------------------------------------------------------------------------------------------------------------------------------------------------
--------------------------------------------------------------------------------------------------------------------------------------------------
--------------------------------------------------------------------------------------------------------------------------------------------------
--------------------------------------------------------------------------------------------------------------------------------------------------
----------------------------g---------------------------------------------------------------------------------------------------------------------
--------------------S!!S--SSSSSSSS----------------------------------------------------------------------------------------------------------------
------------------------------------------------------------------S!--------S!--------------------------------------------------------------------
--------------------------------------------------------------------------------------------------------------------------------------------------
--------------------------------------------------------------------------------------------------------------------------------------------------
-------------------##g----#-------------S!!S--------------------------------------#---------------------------------------------------------------
---------!S-------###XXXXXX----!--------------!---------tt---------C-----!---C----##----------------S----!S-----#--#---------!--------------------
-----------------####XXXXXX-----------------------------tt------------------------###--------##----------------##--#------------------------------
----------------#######---------------------------------tt------------------------####------###---------------###--#------------------------------
-M-g---------gg---------------------g-g-tt----k----tt---###-g-------g----k----g-###--#--g-g-tt-g-------------gg---------------tt-----g-g-tt-g-----
XXXXXXXXXXXXXXXXXXXXXXXXXXXXXXXXXXXXXXXXXXXXXXXXXXXXXXXXXXX-XXXXXXXXXXXXXXXXXXXXXXXXXXXXXXXXXXXXXXXXXXXXXXXXXXXXXXXXXXXXXXXXXXXXXXXXXXXXXXXXXXXXXX
XXXXXXXXXXXXXXXXXXXXXXXXXXXXXXXXXXXXXXXXXXXXXXXXXXXXXXXXXXX-XXXXXXXXXXXXXXXXXXXXXXXXXXXXXXXXXXXXXXXXXXXXXXXXXXXXXXXXXXXXXXXXXXXXXXXXXXXXXXXXXXXXXX
