------------------------------------------------------------------------------------------------------------------------------------------
------------------------------------------------------------------------------------------------------------------------------------------
--------------------------------------------------------------------------------tt--------------------------------------------------------
--------------------------------------------------------------------------------tt--------------------------------------------------------
--------------------------------------------------------------------------------tt--------------------------------------------------------
---------------------------------------------------------------------------------------1--------------------------------------------------
-------------------S!!S---------------------------------------------------------S!S----------------------------------------S!-------------
------------------------------------------------------------------------------------------------------------------------------------------
------------------------------------------------------------------------------------------------------------------------------------------
--------------------------------------------------------------------------#-----S@S!S-----------------------------------------------------
---!S------------##-----------------------------#--#----!----------!------##----------------tt---------------------S--------C-------!S----
----------------###----------------------------##--#----------------------###---------------tt--------------------------------------------
----------------###---------------------------###--#----------------------####---g----------tt--------------------------------------------
-M-----gg-------###-g----#--------------------g-g-tt-------------g-g-tt---tt--------------g-g-tt-----------------###--#------g----------gg
XXXXXXXXX--XXXXXXXX-XXXXXX--XXXXX---XXXXXXXXXXXXXXXXXXXXXXXXXXXXXXXXXXXXXXXXXXXXXXXXXXXXXXXXXXXXXXXXXXXXXX--XXXXXXXXXXXXXXXXXXXXXXXXXXXXXX
XXXXXXXXX--XXXXXXXX-XXXXXX--XXXXX---XXXXXXXXXXXXXXXXXXXXXXXXXXXXXXXXXXXXXXXXXXXXXXXXXXXXXXXXXXXXXXXXXXXXXX--XXXXXXXXXXXXXXXXXXXXXXXXXXXXXX
