----------------------------------------------------------------------------------------------------------------------------
---------------------------------------------------------------------------------1------------------------------------------
------------------------------------------------------------------------S@S!S-----------------------------------------------
----------------------------------------------------------------------------------------------------------------------------
----------------------------------------------------------------------------------------------------------------------------
-------------------------------------------------------------------------g--------####--------------------------------------
---------------------------------------------------------------------------------#####--------------------------------------
---------------------------------------------------------------------------#----######--------------------------------------
-------------------------------------------------g------------------------##---#######--------------------------------g-----
-----------------------------------------------SSSS----------------------#######------------!-----------------------SSSSSSSS
----------!----------------------SS--------S@S---------#--#----------------S@S-----XXXX-------------------------------------
--------------------!---------------------------------##--##-----------------------XXXX---------##--------------------------
----------------------------tt-----------------------###--###------#-----------------#####-----###--------------------------
-M--------k-----------------tt-----------------g-----------###----##g----------g-----#####---tt-----------------g-g-t-------
XXXXXXXXXXXXX-XXXXX-XXXXXXXXXXXXXXXXXXXXXXXXXXXXXXXX-------XXXXXXXXXXXXXXXXXXXXXXXXXXXXXXXXXXXXXXXXXXXXXXXXXXXXXXXXXX-------
XXXXXXXXXXXXX-XXXXX-XXXXXXXXXXXXXXXXXXXXXXXXXXXXXXXX-------XXXXXXXXXXXXXXXXXXXXXXXXXXXXXXXXXXXXXXXXXXXXXXXXXXXXXXXXXX-------
