------------------------------------------------------------------------------------------------------------------------------------------
---------------------------g------------------------------------------SSS-----------------------------------------------------------------
-------------------------SSSSSSSS---------------------------------------------------------------------------------------------------------
------------------------------------------------------------------------------------------------------------------------------------------
------------------------------------------------------------------------------------------------------------------------------------------
------------------------------------------------------------------------------------------------------------------------------------------
-----------------------------####-------------------------------------S@S!S-----------------S!--------------------------------------------
----------------------------####----------g-----------------------------------------------------------------------------------------------
---------------------------#####--------SSSSSSSS-------------------------------------------------------------------------------------####-
--------------------------######---------------------------------------g------------------------------------------------------------#####-
------------tt-------!--!---S@S--------------------------!---------##-----------1------------C----------------tt-------------------######-
------------tt----------------------#--#--------------------------###-----------------------------------------tt--------------t---#######-
------------tt---------------------##--#----#####-----------------###-----------------------------------------tt------gg-g----tt####------
-M--tt-g--g----#------------------###--#----#####--------tt-------###--gg-g-------------------g--------g-XXXXXXXXXXXXXXXXXXXXXXXXXXXXXXX--
XXXXXXXXXXXXXXXXXXXXXXXXXXXXXXXXXXXXXXXXXXXXXXXXXXXXXXXXXXXXXXXXXXXXX-XXXXXXXXXXXXXXXXXXXXXXXXXXXXXXXXXXXXXXXXXXXXXXXXXXXXXXXXXXXXXXXXXX--
XXXXXXXXXXXXXXXXXXXXXXXXXXXXXXXXXXXXXXXXXXXXXXXXXXXXXXXXXXXXXXXXXXXXX-XXXXXXXXXXXXXXXXXXXXXXXXXXXXXXXXXXXXXXXX----------------------------
