-----------------------------------#----------##---------------------##-----######----------------------###------------------
-----------------------------------##------tt-###-------------------###----#########---------------tt-###--------------------
---------------------------------g-###-----tt-####--------------###--#--g-g-tt-#####-------gg-g----tt####g----#--------------
-----------------------XXXXXXXXXXXXXXXXXXXXXX-XXXXXXXXXXX--XXXXXXXXXXXXXXXXXXXXXXXXXXXXXXXXXXXXXXXXXXXXXXXXXXXXXXXXXXXXXXXXXX
-----------------------XXXXXXXXXXXXXXXXXXXXXX-XXXXXXXXXXX--XXXXXXXXXXXXXXXXXXXXXXXXXXXXXXXXXXXXXXXXXXXXXXXXXXXXXXXXXXXXXXXXXX
-----------------------------------------------------------------------------------------------------------------------------
-----------------------------------------------------------------------------------------------------------------------------
-----------tt--------S@S!S---------------------------------------------------------------------------------------------------
-----------tt----------------------------------------------------------------------------------------------------------------
-----------tt----tt----------S!!---------------------------------------------------------------------------------------------
---!--!----------tt---g------------------------------------------------------------------------------------------------------
-----------------------------------------------------------------------------------------------------------------------------
---------------------------------------F-------------------------------------------------------------------------------------
-M--------gg-g--tt-g-------------------#-------------------------------------------------------------------------------------
XXXXXXXXXXXXXXXXXXXXXXXXXXXXXXXX--XXXXXXXXX----------------------------------------------------------------------------------
XXXXXXXXXXXXXXXXXXXXXXXXXXXXXXXX--XXXXXXXXX----------------------------------------------------------------------------------
