----------------------------------1--------------------------------------------------------------------------------------------
----------------------------SU-------------------------------------------------------------------------------------------------
-------------------------------------------------------------------------------------------------------------------------------
-------------------------------------------------------------------------------------------------------------------------------
-------------------------------------------------------------------------------------------------------------------------------
--------------------------------S@S!S------------------------------------------------------------------------------------------
----------------------------S!--------#--------------SU-----------#------------------------------------------------------------
--------------------------------------##-------------------------##----tt-----S------------------t-----------------------------
---------------------------------g----###-----------------------###----tt------------------------t--g--------------------------
--------------------------------------XXXXXX---------------------------tt------------------------tSSSSSSSS---------------------
-----------------------------C-----!--XXXXXX-------S@S!S----!-----!------------####-----------------------------------!--------
------------------------------------------------------------------------------#####--------------------------------------------
-----------------------------------------------tt----------------------------######--------------------------------------------
-M----------------------------g---------g-----tt---g--------k---------gg----#######------------gg-g-g-----------------k--------
XXX--XXXXX---XXXXXXXXXXXXXXXXXXXXXXXXX-XXXXXXXXXXXXXXXXXXXXXXXXXXXXXXXXXXXXXXXXXXXXXXXX--XXXXXXXXXXXXXXXXXXXXXXXXXXXXXXXXXXXXXX
XXX--XXXXX---XXXXXXXXXXXXXXXXXXXXXXXXX-XXXXXXXXXXXXXXXXXXXXXXXXXXXXXXXXXXXXXXXXXXXXXXXX--XXXXXXXXXXXXXXXXXXXXXXXXXXXXXXXXXXXXXX
