------------------------------------------------------------------------------------------------------------
-----------------------------S!!S---------------------------------------------------------------------------
-------------------------------------------------tt-----SU--------------------------------------------------
-------------------------------------------------tt---------------------------------------------------------
-------------------------------------------------tt---------------------------------------------------------
--------------------------------------------------------------------------------------------1---------g-----
-------------!--!--------S@S!S----------------!-------S@--------------------------------------------SSSSSSSS
------------------------------------------------------------!-----------------------------------------------
--------t-###--------tt-------------------------------------------------------------------------------------
----S---t####--------tt---g--------------####----------g----------------------------------------------------
--------XXXXXXXXXXX---------------------#####-------------------S@S-----------------------S@S!S----!--------
--------XXXXXXXXXXX-------#------------######-----------------------#----------#----------------------------
---#####------------------##------#---#######-----------------------##----t-#####------tt-------------------
-M-#####-g----#-----g-----###----##--tt-------------------gg-g------###---t#######-----tt--g-------k---gg-g-
XXXXXXXXXXXXXXXXXXXXXXXXXXXXXXXXXXXXXXXXXXXXXX--XXXXXXXXXXXXXXXXXXXXXXXXXXXXXXXXXXXXXXXXX--t-###XXXXXXXXXXXX
XXXXXXXXXXXXXXXXXXXXXXXXXXXXXXXXXXXXXXXXXXXXXX--XXXXXXXXXXXXXXXXXXXXXXXXXXXXXXXXXXXXXXXXX--t####XXXXXXXXXXXX
