-------------------------------------------------------------------------------------------------------------------------------------------------------------
-------------------------------------------------------------------------------------------------------------------------------------------------------------
-----------------------------------------------------------------------------------------------------------------##--#---------------------------------------
----------------------------------------------------------------------------------------------------------------###--##--------------------------------------
---------------------------------------------------------------------------------------------------------------####--##--------------------------------------
---------------------------------------------------------------------------------------------------------------####--##--------------------------------------
----------------------------------------------------------S!!S----------------------------------------------------######-##--#-------------------------------
------------------------------------------------------------------------------------------------------------------#########--##------------------------------
----------------------------------------------##------------------------------------------------------------------#########--##------------------------------
---------------------------------------------###-----------------------------------------------------------------------####--##------------------------------
------tt------------C-----S---tt-U----!-----####---C-------SS-------------##--#----!--!-----------------!--!--C----XXXX---######----------U----!-------------
------tt----------------------tt-------#------##-------------------------###--##-----------------------------------XXXX---######----!------------------------
------tt-------tt-#-----------tt-------#------##------------------------####--##------------------------------------------######-------------------------F---
-M----tt--g-g--tt##--g-g------tt------k#-------g-g--g-g----tt-----#----#-g-g--##------------gg-----------------g-g-----------------------------k-----gg--#---
XXXXXXXXXXXXXXXXXXXXXXXXXXXXXXXXXXXXXXXXXXXXXXXXXXXXXXXXXXXXXXXXXXXXXXXXXXXXXXXXXXXXXXXXXXXXXXXXXXXXXXXXXXXXXXXXXXXXXXXXXXXXXXXXXXXXXXXXXXXXXXXXXXXXXXXXXXXXX
XXXXXXXXXXXXXXXXXXXXXXXXXXXXXXXXXXXXXXXXXXXXXXXXXXXXXXXXXXXXXXXXXXXXXXXXXXXXXXXXXXXXXXXXXXXXXXXXXXXXXXXXXXXXXXXXXXXXXXXXXXXXXXXXXXXXXXXXXXXXXXXXXXXXXXXXXXXXX
