-------------------------------------------------------------------------------------------------------------------------------------------------##--#-----
------------------------------------------------------------------------------------------------------------------------------------------------###--##----
---------------------------------------------------------------------------------------------------------------------------------------##------####--##----
--------------------------------------------------------------------------------------------------------------------------------------###------####--##----
-------------------------------------------------------------------------------------------------------------------------------------####---------######---
------------------------------------------------------------------------------------------------------------------------------------#####---------######---
--------------------------------------------------------------------------!----------##--------------------------------1-----------######---------######---
------------------------------------------------------------------------------------###----------------------tt-------------------#####-tt------g------tt--
---------##-----------------tt-----------------------------------------------------####----------------------tt-------------------#####XXXXXXXXXXXXXXXXXXXX
--------###-----------------tt----------------------------------------------------#####----------------------tt-------------------#####XXXXXXXXXXXXXXXXXXXX
-------####----------tt-----tt-----U----!---------------------S---------S@S!S----######-------C-----S----------------gg---------g------tt------------------
------#####----------tt-----#---------------------------tt------------!---------#-----#-----------------XXXXXXXXXXXXXXXXXXXX--XXXXXXXXXXXXX----------------
-----######----------tt-----#---------------tt-#--------tt----------------------#-----#-----------------XXXXXXXXXXXXXXXXXXXX--XXXXXXXXXXXXX----------------
-M--tt-----#---------tt--g-g#-----------k---tt##--------tt------#---------------#-----#--------g-g----g------tt--------------------------------------------
XXXXXXXXXXXXXXXXXXXXXXXXXXXXXXXXXXXXXXXXXXXXXXXXXXXX--XXXXXXXXXXXXXXXXXXXXXXXXXXXXXXXXXXXXXXXXXXXXXXXXXXXXXXXXXXX------------------------------------------
XXXXXXXXXXXXXXXXXXXXXXXXXXXXXXXXXXXXXXXXXXXXXXXXXXXX--XXXXXXXXXXXXXXXXXXXXXXXXXXXXXXXXXXXXXXXXXXXXXXXXXXXXXXXXXXX------------------------------------------
