-------------------------------------------------------------------------------------------------------------------------------------------------------------------------------------
-------------------------------------------------------------------------------------------------------------------------------------------------------------------------------------
-------------------------------------------------------------------------------------------------------------------------------------------------------------------------------------
-------------------------------------------------------------------------------------------------------------------------------------------------------------------------------------
-------------------------------------------------------------------------------------------------------------------------------------------------------------------------------------
-------------------------------------------------------------------------------------------------------------------------------------------------------------------------------------
-------------------------------------------------------------------------------------------------------------------------------------------------------------------------------------
-------------------------------------------------------------------------------------------------------------------------------------------------------------------------------------
-----------------------------------------------------------------------------------------------------------------##-----------------------------------------------##-----------------
---1------------------------------------------------------1------------##-----1---------------------------------###-------------------------------##--#----------###-----------------
------------C-------!---------tt-U----!----tt--!--!-------------------###-------------U----!------tt-----##----####----------------C-----S---tt--###--#U----!---####-----------------
------------------------------tt-----------tt------------------------####-------------------------tt----###---#####--------------------------tt-####--#--------#####-----------------
------------------------------tt-----------tt-----------------------#####-------------------------tt---####--######--------------------------tt-####--#-------######---------gg------
-M-----------g-g----tt--------tt------k----tt----------------------######------------------k-----------####--##---g-g----------g-g--g-g------tt-----g-g-----k------XXXXXXXXXXXXXXXXXX
XXXXXXXX--XXXXXXXXXXXXXXXXXXXXXXXXXXXXXXXXXXXXXXXXXXXXXXXXXXXXX--XXXXXXXXXXXXXXXXXX--XXXXXXXXXXXXXXXXXXXXXX--XXXXXXXXXXXXXXXXXXXXXXXXXXXXXXXXXXXXXXXXXXXXXXXXXXXXX-XXXXXXXXXXXXXXXXXX
XXXXXXXX--XXXXXXXXXXXXXXXXXXXXXXXXXXXXXXXXXXXXXXXXXXXXXXXXXXXXX--XXXXXXXXXXXXXXXXXX--XXXXXXXXXXXXXXXXXXXXXX--XXXXXXXXXXXXXXXXXXXXXXXXXXXXXXXXXXXXXXXXXXXXXXXXXXXXX-------------------
