----------------------------------------------------------------------------------------------------------------
---------------------------------S!!S---------------------------------------------------------------------------
-------------------------------------------------------##-------------------------------------------------------
------------------------------------------------------###-------------------------------------------------------
-----------------------------------------------------####-----------------------##-----------tt-----------------
-----------------##---------------SS----------------#####----------------------###-----------tt-----------------
----------------###--------------------------------######-------##------------####-----------tt-----------------
---------------####------U----!---------C---------############-###-----------#####------######------------------
--------------#####-----------1-------------------################----------######------######------------------
-------------######-------------------------------################---------------g----S-######--C-----S-----S@S-
------------#####-tt---------------------g-g-----------tt-----XXXX-------XXXXXXXXX------#-----------------------
------------#####XXXXXXXXXXXXX--------XXXXXX------XXXXXXXXX---XXXX-------XXXXXXXXX------#-----------------------
-----tt-#---#####XXXXXXXXXXXXX--------XXXXXX----gg----------tt---------gg---------------#--------g-g------------
-M---tt##-g------tt-----------XXXXX--XXXXXXXXXXXXXXXXXXXXXXXXXXXXXXXXXXXXXXXXXXXXXXXXXXXXXXXXXXXXXXXXXXXXXXXXXXX
XXXXXXXXXXXXXXXXXXXXX---------XXXXX--XXXXXXXXXXXXXXXXXXXXXXXXXXXXXXXXXXXXXXXXXXXXXXXXXXXXXXXXXXXXXXXXXXXXXXXXXXX
XXXXXXXXXXXXXXXXXXXXX-------------------------------------------------------------------------------------------
