-----------------------------------------------------------------------------------------------------------------------------------------------
-----------------------------------------------------------------------------------------------------------------------------------------------
-----------------------------------------------------------------------------------------------------------------------------------------------
-----------------------------------------------------------------------------------------------------------------------------------------------
-----------------------------------------------------------------------------------------------------------------------------------------------
-------------------------------------------------------------------------!---------------------------------------------------------------------
--------------------------------------S!!S---------------------------------------------------------------------------------------------##------
--------------------------------------------------------------------t------------##--#--------------------1--------------##--#--------###------
---------------------------------##---------------------------------SS!S-----##-###--#---------tt--C-----S-------######-###--##------####------
--------------##----------------###------------------------------------------######--#---------tt----------------##########--##-----#####------
-------------###---------------####----SS---------S--C-----S---#####---------######--#---------tt----------------##########--##----######------
------------####------##--#---#####----------------------------#####------gg-------------------tt---g-g-------------------g-g-----------tt-----
-----------#####-----###--##-######----------------------------#####XXXXXXXXXXXXXXXXXXXXXXXXXXXXXXXXXXXXXXXXXXX-XXXXXXXXXXXXXXXXX--XXXXXXXXXXXX
-M-----gg-######----####--###------g-g-tt-------------g-g----g------XXXXXXXXXXXXXXXXXXXXXXXXXXXXXXXXXXXXXXXXXXX-XXXXXXXXXXXXXXXXX--XXXXXXXXXXXX
XXXXXXXXXXXXXXX-----####--###--XXXXXXXXXXXXXXXXXXXXXXXXXXXXXXXXXXXXXXXXX-----------------------------------------------------------------------
XXXXXXXXXXXXXXX-XXXX--------#--XXXXXXXXXXXXXXXXXXXXXXXXXXXXXXXXXXXXXXXXX-----------------------------------------------------------------------
