----------------------------------------------------------------------------------------------------------------------------------------------------------------------------
----------------------------------------------------------------------------------------------------------------------------------------------------------------------------
----------------------------------------------------------------------------------------------------------------------------------------------------------------------------
----------------------------------------------------------------------------------------------------------------------------------------------------------------------------
----S!!S------------------------------------------------------------------------------------------S!!S----------------------------------------------------------------------
----------------------------------------------------------------------------------------------------------------------------------------------------------------------------
------------------------##----------------------------------S!!S----------------------------------------------------------------------------------------------------##------
-----------------------###---------------------------S!!S----------------------------------------------------------------------------------------------------------###------
-----SS---------------####-------------------------------------------------------------------------SS-------------------------------------------------------------####------
---------------------#####------------------------------------1-----------------------------------------1------##---------1----------------------------------1---#####------
--------------------######---------tt--------C---------------S---------!--!----------#--#---------------------###-----------------U----!--------------C-----S---######------
---#---------------g-g---#---------tt-----------------SS----------------------------##--##-------#-----------####----------------------------------------------------#------
---#--------tt-#--XXXX---#---------tt----------------------------------------------###--###------#----------#####--------------------------------tt-#----------------#------
-M-#--------tt##--XXXX---#---------tt-#----#--g-g----------g-g--------------#----#####--###------#---------######------g-g-------------k-#----#--tt##--g-g-----------#------
XXXXXXXXXXXXXXXXXXXXXXXXXXXXXXXXXXXXXXXXXXXXXXXXXXXXXXXXXXXXXXXXXXX--XXXXXXXXXXXXXXXXXXXXXXXXXXXXXXXXXXXXXXXX--XXXXXXXXXXXXXXXX--XXXXXXXXXXXXXXXXXXXXXXXXXXXXXXXXX--XXXXXXXX
XXXXXXXXXXXXXXXXXXXXXXXXXXXXXXXXXXXXXXXXXXXXXXXXXXXXXXXXXXXXXXXXXXX--XXXXXXXXXXXXXXXXXXXXXXXXXXXXXXXXXXXXXXXX--XXXXXXXXXXXXXXXX--XXXXXXXXXXXXXXXXXXXXXXXXXXXXXXXXX--XXXXXXXX
