----------------------------------------------------------------------------------------------------------------------------------------------------------tt---
------------------------------------------------------------------------------------------------------------------S!!S-------------------------------######----
----------------------------------------------------------------------------------------------------##----------------------------tt-------SS--------######----
---------------------------------------------------------------------------------------------------###---1------------------------tt-----------------######----
-----------------------------------------------------!--------------------------------------------####----------------------------tt---------------g------tt---
---------------------------##--------------------------------------------------------------------#####-------------SS--------#####XXXXXXXXXX--XXXXXXXXXXXXXXXX-
--------------!-----------###-------------------------------------------------------------------######-------------------tt-######XXXXXXXXXX--XXXXXXXXXXXXXXXX-
--##--#------------------####-------C-----S---------------------------------##--#----C-----S---###----g-g----------------tt########----------------------------
-###--##----------------#####----------------------S@S!S-----------#-------###--##-------------###XXXXXXXXXXXX--XXXXXXXXXXXXX----------------------------------
####--##---------------######--------------------------------------#------####--##-------------###XXXXXXXXXXXX--XXXXXXXXXXXXX-XXXX-----------------------------
####--##----S@S!S-----#####-tt-------g-g----tt-------------------gg#------####--##----g-g----g------tt------------------------XXXX-----------------------------
---#------------------#####XXXXXXXXXXXXXXXXXXXXXXXXXXXX--XXXXXXXXXXXXXXXXXXXXX--XXXXXXXXXXXXXXXXXXXXXXXX-------------------------------------------------------
---#------------------#####XXXXXXXXXXXXXXXXXXXXXXXXXXXX--XXXXXXXXXXXXXXXXXXXXX--XXXXXXXXXXXXXXXXXXXXXXXX-------------------------------------------------------
-M-#----------------g------tt----------------------------------------------------------------------------------------------------------------------------------
XXXXXXXXXXXXXXXXXXXXXXXXXXXXXXX--------------------------------------------------------------------------------------------------------------------------------
XXXXXXXXXXXXXXXXXXXXXXXXXXXXXXX--------------------------------------------------------------------------------------------------------------------------------
