-----------------------------###----###--##----------------###--##----!--------------!--!--######---------------S@S!S--------tt-!--!----------------
----------------------------####---####--##--------#------####--##-------------------------######----------------------------tt---------------------
---------------------------#####---####--##--------#------####--##--------tt-#-------------######---tt-#---------------------tt---------------------
--------------------------######------tt---------gg#----------g-g-----k---tt##-------------tt-------tt##----gg----------tt--------------------------
---------------##--#-----######XXXXXXXXXXXXXXXXXXXXXXXXXXXXXXXXXXXXXXXXXXXXXXXXXXXXXXXXXXXXXXXXXXXXXXXXXXXXXXXXXXXXXXXXXXXXXXXXXXXXXXXXXXXXXXXXXXXXX
--------------###--##----######XXXXXXXXXXXXXXXXXXXXXXXXXXXXXXXXXXXXXXXXXXXXXXXXXXXXXXXXXXXXXXXXXXXXXXXXXXXXXXXXXXXXXXXXXXXXXXXXXXXXXXXXXXXXXXXXXXXXX
---------tt-#####--##----######---------------------------------------------------------------------------------------------------------------------
---------tt##-------------g-g-----------------------------------------------------------------------------------------------------------------------
-------XXXXXXXXXXXXXXXXXXXXXX--##-------------------------------------------------------------------------------------------------------------------
-------XXXXXXXXXXXXXXXXXXXXXX-###-------------------------------------------------------------------------------------------------------------------
-------S--------######-------####-------------------------------------------------------------------------------------------------------------------
----------------#-----------#####-------------------------------------------------------------------------------------------------------------------
----------------#----------######-------------------------------------------------------------------------------------------------------------------
-M-----------g-g#-------g------tt-------------------------------------------------------------------------------------------------------------------
XXXXXXXXXXXXXXXXXXXXXXXXXXXXXXXXXXX-----------------------------------------------------------------------------------------------------------------
XXXXXXXXXXXXXXXXXXXXXXXXXXXXXXXXXXX-----------------------------------------------------------------------------------------------------------------
