--------------------------------------------------------------------------------------------------------------------------------------------------------
--------------------------------------------------------------------------------------------------------------------------------------------------------
--------------------------------------------------------------------------------------------------------------------------------------------------------
--------------------------------------------------------------------------------------------------------------------------------------------------------
-------------------------------------------------------------S!!S---------------------------------------------------------------------------------------
-------------------------##--------S!!S-----------------------------------------------------------------------------------------------------------------
------------------------###----------------------------------------------------------------S!!S------------##-------------------------------------------
-----------------------####-------------------------------------------------------------------------------###------------tt-----------------------------
----------------------#####----------------------##--#--------SS-----------------------------------------####------------tt-------------##--------------
---1-----------------######---------SS------C---###--##--##----------1----------------------------------#####------------tt------------###-------C-----S
--------------tt----#######--------------------####--##-###-------------------------!--!----SS---------######--t----######------------####--------------
--------------tt----#######--------------------####--######--##---------------------------------------#-------tt----######-----------#####--tt-#--------
--------------tt----#######-------g-g--------g-g-------####--##---------------------------------------#-------tt----######----------######--tt##--g-g---
-M------------tt--g------tXXXXXXXXXXXXXXXXXXXXXXXXXXX---------#------------------------------g-g#----##-------g-g-g------XXXXXXXXXXX--XXXXXXXXXXXXXXXXXX
XXXXXXXX--XXXXXXXXXXXXXXXXXXXXXXXXXXXXXXXXXXXXXXXXXXXXXXXXXXXXXXXXXXXXXXXX--XXXXXXXXXXXXXXXXXXXXXXXXXXXXXXXXXXXXXXXXXXXXXXXXXXXXXXXX--XXXXXXXXXXXXXXXXXX
XXXXXXXX--XXXXXXXXXXXXXXXXXXX------------------------XXXXXXXXXXXXXXXXXXXXX--XXXXXXXXXXXXXXXXXXXXXXXXXXXXXXXXXXXXXXXXXXXXXXXXX---------------------------
