--------------------------------------------------------------------------------------------------------------------------------------------------------
-----------------------------------------------------------------------------------------------------------##-----------------------------------1-------
-------------------------------------------------------------------------S!!S-----------------------------###---------------------S--------!--!---------
----------------------------------------------------SS---------------------------------------------------####-------------------------------------------
------------------!-------------------------------------------------------------------------------------#####-------------------------------------------
---------------------------------------------------------1---------------------------------------------######-----#----#--------------------------------
-------------S!!------------##--#---------U----!--######------------------SS----------C-----S---------######XXXXXXXXXXXXXXXXXXXXXXXXXXXXXXXXXXXXXXXXX--X
---------------------------###--##----------------######----------------------------------------------######XXXXXXXXXXXXXXXXXXXXXXXXXXXXXXXXXXXXXXXXX--X
----------------S@S!------####--##----------------######----------------------------------------------######--------------------------------------------
--------------------#----#####--##-------------k--tt-------------#----#-tt-------------g-g---#----#-g------tt-------------------------------------------
------tt------SS----XXXXXXXXXX--XXXXXXXXXXXXXXXXXXXXXXXXXXXXXX--XXXXXXXXXXXXXXXXXXXXXXXXXXXXXXXXXXXXXXXXXXXXXXX-----------------------------------------
------tt-----------#XXXXXXXXXX--XXXXXXXXXXXXXXXXXXXXXXXXXXXXXX--XXXXXXXXXXXXXXXXXXXXXXXXXXXXXXXXXXXXXXXXXXXXXXX-----------------------------------------
------tt-----------######----######---------------------------------------------------------------------------------------------------------------------
-M----tt-----gg----######--g------tt--------------------------------------------------------------------------------------------------------------------
XXXXXXXXXXXXXXXXXXXX--XXXXXXXXXXXXXXXX------------------------------------------------------------------------------------------------------------------
XXXXXXXXXXXXXXXXXXXX--XXXXXXXXXXXXXXXX------------------------------------------------------------------------------------------------------------------
