------------------------------------------------------------------------------------------------------------------------------------------------
------------------------------------------------------------------------------------------------------------------------------------------------
------------------------------------------------------------------------------------------------------------------------------------------------
------------------------------------------------------------------------------------------------------------------------------------------------
------------------------------------------------------------------------------------------------------------------------------------------------
------------------------------------------------------------------------------------------------------------------------------------------------
--------------------------------S!!S-------------------------------------------------------------!-----S!!S-------------------------------------
------------------------------------------------------------------------------------------------------------------------------------------------
---------------------------------------------------##-------##----------------------------!-----------------------------------------------------
--------------------------------------------------###------###--------------1-------------------------------------------##--#-------------------
---------tt-------S----tt--------SS--------------####-----####---------------------------------S@S!S----SS-------------###--##---------S--------
---------tt------------tt-----------------------#####----#####----------------------------#---------------------------####--##----tt-----#------
---------tt------------tt----------------------######---######----------tt-#----------tt-##---------------------------####--##----tt-----#------
-M--tt-------g-g-------tt------g-tt---------g-g----####--###-g-g----gg--tt##----------tt###-------g-g----g-g-g-g#----#----g-g-----tt-----#------
XXXXXXXXXXXXXXXXXXXXXXXXXXXXXXXXXXXXXXXXXXXXXXXXXXXXXXXXXXXXXXXXXXXXXXXXXXXXXXXXX--XXXXXXXXXXXXXXXXXXXXXXXXXXXXXXXXXXXXXXXXXXXXXXXXXXXXXXXXXXXXX
XXXXXXXXXXXXXXXXXXXXXXXXXXXXXXXXXXXXXXXXXXXXXXXXXXXXXXXXXXXXXXXXXXXXXXXXXXXXXXXXX--XXXXXXXXXXXXXXXXXXXXXXXXXXXXXXXXXXXXXXXXXXXXXXXXXXXXXXXXXXXXX
