----------------------------------------------------------------------------------------------------------------------------------------------------------------------
----------------------------------------------------------------------------------------------------------------------------------------------------------------------
----------------------------------------------------------------------------------------------------------------------------------------------------------------------
----------------------------------------------------------------------------------------------------------------------------------------------------------------------
----------------------------------------------------------------------------------------------------------------------------------------------------------------------
----------------------------------------------------------------------------------------------------S!!S--------------------------------------------------------------
---------------------------------!-----------------------------------------------------------------------------------------------------------------------##-----------
-----------------------------------------------------------------tt-------------------------------------------------------------------------------------###-----------
-----------------------------------------------------------------tt-------------------------##--#------------------------------------------------------####-----------
-----------------------------------------------------------------tt---------S--C-----S-!---###--##---SS--------##--#----------------------------------#####-----------
-----------C-----SU----!--#####S@S!S---!--!-U----!----------######------------------------####--##------------###--#-------------------!--!-----S----######-----------
---#----------------------#####-----------------------------######------------------------####--##-----------####--#--------------------------------------######------
---#----------------------#####----------------------tt-#---######--------------g-g----------g-g-------------####--#--------tt-#--------------------------######--F---
-M-#--------g-g--------k--g-g--------------------k---tt##-g------XXXXXXXXXXXXXXXXXXXXXXXXXXXXXXXXXXXXXXXXXX---------#----#--tt##----gg-------------tt-----######--#---
XXXXXXXXXXXXXXXXXXXXXXXXXXXXXXXXXXXXXXXXXXXXXXXXXXXXXXXXXXXXXXXXXXXXXXXXXXXXXXXXXXXXXXXXXXXXXXXXXXXXXXXXXXXXXXXXXXXXXXXXXXXXXXXXXXXXXXXXXXXXXXXXXXXXXXXXXXXXXXXXXXXXXX
XXXXXXXXXXXXXXXXXXXXXXXXXXXXXXXXXXXXXXXXXXXXXXXXXXXXXXXXXXXXXXXXXXXXX--------------------------------------XXXXXXXXXXXXXXXXXXXXXXXXXXXXXXXXXXXXXXXXXXXXXXXXXXXXXXXXXXX
