-------------------------------------------------------------------------------------------------------------------------------------------------------------
-------------------------------------------------------------------------------------------------------------------------------------------------------------
-------------------------------------------------------------------------------------------------------------------------------------------------------------
-------------------------------------------------------------------------------------------------------------------------------------------------------------
-------------------------------------------------------------------------------------------------------------------------------------------------------------
-------------------------------------------------------------------------------------------------------------------------------------##----------------------
----------------------------------------------------------------------------------------S!!S----------------------------------------###----------------------
------------------------------------------!-------------------------------##--#----------------------------------------------------####------##--#----C-----S
----------------------------------------------------------------------##-###--##----------------------------------##--------------#####-----###--##----------
---------------------------------------------------------------------#######--##------------------1--------------###-------------######----####--##----------
-------------tt----#-------S---------------------------U----!--!----########--##---------SS---------------------####------tt----######-----####--##----g-g---
-------------tt----##-------------------S@S!S----------------------#####---#------------------####-------------#####------tt----######-XXXXXXXX--XXXXXXXXXXXX
-------------tt----##----------tt-#-------------------------------######---#--------tt--------####------------######------tt----######-XXXXXXXX--XXXXXXXXXXXX
-M-----------####--##----------tt##-tt----------------------k-----------g-g#--------tt##----######------------gg----g-g---tt--g------tt----------------------
XXXXXXXXXXXXXXXXX--XXXXXXXXXXXXXXXXXXXXXXXXXXXXXXXXXXXXXXXXXXXXXXXXXXXXXXXXXXXXXXXXXXXXXXXXXXXXXXXXXXXX--XXXXXXXXXXXXXXXXXXXXXXXXXXXXXXXX--------------------
XXXXXXXXXXXXXXXXX--XXXXXXXXXXXXXXXXXXXXXXXXXXXXXXXXXXXXXXXXXXXXXXXXXXXXXXXXXXXXXXXXXXXXXXXXXXXXXXXXXXXX--XXXXXXXXXXXXXXXXXXXXXXXXXXXXXXXX--------------------
