------------------------------------------------------------------SS---------tt--------------------------------------------
----------S!!S---------------------------------------------------------------tt--------------------------------------------
-----------------------------------------------------------------------------tt--------------------------------------------
------------------------------------------------------------------#######------####-##--#----------------------------------
------------------------------------------------------------------#######------#######--##---------------------------------
-----------SS-----------------------------------------------------#######------#######--##---------------------------------
------------------S!!S---------------------------S!!S-------------------XXXXXXX---####--##---------------------------------
------------------------------------------------------------------------XXXXXXXXXX---######-##--#--------------------------
-----------#####---------------------------------------------------##---------XXXX---#########--##-------------------------
-----------#####--------------------------------------------------###----------------#########--##-------------------------
----tt-----#####---SS-------------C-----S---------SS-------------####----!--!--C-----S----####--##------S--C-----S-----S@S-
----tt-----#--------------#-------------------------------------#####-----------------XXXX---#-----------------------------
----tt-----#--------------#------------------------------------######-----------------XXXX---#-----------------------------
-M--tt-----#-------tt-----#--------g-g-------gg---######-----gg------g-g--------g-g-------g-g#--------------g-g------------
XXXXXXXXXXXXXXXXXXXXXXXXXXXXXXXXXXXXXXXXXXXXXXXXXXX--XXXXXXXXXXXXXXXXXXXXXXXXXXXXXXXXXXXXXXXXXXXXXXXXXXXXXXXXXXXXXXXXXXXXXX
XXXXXXXXXXXXXXXXXXXXXXXXXXXXXXXXXXXXXXXXXXXXXXXXXXX--XXXXXXXXXXXXXXXXXXXXXXXXXXXXXXXXXXXXXXXXXXXXXXXXXXXXXXXXXXXXXXXXXXXXXX
