--------------------------------------------------------------------------------------------------------------------------------------------------------------------------
--------------------------------------------------------------------------------------------------------------------------------------------------------------------------
--------------------------------------------------------------------------------------------------------------------------------------------------------------------------
----------------------------------------------------------------------------------------------1---------------------------------1-----------------------------------------
-------------------------------------------------------------------------------------------------------------------U----!-------------------S------------####-!--!--------
-----------------##-------------------------------------------------------------tt-----#-----------------------------------------------------------------####-------------
----------------###-----------S!!S-------##-------------------------------------tt-----#--------------------------------------------------------tt-#-----####-------------
---------------####---------------------###-------------------------------------tt-----#------------------g-g-----------k-----gg----------------tt##-------------------g-g
--------------#####--------------------####------------tt--------U----!----##XXXX--XXXXXXXXXXXXXXXX--XXXXXXXXXXXXXXXXXXXXXXXXXXXXXXXX--XXXXXXXXXXXXXXXXXXXXXXXXXXXXXXXXXXX
-------------######-------------------#####------------tt------------------##XXXX--XXXXXXXXXXXXXXXX--XXXXXXXXXXXXXXXXXXXXXXXXXXXXXXXX--XXXXXXXXXXXXXXXXXXXXXXXXXXXXXXXXXXX
----C-----S-------######-------SS----######------------tt------------------######-----------------------------------------------------------------------------------------
------------------######------------#-------------gg----g-g#----#-----k--g------tt----------------------------------------------------------------------------------------
-------------tt-#-######------------#XXXXXXXXXXXXXXXXXXXXXXXXXXXXXXXXXXXXXXXXXXXXXXX--------------------------------------------------------------------------------------
-M---g-g-----tt##-tt---------g-g----#XXXXXXXXXXXXXXXXXXXXXXXXXXXXXXXXXXXXXXXXXXXXXXX--------------------------------------------------------------------------------------
XXXXXXXXXXXXXXXXXXXXXXXXXXXXXXXXX-g------tt-------------------------------------------------------------------------------------------------------------------------------
XXXXXXXXXXXXXXXXXXXXXXXXXXXXXXXXXXXXXXXXXXXXX-----------------------------------------------------------------------------------------------------------------------------
