------------------------------------------------------------------------------------------------------------------------S!!S---------------------------------
--------------------------------------------------------------------------------------------------------------------------------S!!--------------------------
------------------------------------------------------------------------------------------------------------##S@S!S------------------------------------------
-----------------------------------------------------------------------------------------------------------###-----------------------------------------------
---------------------------------------------------------------------------------------------!------------####-----------SS------------!--------U----!-----S-
----------------------------------------------------------##---------------------------------------------#####---#---------------SS--------------------------
----------------------------------------------!----------###-----------------1--------------------------######---#-------------------------------------------
--------------------------------------------------------####-------------------------------------------###----g-g#-------g-g-----------g-g----gg-----k-------
-------------------------------------------------------#####-------------------------------S@S!S-------###XXXXXXXXXXXXXXXXXXXXXX--XXXXXXXXXXXXXXXXXXXXXXXXXXX
------------------------------------------------------######-------------------------------------------###XXXXXXXXXXXXXXXXXXXXXX--XXXXXXXXXXXXXXXXXXXXXXXXXXX
---U----!--!--!--------------S--C---------!-S@S!S----###----g-g-tt---------gg------------------------g------tt-----------------------------------------------
-----------------------------------------------------###XXXXXXXXXXXXXXXXXXXXXXXXXX--XXXXXXXXXXXXXXXXXXXXXXXXXXXX---------------------------------------------
-----------------------------------------------------###XXXXXXXXXXXXXXXXXXXXXXXXXX--XXXXXXXXXXXXXXXXXXXXXXXXXXXX---------------------------------------------
-M------k------------------------g-g-------g-g-g-g-g------tt-------------------------------------------------------------------------------------------------
XXXXXXXXXXXXXXXXXXXXXXXXXXXXXXXXXXXXXXXXXXXXXXXXXXXXXXXXXXXXXX-----------------------------------------------------------------------------------------------
XXXXXXXXXXXXXXXXXXXXXXXXXXXXXXXXXXXXXXXXXXXXXXXXXXXXXXXXXXXXXX-----------------------------------------------------------------------------------------------
