----------------------------------------------------------------------------------------------------------------------------------------------------------------------
----------------------------------------------------------------------------------------------------------------------------------------------------------------------
----------------------------------------------------------------------------------------------------------------------------------------------------------------------
--------------------------------------------------------------------------------------------------------------------------------------------------------tt------------
---------------------------------------------------------------------------------------------------------------------##---------------------------------tt------------
---------------------------------------------------------------------------------------##---------------------------###---------------------------------tt------##--#-
--------------------------S!!S--------------------------------------------------------###--------------------------####-------#--#---!--!----------###########-###--##
-------------------------------------------------------------------------------------####-------------------------#####------##--##----------------###############--##
------------------------------------------------------------------------------------#####------------------------######-----###--###---------------###############--##
---##--#--------------------------------------------------------##-----------------######----------S------------######-----####--###------#----#-g------tt------------
--###--##--------U----!----SS----------------------------S-----###----------------#######-----------------------######-XXXXXXXXXXXXXXXXXXXXXXXXXXXXXXXXXXXXX----------
-####--##-----------------------------------------------------####----------------#######-----------------------######-XXXXXXXXXXXXXXXXXXXXXXXXXXXXXXXXXXXXX----------
-####--##----------------------------------------------------#####----------------#######----------------gg----------g------tt----------------------------------------
-M--tt---------gg-----k-----g-g----gg#----#-----------------######-----------gg-g------tXXXXXXXXXXXXXXXXXXXXXXXXXXXXXXXXXXXXXXXX--------------------------------------
XXXXXXXXXXXXXXXXXXXXXXXXXXXXXXXXXXXXXXXXXXXXXXX--XXXXXXXXXXXXXXXXXXXXX--XXXXXXXXXXXXXXXXXXXXXXXXXXXXXXXXXXXXXXXXXXXXXXXXXXXXXXXX--------------------------------------
XXXXXXXXXXXXXXXXXXXXXXXXXXXXXXXXXXXXXXXXXXXXXXX--XXXXXXXXXXXXXXXXXXXXX--XXXXXXXXXXXXXXXXXXX---------------------------------------------------------------------------
