------------#--------#--------------------####------!----!--!---------##--#--------------------------
------------##-------#-------------------#####-----------------------###--##-------------------------
------------###------#------------------######----------------------####--##-------------------------
------------####----##-------------------------gg----g-g------#----#####--##---##--#-----------------
----------XXXXXXXXXXXXXXXXXXXXXXXXXXXXXXXXXXXXXXXXXXXXXXXXXXXXXXXXXX---######-###--##----------------
----------XXXXXXXXXXXXXXXXXXXXXXXXXXXXXXXXXXXXXXXXXXXXXXXXXXXXXXXXXX---##########--##----------------
-----------------------------------------------------------------------##########--##---##--#--------
--------------------------------------------------------------------------------######-###--##-------
--------------------------------------------------------------------tt----------##########--##-------
--------------------------------------------------------------------tt----------##########--##-------
----C-----S----------------##--#------tt----------------------------tt-------S----S------######------
-------------------tt-----###--##-----tt-----------------------#-------------------------######------
-------------------tt----####--##-----tt-------------tt-#------#-------------------------######--tt--
-M---g-g-----------tt----####--##-----tt-------------tt##------#--------g-g----------------------tt--
XXXXXXXXXXXXXXX--XXXXXXXXXXXX--XXXXXXXXXXXXXX--XXXXXXXXXXXXXXXXXXXXXXXXXXXXXXXXXXXXXXXXXXXXXXXXXXXXXX
XXXXXXXXXXXXXXX--XXXXXXXXXXXX--XXXXXXXXXXXXXX--XXXXXXXXXXXXXXXXXXXXXXXXXXXXXXXXXXXXXXXXXXXXXXXXXXXXXX
