------------------------------------------------------------##########--############--##-###--##-----------------
--------------------------------------------------------------------------##########--######--##-------##--------
-------------------------------------------------------XXXXXXXXXX-----XXXX--------------####--##------###--------
-----------------------------------------------------!-XXXXXXXXXX-----XXXX----------XXXX---######----####--------
--------!---------------------------------------------------------------------------XXXX---######---#####--------
------------------------------##-----------------------------------------------------------######--######--------
-----------------------------###------C-----S----------------------------------------U--XXXX--XXXXXXXXXX######---
----------------------------####-------------------S@S!S--------------------------------XXXX--XXXXXXXXXX######---
------S@S!S----------------#####---------------tt-#-----------------------------------------------------######---
--------------------------######-------g-g-----tt##--------------------gg#----#----gg-----k-----------g------tt--
-------------------tt----######XXXXXXXXXXXXXXXXXXXXXXXX--XXXXXXXXXXXXXXXXXXXXXXXXXXXXXXXXXXXXXXXXXXXXXXXXXXXXXXXX
---------#---------tt----######XXXXXXXXXXXXXXXXXXXXXXXX--XXXXXXXXXXXXXXXXXXXXXXXXXXXXXXXXXXXXXXXXXXXXXXXXXXXXXXXX
---------#---------tt----######----------------------------------------------------------------------------------
-M-------#---------tt--g------tt---------------------------------------------------------------------------------
XXXXXXXXXXXXXXXXXXXXXXXXXXXXXXXXXX-------------------------------------------------------------------------------
XXXXXXXXXXXXXXXXXXXXXXXXXXXXXXXXXX-------------------------------------------------------------------------------
