----------------------------------------------------------------------------------------------------------------------------------------------------
----------------------------------------------------------------------------------------------------------------------------------------------------
---------------------------------------------------------------------------------S!!S---------------------------------------------------------------
----------------------------------------------------------------------------------------------------------------------------------------------------
----------------------------------------------------------------------------------------------------------------------------------------------------
----------------------------------------------------------------------------------------------!----------------------!------------------------------
----------------------------------------------------------------------------------SS----------------------------------------------------------------
------------------tt--------------------------------------------------------------------------------------------------------------------------------
------------------tt--------------------------------------------------------------------------------------------------------------------------------
------------------tt-------#--#----------------!--!--------!--!----tt-------U----!######----S@S!S---------------tt-S@S!S-------!-----U----!---------
-------tt----###########--##--##-#---------------------------------tt-------------##########------#-------------tt----------------------------------
-------tt----###########-###--####--------------------tt-#---------tt---tt-#------##########------#-------------tt----------------------------------
-------tt----###############--####--------------------tt##---------tt---tt##-----k-----######--g-g#-------g-g---tt-----g-g-----k--g-g-----k--tt-----
-M-----g-g-g------tt----XXXXXXXXXXXXXXXXXXXXXXXXXXXXXXXXXXXXXXXXXXXXXXXXXXXXXXXXXXXXXXXX--XXXXXXXXXXXXXXXXXXXXXXXXXXXXXXXXXXXXXXXXXXXXXXXXXXXXXXXXXX
XXXXXXXXXXXXXXXXXXXXXX--XXXXXXXXXXXXXXXXXXXXXXXXXXXXXXXXXXXXXXXXXXXXXXXXXXXXXXXXXXXXXXXX--XXXXXXXXXXXXXXXXXXXXXXXXXXXXXXXXXXXXXXXXXXXXXXXXXXXXXXXXXX
XXXXXXXXXXXXXXXXXXXXXX------------------------------------------------------------------------------------------------------------------------------
