------------------------------------------------------------------------------------------------------------------------------------------------------------------------
------------------------------------------------------------------------------------------------------------------------------------------------------------------------
------------------------------------------------------------------------------------------------------------------------------------------------------------------------
------------------------------------------------------------------------------------------------------------------------------------------------------------------------
------------------------------------------------------------------------------------------------------------------------------------------------------------------------
------------------------------------------------------------------------------------------------------------------------------------------------------------------------
----------------------------------------------------------------------------------!-------------------------------------------------------------------------------------
----------------!----------------------------------------------------------------------------------------------------------tt----------------C-----S------U----!--------
---------------------------------------------------------------------------------------------------------------##----------tt--------######-----------------------------
--------------------------------------------------------------------------------------------------------------###----------tt--------######-----------------------------
--------C-----S-######--!--!-----------S---------##--#----!--!--C-----SU----!---S@S!S--------tt-----tt-------####-----####-tt--------######---g-g-------gg-----k-----g-g
----------------######--------------------------###--##--------------------------------------tt-----tt------#####-----####XXXXXXXXXXXX--XXXXXXXXXXXXXXXXXXXXXXXXXXXXXXXX
----------------######---------tt-#--------tt-#####--##--------------------------------------tt-----tt-----######-----####XXXXXXXXXXXX--XXXXXXXXXXXXXXXXXXXXXXXXXXXXXXXX
-M--g-g--g-g----tt-------------tt##--------tt######--##----------g-g--------k--g-g-tt--------tt-----#######-----#######-------------------------------------------------
XXXXXXXXXXXXXXXXXXXXXXXXXXXXXXXXXXXXXXXXXXXXXXXXXXX--XXXXXXXXXXXXXXXXXXXXXXXXXXXXXXXXXXXXXXXXXXXXXXX#######-----#######-------------------------------------------------
XXXXXXXXXXXXXXXXXXXXXXXXXXXXXXXXXXXXXXXXXXXXXXXXXXX--XXXXXXXXXXXXXXXXXXXXXXXXXXXXXXXXXXXXXXXXXXXXXXX#######-----#######-------------------------------------------------
