------------------------------------------------------------------------------------------###--##----------------------
-----------------------------------------------------------------------------------------####--##----------------------
-----------------------------------------------------------------------------------------####--##---##--#--------------
--------------------------------------------------------------------------------------------######-###--##-------------
---------------------------------S!!S-------------------------------------------------------##########--##-------------
--------------------------------------------------------------------------------------------##########--##---##--#-----
---------------S!!S-------!---------------------------------------##---------------------------------######-###--##----
-----------------------------------------------------------------###---------------------------------##########--##----
----------------------------------SS----------------------------####--------------------##----------###########--##----
------------------------------------------------------------#--#####-------------------###---------###--------######---
----------------SS------S@S!S--C-----S---------------------##-######-------##--#------####--------####--------######---
--------------------------------------#-------------------#####----######-###--##----#####-------#####--------######---
--------------------------------------#--------------tt--######----##########--##-#-######------######------g------tt--
-M-#----#-----------------------g-g---#--------------tt##----------##########--######--#########-----XXXXXXXXXXXXXXXXXX
XXXXXXXXXXXXXXXXXXXXXX--XXXXXXXXXXXXXXXXXXXXXXXXXXXXXXXXXXXXXXXXXX-tt------------####--#########-----XXXXXXXXXXXXXXXXXX
XXXXXXXXXXXXXXXXXXXXXX--XXXXXXXXXXXXXXXXXXXXXXXXXXXXXXXXXXXXXXXXXXXXXXXXXX---XXXX--------#######-----------------------
