----------------------------------------------------------------------------------------------
----------------------------------------------------------------------------------------------
---------------------------------------------------------------------------##-----------------
-----------------------------------------S!!S-----------------------------###-----------------
---------------------##--#-----------------------------------------------####-----------------
-----------------##-###--##-------------------------######--------------#####-----------------
----------------#######--##--1----------------------######-------------######-------##--#-----
---------------########-------------------------------------C-----------##########-###--##----
--------------#####---#-----------------------!-------------------------##############--##----
-------------######---#-------------------------------------------------##############--##----
------------###----g-g#-------!--!------C-----S----S---------g-g-----tt----tt--------######---
------------###XXXXXXXX-------------XXX--------------------#---------tt-XXXXXXX------######---
------------###XXXXXXXX--tt-#-------XXX--------------------#---------tt-XXXXXXX------######---
-M-#----#-g------tt------tt##-------g-g--g-g---------------#---------tt------------g------tt--
XXXXXXXXXXXXXXXXXXXXX--XXXXXXXXXXXXXXXXXXXXXXXXXXXXXXXXXXXXXXXXXXXXXXXXXXXXX--XXXXXXXXXXXXXXXX
XXXXXXXXXXXXXXXXXXXXX--XXXXXXXXXXXXXXXXXXXXXXXXXXXXXXXXXXXXXXXXXXXXXXXXXXXXX--XXXXXXXXXXXXXXXX
