--------------------------------------------------------------------------------------------------------------------------------------------------------------
--------------------------------------------------------------------------------------------------------------------------------------------------------------
--------------------------------------------------------------------------------------------------------------------------------------------------------------
--------------------------------------------------------------------------------------------------------------------------------------------------------------
--------------------------------------------------------------------------------------------------------------------------------------------------------------
--------------------------------------------------------------------------------------------------------------------------------------------------------------
-----------------------------S!!S-------------------------------------------------------------------------------------------------------------------!---------
--------------------------------------------------------------------------------------------------------------------------------------##--#-------------------
----------------------------------------------##-------------------------------------------------------------------------------------###--##------------------
--------------------------------------1------###------------------------------------------------------------------------------------####--##------------------
-------S--------!--!----------SS------------####------------U----!-------U-----tt------#----!-------#--#---!----------U----!--------####--##---C--S@S!S------#
-------------------------------#-----------#####-------------------------------tt-----##-----------##--##-------!------------#---------######---------------##
-----------------------tt-#----#----------######-------------------------------tt----###----------###--###-------------------#---------######--------------###
-M---------------------tt##-g-g#---------------tt----------------k------------k-----####--###----####--###-----------------k-#---------######---g-g-------####
XXXXXXXXXXXXXXXXXXXXXXXXXXXXXXXXXXXXXXXXXXX--XXXXXXXXXXXXXXXXXXXXXXXXXXXXXXXXXXXXXXXXXXXXXXXXXXXXXXXXXXXXXXXXXXXXXXXXXXXXXXXXXXXXXXXXXXX--XXXXXXXXXXXXXXXXXXXX
XXXXXXXXXXXXXXXXXXXXXXXXXXXXXXXXXXXXXXXXXXX--XXXXXXXXXXXXXXXXXXXXXXXXXXXXXXXXXXXXXXXXXXXXXXXXXXXXXXXXXXXXXXXXXXXXXXXXXXXXXXXXXXXXXXXXXXX--XXXXXXXXXXXXXXXXXXXX
