--------------------------------------------------------------------------------------------------------------------
------------------------------------------------------------------------------##--#---------------------------------
--------------------------------------------g-g--g-g-------gg---######-------###--##--------------------------------
----------------------------------------XXXXXXXXXXXXXXXXXXXXX---######------####--##--------------------------------
----------------------------------------XXXXXXXXXXXXXXXXXXXXX---#######----#####--##---##--#------------------------
----------------------------------------------------------------XXXXXXXXXXXX---######-###--##-----------------------
----------------------------S!!S--------------S!!S--------------XXXXXXXXXXXX---##########--##-----------------------
---------------------------------------------------------S@S!S-----------------##########--##-----------------------
----------------------------------------------------------------------------------------######----------------------
------------------------------------------------------------------------##------1-------######----------------------
--------------S----------t---SS----##--#-------SS-----------######-----###----S---------######-U----!---------------
-------------------------t--------###--##-------------------######----####--------------#---------------------------
-------------------------t--------###--##-------------------######---#####--------------#-----------------------tt--
-M-----g-g---------------tt--tt--####--##-----g-g----gg-------------######--------------#-----------k-----------tt--
XXXXXXXXXXXXXXXXXXXXXXXXXXXXXXXXXXXXXXXXXXXXXXXXXXXXXXXXXXXXXXXXXXXX--XXXXXXXXXXXXXXX--XXXXXXXXXXXXXXXXXXXXXXXXXXXXX
XXXXXXXXXXXXXXXXXXXXXXXXXXXXXXXXXXXXXXXXXXXXXXXXXXXXXXXXXXXXXXXXXXXX--XXXXXXXXXXXXXXX--XXXXXXXXXXXXXXXXXXXXXXXXXXXXX
