----------------------------------------------------------------------------------------------------------------------------------------------------------------------------
-----------------------------------------------------------------------------------------------------------------------------------------------------##---------------------
----------------------------------------------------------------------------------------------------------------------------------------------------###---------------------
---------------------------------------------------------------------------------------------------------------------------------------------------####-------S-------------
----------------------------------------------------------------------------------------------------------------------------------------##--------#####---------------------
---------------------------------------------------------------------------------------------------------------------------------------###-------######---------------------
-------------------------------------------------------------------------------------------------------------------------!--!---------####------###----g-g-------g------tt--
-----------------------------------------------------------------------------------------------------------------tt------------------#####------###XXXXXXXXXXXXXXXXXXXXXXXXX
------------------##---------------------------------------------------------##---------------##-----------------tt-----------------######------###XXXXXXXXXXXXXXXXXXXXXXXXX
----------1------###--------------------------------------------------------###--------------###-----------------tt---------------------------g------tt---------------------
---U----!-------####----------S--C-----S---tt------------------------------####-------------####------------##XXXX--XXXXXXXXXXXXXXXXXXXXXXXXXXXXXXXXXXXXX-------------------
---------------#####-----------------------tt-#---------------------------#####------------#####------------##XXXX--XXXXXXXXXXXXXXXXXXXXXXXXXXXXXXXXXXXXX-------------------
--------------######-----------------------tt-#--------------------------######-----------######-----tt-#---######----------------------------------------------------------
-M------k----------tt-------------g-g------tt-#-------------g-g----------g-g#----#-------tt-----g-g--tt##-g------tt---------------------------------------------------------
XXXXXXXXXXXXXXX--XXXXXXXXXXXXXXXXXXXXXXXXXXXXXXXXXXXXXXXXXXXXXXXXXXXXXXXXXXXXXXXXXXXXXXXXXXXXXXXXXXXXXXXXXXXXXXXXXXXX-------------------------------------------------------
XXXXXXXXXXXXXXX--XXXXXXXXXXXXXXXXXXXXXXXXXXXXXXXXXXXXXXXXXXXXXXXXXXXXXXXXXXXXXXXXXXXXXXXXXXXXXXXXXXXXXXXXXXXXXXXXXXXX-------------------------------------------------------
