----------------------------------------------------------------------------------------------------------------------------------------------------------------------
----------------------------------------------------------------------------------------------------------------------------------------------------------------------
----------------------------------------------------------------------------------------------------------------------------------------------------------------------
----------------------------------------------------------------------------------------------------------------------------------------------------------------------
----------------------------------------------------------------------------------------------------------------------------------------------------------------------
----------------------------------------------------------------------------------------------------------tt----------------------------------------------------------
------------------------------------------------------------------------------------S!!S------------------tt--------------######--------------------------------------
------------------------------------------------------------------------------------------------tt--------tt--------##--#-######------------------------------1-------
------------------------------------------------------------------------------------------------tt---#-------------###--########-----------------U----!-----S---------
-----------------1------------------------------------------------------------------------------tt---#--------tt-#####--###-------------------------------------------
----------C-----S----------------------S-----------------tt--C-----S------tt---------SS----######----#--------tt##-g-g--###-------------------------------------------
----------------------------!------------------#---------tt---------------tt---------------######XXXXXXXXXXXXXXXXXXXXX----#------------#----#-g-g-----k---------------
-------------------------------------------tt-##---------tt---------------tt---------------######XXXXXXXXXXXXXXXXXXXXXXXXXXXXXXXXXXXXXXXXXXXXXXXXXXXXXXXXXXXXXXXXXX--X
-M-----gg--g-g-----------------------------tt###---------tt---g-g----tt--------------#######--------------------------XXXXXXXXXXXXXXXXXXXXXXXXXXXXXXXXXXXXXXXXXXXXX--X
XXXXXXXXXXXXXXXXXXXXXX--XXXXX--XXXXXXXXXXXXXXXXXXXXXXXXXXXXXXXXXXXXXXXXXXXXXXXX------#######--------------------------------------------------------------------------
XXXXXXXXXXXXXXXXXXXXXX--XXXXX--XXXXXXXXXXXXXXXXXXXXXXXXXXXXXXXXXXXXXXXXXXXXXXXX#----########--------------------------------------------------------------------------
