------------------------------------------------------------------------------------------------------------------------------------------
------------------------------------------------------------------------------------------------------------------------------S!!S--------
-----------------------------------------------------------------------------------------tt-----------------------------------------------
-----------------------------------------------------------------------------------------tt-----------------------------------------------
-----------------------------------------------------------------------------------------tt-----------------------------------------------
--------------##---------tt--------------------------------------------------------------####----------------------------------SS---------
-------------###---------tt-----------------------1--------------------------------##--#-####---------------------------------------------
------------####---------tt---------S----------tt---------------------------------###--######----!----------S-----------------------------
--------#--#####----###########----------------tt--------------tt-------------#--####--###-----------------------------------######-------
-------##-######----###########----------------tt--------------tt-------------#--####--###----------------------tt-#---------######---F---
------#-------------###########----------------tt--------------t-tt---------gg#----------#-------tt-------------tt###----#---######---#---
------#XXXXXXXXXXXXX--XXXX--XXXXXXXXXXXXXXXXXXXXXXXXXXX--XXXXXXXXXXXXXXXXXXXXXXXXXXXXXXXXXXXXXXXXXXXXXXXXXXXXXXXXXXXXXXXXXXXXX--XXXXXXXXXX
------#XXXXXXXXXXXXX-XXXXX--XXXXXXXXXXXXXXXXXXXXXXXXXXX--XXXXXXXXXXXXXXXXXXXXXXXXXXXXXXXXXXXXXXXXXXXXXXXXXXXXXXXXXXXXXXXXXXXXX--XXXXXXXXXX
-M--g------tt--------XXXX-----------------------------------------------------------------------------------------------------------------
XXXXXXXXXXXXXXX---------------------------------------------------------------------------------------------------------------------------
XXXXXXXXXXXXXXX---------------------------------------------------------------------------------------------------------------------------
