--------------------------------------------------------------------------------------------------------------------------------------------
--------------------------------------------------------------------------------------------------------------------------------------------
--------------------------------------------------------------------------------------------------------------------------------------------
--------------------------------------------------------------------------------------------------------------------------------------------
--------------------------------S!!S------------------S!!S----------------------------------------------------------------------------------
--------------------------------------------------------------------------------------------------------------------------------------------
---------------------------------------------------------------------##--------------------------!------------------------------------------
--------------------------------------------------------------------###---------------------------------------------------------------------
-------------------------##------SS--------------------SS----------####--------------------------------------##----------##----------##-----
-----------##-----##----###-----------------------##--------------#####-------------------------------------###---------###---------###-----
----------###----###---####-----------------S----###-------------######-------------------C----S@S!S-------####--------####--------####-----
---------####---####--#####------#--------------####--##--------------######------------------------------#####-------#####-------#####-----
--------#####--#####-######------#--------------####--##--------------######---------tt-#----------------######------######------######-----
-M-----######-######------tt-----#---------------------#-------g-g----######---------tt##--g-g----tt----------#######-----#######-----XXXXXX
XXXXXXXXXXXXX--XXXXXXXXXXXXXXXXXXXXXXXXXXXXXXXXXXXXXXXXXXXXXXXXXXXXXXXX--XXXXXXXXXXXXXXXXXXXXXXXXXXXXXXXXXXXX-#######-----#######-----XXXXXX
XXXXXXXXXXXXX--XXXXXXXXXXXXXXXXXXXXXXXXXXXXXXXXXXXXXXXXXXXXXXXXXXXXXXXX--XXXXXXXXXXXXXXXXXXXXXXXXXXXXXXXXXXXX-#######-----#######-----------
