---------------------------------------------------------------------------------------------------------------------------------------------------------------------------
---------------------------------------------------------------------------------------------------------------------------------------------------------------------------
---------------------------------------------------------------------------------------------------------------------------------------------------------------------------
---------------------------------------------------------------------------------------------------------------------------------------------------------------------------
---------------------------------------------------------------------------------------------------------------------------------------------------------------------------
-------------------------------------------------------------------------------------------------------------##------------------------------------------------------------
---------------------------------------------------------------------------------!--------------------------###------------------------------------------------------------
-----------------------------------------------------------------------------------------------------------####-------S----tt--!--!-----U----!----tt------####---tt--------
---------------------------------------------------------------##-----------------------------------------#####------------tt---------------------tt------####---tt--------
---------------------------1---------##-----------------------###----------------------------------------######------------tt---------------------tt------####---tt--------
------------------tt--!--!----------###----------------------####---U----!-----S@S!S-----S--------------###----g-g---------tt--------g-g-----k----tt-------------tt-----g-g
---------tt-------tt---------------####---------------------#####---------------------------------------###XXXXXXXXXXXXXXXXXXXXXXXXXXXXXXXXXXXXXXXXXXXXXXXXXXXXXXXXXXXXXXXX
---------tt-------tt--------------#####--------tt-#--------######---------------------------------------###XXXXXXXXXXXXXXXXXXXXXXXXXXXXXXXXXXXXXXXXXXXXXXXXXXXXXXXXXXXXXXXX
-M-------tt-------tt-------------######--------tt##-------g-g----g-g-----k-----gg-g-g-------g-g-------g------tt------------------------------------------------------------
XXXXXXXXXXXXXXXXXXXXXXXXXXXXXXXX--XXXXX--XXXXXXXXXXXXXXXXXXXXXXXXXXXXXXXXXXXXXXXXXXXXXXXXXXXXXXXXXXXXXXXXXXXXXXXX----------------------------------------------------------
XXXXXXXXXXXXXXXXXXXXXXXXXXXXXXXX--XXXXX--XXXXXXXXXXXXXXXXXXXXXXXXXXXXXXXXXXXXXXXXXXXXXXXXXXXXXXXXXXXXXXXXXXXXXXXX----------------------------------------------------------
