---------------------------------------------------------------------------------------------------------------------------------------------------------------
---------------------------------------------------------------------------------------------------------------------------------------------------------------
---------------------------------------------------------------------------------------------------------------------------------------------------------------
---------------------------------------------------------------------------------------------------------------------------------------------------------------
---------------------------------------------------------------------------------------------------------------------------------------------------------------
---------------------------------------------------------------------------------------------------------------------------------------------------------------
-----------------------!----------------------------------------------------------------------------------##---------------------------------------------------
---------------------------------------------------------------------------------------------------------###---------------------------------------------------
-----------------------------------------------------------------##--------------------------##---------####---------------------------------------------------
---1-----------------------------------------------1------------###-------------------------###--------#####---------------------------------------------------
-----------------tt--S@S!S------#--#--------#------------------####------##--#----!--!-----####-------######---------------------------------------------------
-----------------tt-------------#--##------##-----------------#####-----###--##-----------#####------------#--------------------------tt----------------######-
-----------------tt---------tt-##--##-----###----------------######----####--##----------######------------#--------------------------tt------------tt-#######-
-M----------g-g-------------tt###--##-----g-g----gg---------tt---------####--##---------g-g----------------#------#----#----gg--------tt-g-g--------tt##----g-g
XXXXXXXX--XXXXXXXXX--XXXXXXXXXXXXXXXXXXXXXXXXXXXXXXXXXXX--XXXXXXXXXXXXXXXXX--XXXXXXXXXXXXXXXXXX--XXXXXXXXXXXXXXXXXXXXXXXXXXXXXXXXX--XXXXXXXXXXXXXXXXXXXXXXXXXXX
XXXXXXXX--XXXXXXXXX--XXXXXXXXXXXXXXXXXXXXXXXXXXXXXXXXXXX--XXXXXXXXXXXXXXXXX--XXXXXXXXXXXXXXXXXX--XXXXXXXXXXXXXXXXXXXXXXXXXXXXXXXXX--XXXXXXXXXXXXXXXXXXXXXXXXXXX
