----------------------------------------------------------SS----------------SS----------------------------------
----------------------------------------------------------------------------------------------------------------
----------------------------------------------------------------------------------------------------------------
-----------------------------------------------------gg---g-g----------gg-######---##--#------------------------
-------------------------------------------------XXXXXX--XXXXXXXXXXXXXXXX-######--###--##-----------------------
-------------------------------------------------XXXXXX--XXXXXXXXXXXXXXXX-######-####--##-----------------------
--------------------------------------------------------------------------g-g----####--##---##--#---------------
-------------------------------------------------------------------------XXXXXXXX---######-###--##--------------
---------------------------------##-----------------SS-----##------S@S!S-XXXXXXXX---##########--##--------------
--------------------------------1-------------------------###-----------------------##########--##--------------
----------------C-----S--------#--------U----!-----------####--------------------------------######-------------
------------------------------##------------------####--#####---------#-----------tt---------######-------------
-----------tt-#--------------###------------------####-######---------#-----------tt---------######---------F---
-M-#----#--tt##--g-g-------------------------k----######-----g-g----gg#-----------tt---------tt-------------#---
XXXXXXXXXXXXXXXXXXXXXXXXXXXXXXXXXXXXX--XXXXXXXXXXXX--XXXXXXXXXXXXXXXXXXXXXXXXXXXXXXXXXXXXXXXXXXXXXXXXXXXXXXXXXXX
XXXXXXXXXXXXXXXXXXXXXXXXXXXXXXXXXXXXX--XXXXXXXXXXXX--XXXXXXXXXXXXXXXXXXXXXXXXXXXXXXXXXXXXXXXXXXXXXXXXXXXXXXXXXXX
