-----------------------------------------------------------------------------------------------------------------------------------!----------------
----------------------------------------------------------------------------------------------------------------------------------------------------
--------------------------------------------------------------S!!-----------------------------------------------------------------------------------
------------------------------------------------------------------------------------------------------------------------------------------!---------
-----------------------------------------------------------------------------------------------------------------##--------------S@S!S--------------
---------------------------------------------------##--------------##--#----------------------------------------###---------------------------------
--------------------------------------##--#-------###----------SS-###--##---------------C-----S-!--!--C--------##1-------##--#----------------------
-------------------------------------###--##-----####------------####--##-------------------------------------###--------##--##-----######S!S-------
--------------------------------tt-#####--##----#####------------####--##----------tt-#----------------------####--------##--##-----######----------
---1----------------------------tt######--##---######---------------tt-------------tt##--g-g-----------g-g-----tt--------##--##-----######----------
--------------------#--#----##XXXXXXXXXX--XXXXXXXXXXXXXXXXXXXXXXXXXXXXXXXXXXXXXXXXXXXXXXXXXXXXXXXXXXXXXXXXXXXXXXX---------tt---------g-g-g------tt--
-------------------##--##--###XXXXXXXXXX--XXXXXXXXXXXXXXXXXXXXXXXXXXXXXXXXXXXXXXXXXXXXXXXXXXXXXXXXXXXXXXXXXXXXXXXXXXXX--XXXXXXXXXXXXXXXXXXXXXXXXXXXX
-------------tt-#-###--#######--##-----######--------------------------------------------------------------------XXXXX--XXXXXXXXXXXXXXXXXXXXXXXXXXXX
-M-----------tt######--#######--##---g------tt------------------------------------------------------------------------------------------------------
XXXXXXXX--XXXXXXXXXXXXXXXXXXXX--XXXXXXXXXXXXXXXX----------------------------------------------------------------------------------------------------
XXXXXXXX--XXXXXXXXXXXXXXXXXXXX--XXXXXXXXXXXXXXXX----------------------------------------------------------------------------------------------------
