-----------------------------------------------------------------------------###-------------------------------------------------------------
----------------------------------------------------------------------------####-------------------------------------------------------------
-------------------------------------------------------tt------------------#####-------------------------------------------------------------
-------------------------------------------------------tt-----------------######------U----!-------tt-------!--!--C-----S-------!--!-S@S!S---
-------------------------------------------------------tt------##--#-----#######-------------------tt----------------------------------------
----------------------------------------##--------###########-###--##----#######-------------------tt----------------------------------------
------------------------!--------------###--------###############--##----#######-----------k--g-g------------------g-g-------------------g-g-
--------------------------------------####---!--!-###############--##--g------tXXXXXXXXXXXXXXXXXXXXXX--XXXXXXXXXXXXXXXXXXXXXXXXXXXXXXXXXXXXX-
-------------------------------------#####--------#-------------XXXXXXXXXXXXXXXXXXXXXXXXXXXXXXXXXXXXX--XXXXXXXXXXXXXXXXXXXXXXXXXXXXXXXXXXXXX-
---1--------------------------------######--------#-------------XXXXXXXXXXXXXXXXXX-----------------------------------------------------------
-----------U----!--!--S@S!S--------#####-g-g------#--------------S@S-------------------------------------------------------------------------
-----------------------------------#####XXXXXXXXXXXXXXXXX------------------------------------------------------------------------------------
-----------------------------------#####XXXXXXXXXXXXXXXXX------------------------------------------------------------------------------------
-M--------------k--------g-g-------tt--------------------------------------------------------------------------------------------------------
XXXXXXXX--XXXXXXXXXXXXXXXXXXXXXXXXXXXXXXXXXXXX--XXXXXXXXX--XXXXXXXXXX------------------------------------------------------------------------
XXXXXXXX--XXXXXXXXXXXXXXXXXXXXXXXXXXXXXXXXXXXX--XXXXXXXXX--XXXXXXXXXX------------------------------------------------------------------------
