---------------------------------------------------------------------------------------------------------------------------------------------------------------
-------------------------------------------------------------------------------------------------------------##-------------------tt---------------------------
-----------------------------------------------------------------------##-----------------------------------###---1---------------tt----------------##--#------
----------------------------------------------------------------------###------!--!------SS-------S--------####------------C------tt----------tt---###--#----S-
---------------------------------------------------------------------####---------------------------------#####-------------------#-----------tt---###--#------
--------------------------------------------------------------------#####--------------------------------######-------------------#-----------tt---###--#------
-------------------------------------------------------------------######---------------g-g--g-g----------------------------g-g---#-------------------g-g------
-------------------------------------------------tt------#--#-----######XXXXXXXXXXXXXXXXXXXXXXXXXXXXXXXXXXXXXXXXXXXXXXX--XXXXXXXXXXXXXXXXXXXXXXXXXXXXXXXXXXXXXX
-------------------------------------------------tt-----##--##----######XXXXXXXXXXXXXXXXXXXXXXXXXXXXXXXXXXXXXXXXXXXXXXX--XXXXXXXXXXXXXXXXXXXXXXXXXXXXXXXXXXXXXX
-------------------------------------------------tt----###--###---######---------------------------------------------------------------------------------------
----######----!-----------------------tt----######----####--###-g------tt--------------------------------------------------------------------------------------
----######------------------#---------tt----######XXXXXXXXXXXXXXXXXXXXXXXXX------------------------------------------------------------------------------------
----######------------------#---------tt----######XXXXXXXXXXXXXXXXXXXXXXXXX------------------------------------------------------------------------------------
-M--tt---------g-g#----#----#---------tt--g------tt------------------------------------------------------------------------------------------------------------
XXXXXXXXXXXXXXXXXXXXXXXXXXXXXXXXXXXXXXXXXXXXXXXXXXXXX----------------------------------------------------------------------------------------------------------
XXXXXXXXXXXXXXXXXXXXXXXXXXXXXXXXXXXXXXXXXXXXXXXXXXXXX----------------------------------------------------------------------------------------------------------
