------------------------------------------------------------------------------------------------------------------------------------------------------------------
------------------------------------------------------------------------------------------------------------------------------------------------------------------
---------------------------------------------------------------------------------!----------##----------------------S!!S------------------------------------------
-------------------------------------------------------------------------------------------###--------S!!S--------------------------------------------------------
-------------------------------------------------------------------------------------------###--------------------------------------------------------------------
--------------------------------------------------##---------------------1-----------------###--------------------------------------------------------------------
------------------------------------S------------###-----tt-----------tt-------S@S----tt---###-----------------!-----SS-----------U----!-------U----!-------------
-------------------tt---------------------------####-----tt-----------tt--------------tt-----#---------SS---------------------------------------------------------
-------##----------tt-------------------tt-#----####-----tt-----------tt--------------tt-----#--------------------------------tt-#--------------------------------
------###----------tt-----#----#--------tt##-------g-g---tt-----g-g---tt----------g-g-tt-----#-----------------------tt-------tt##-----k------------k--g------tt--
-----####-----##XXXX--XXXXXXXXXXXXXXXXXXXXXXXXXXXXXXXXXXXXXXXXXXXXXXXXXXXXXXXX--XXXXXXXXXXXXXXXXXXXXXXXX--XXXXXXXXXXXXXXXXXXXXXXXXXXXXXXXXXXXXXXXXXXXXXXXXXXXXXXXX
----#####-----##XXXX--XXXXXXXXXXXXXXXXXXXXXXXXXXXXXXXXXXXXXXXXXXXXXXXXXXXXXXXX--XXXXXXXXXXXXXXXXXXXXXXXX--XXXXXXXXXXXXXXXXXXXXXXXXXXXXXXXXXXXXXXXXXXXXXXXXXXXXXXXX
---######-----######----------------------------------------------------------------------------------------------------------------------------------------------
-M------g-g-g------tt---------------------------------------------------------------------------------------------------------------------------------------------
XXXXXXXXXXXXXXXXXXXXXXX-------------------------------------------------------------------------------------------------------------------------------------------
XXXXXXXXXXXXXXXXXXXXXXX-------------------------------------------------------------------------------------------------------------------------------------------
