--------------------------------------------------------------------------------------------------------------------------------------------------------------------------
--------------------------------------------------------------------------------------------------------------------------------------------------------------------------
--------------------------------------------------------------------------------------------------------------------------------------------------------------------------
--------------------------------------------------------------------------------------------------------------------------------------------------------------------------
--------------------------------------------------------------------------------------------------------------------------------------------------------------------------
----------------------------------------------------------------------------------------------------------------------------##--------------------------------------------
---------------------------------------------------------------------------------------------------------------------------###--------------------------------------------
--------------------------------------------------------------------------------------------------------------------------####-------------------------C-----tt---------#-
-----------------------------------------##------------------------------------------------------------------------------#####-----------------tt------------tt----tt---##
----------------------------------------###-----------------------------------------------------------------------------######-----------------tt------------tt----tt---##
---------------tt------S----tt---------####------tt---------------------U----!---------------------U----!------!--!----#####-g-g----------g----tt-------g-g--------tt---##
---------------tt-----------tt--------#####------tt---------tt---------------------------------------------------------#####XXXXXXXXXXXXXXXXXXXX--XXXXXXXXXXXXXX---tt-----
---------------tt-----------tt-------######------tt---------tt---------------------------------------------------------#####XXXXXXXXXXXXXXXXXXXX--XXXXXXXXXXXXXXXXXXXXXXXX
-M--------------g-g---------tt-------------------tt--tt-----tt---------------k-----gg-----------g-g-----k--g-g-------g------tt----------------------------------XXXXXXXXXX
XXXXXXXXXXXXXXXXXXXXXXXXXXXXXXXXXXXXXXXXXXXXXXXXXXXXXXXXXXXXXXXXXXXXXXXXXXXXXXXXXXXXXXXXX--XXXXXXXXXXXXXXXXXXXXXXXXXXXXXXXXXXXXX------------------------------------------
XXXXXXXXXXXXXXXXXXXXXXXXXXXXXXXXXXXXXXXXXXXXXXXXXXXXXXXXXXXXXXXXXXXXXXXXXXXXXXXXXXXXXXXXX--XXXXXXXXXXXXXXXXXXXXXXXXXXXXXXXXXXXXX------------------------------------------
