-----------------------------------------------------------------------------------------------------------------------------------------------------------
-----------------------------------------------------------------------------------------------------------------------------------------------------------
-----------------------------------------------------------------------------------------------------------------------------------------------------------
-----------------------------------------------------------------------------------------------------------------------------------------------------------
-----------------------------------------------------------------------------------------------------------------------------------------------------------
----------------------------------------------------------------------------------------------------------------------##---------------------##------------
------------------------------------------------------------------------------S!!S-----------------------------------##-----##--#-----------###------------
-----------------------------------------------!--------------------------------------------------------------------###----###--##---------####------------
--------------------------------------------------------------------------tt---------------------------------------####---####--##--------#####------------
---------1----------------------------------------------------------------tt--------------------------------------#####---####--##-----U-######------------
------------------------------------!----C---------------------#--#-------tt---SS---U----!-----S-------U----!----######------#----------------#------------
-------------------------------t-------------S@S!S------------##--##-#-------------------------------------------######--tt-##----------------#--------F---
-------------------tt-#--------t------------------------tt-#-###--####-------------------------------------------######--tt###--------------k-#--------#---
-M-----gg----------tt##--------tt----g-g--g-g-----------tt######--####-------tt----------k-----------gg-----k--g------tXXXXXXXXXXXXXXXXXXXXXXXXXXXXXXXXXXXX
XXXXXXXXXXXXXX--XXXXXXXXXXX--XXXXXXXXXXXXXXXXXXXXXXXXXXXXXXXXXXXXXXXXXXXXXXXXXXXXXXXXXXXXXXXXXXXXXXXXXXXXXXXXXXXXXXXXXXXXXXXXXXXXXXXXXXXXXXXXXXXXXXXXXXXXXX
XXXXXXXXXXXXXX--XXXXXXXXXXX--XXXXXXXXXXXXXXXXXXXXXXXXXXXXXXXXXXXXXXXXXXXXXXXXXXXXXXXXXXXXXXXXXXXXXXXXXXXXXXXXXXXXXXXXXXXXX---------------------------------
