--------------------------------------------------------------------------------------------------------------------------------------------------------------------------------------------
--------------------------------------------------------------------------------------------------------------------------------------------------------------------------------------------
--------------------------------------------------------------------------------------------------------------------------------------------------------------------------------------------
--------------------------------------------------------------------------------------------------------------------------------------------------------------------------------------------
--------------------------------------------------------------------------------------------------------------------------------------------------------------------------------------------
--------------------------------------------------------------------------------------------------------------------------------------------------------------------------------------------
----------------------------------------------------------------------------------S!!S------------------------------------------------------------------------##----------------------------
-------------------------------------------------------------------------------------------------------------------------------------------------------------##-----------------------------
---------------------------------------------------------------------------------------------------------##-------------------------------------------------###-----------------------------
---------------------1----------------------------------------------------------------------------------###----------------------------------------##--#---####---------------1-------------
--------C-----S----S-----------------------------------------S-------U----!--------SS------------------####---------C-----S-------------C-----S---###--##-#####--##--#----------------------
------------------------------------------------------------------------------------------------------###----------------------------------------####--########-###--##---------------------
-----------------------------------------------------------------------------------------------------####----------------------------------------####--############--##---------------------
-M--g-g--g-g-----------------#----#--------------------gg-----------------k--------------------------g-g#-------g-g--g-g---#----#----gg--g-g-----tt##----##########--##-----gg--------#----#
XXXXXXXXXXXXXXXXXXXXXXXXXX--XXXXXXXXXXX--XXXXXXXXXXXXXXXXXXXXXXXXXXXXXXXXXXXXXXXXXXXXXXXXXXXXXXXXXXXXXXXXXXXXXXXXXXXXXXXXXXXXXXXXXXXXXXXXXXXXXXXXXXXXXXXX---------XXXXXXXXXXXXXXXXX--XXXXXXX
XXXXXXXXXXXXXXXXXXXXXXXXXX--XXXXXXXXXXX--XXXXXXXXXXXXXXXXXXXXXXXXXXXXXXXXXXXXXXXXXXXXXXXXXXXXXXXXXXXXXXXXXXXXXXXXXXXXXXXXXXXXXXXXXXXXXXXXXXXXXXXXXXXXXXXX-XXXX----XXXXXXXXXXXXXXXXX--XXXXXXX
