---------####--##-###--##-------------------------------------------
---------####--######--##-------------------------------------------
-----------------####--##-------------------------------------------
-------------XXXX---######-##--#------------------------------------
-------------XXXX---#########--##-----------------------------------
--------------------#########--##-----------------------------------
-----------------##------####--##---##--#---------------------------
----------------###--XXXX---######-###--##--------------------------
---------------####--XXXX---##########--##--------------------------
--------------#####---------##########--##---##--#------------------
-----------S-######------------------######-###--##-------------S@S-
-------------------------------------##########--##-----------------
-------------------------------------##########--##-----------------
-M--tt---------g-g#----------gg-g-g-----------tt-----#----#---------
XXXXXXXXXXXXXXXXXXXXXXXXXXXXXXXXXXXXXXX--XXXXXXXXXXXXXXXXXXXXXXXXXXX
XXXXXXXXXXXXXXXXXXXXXXXXXXXXXXXXXXXXXXX--XXXXXXXXXXXXXXXXXXXXXXXXXXX
