----------------------------------------###---------------------------------------------------------------------------------#####-----
---------------------------------------####-!-----tt--!--!--C----------------S----------------!--!------!--!-----U----!----######-----
----------------------------tt--------#####-------tt---------------!-------------------tt---------------------------------------######
-----------------!----------tt-------######-------tt-----------------------------------tt---------------------------------------######
----------------------------tt--------------------g-g--------g-------------------------tt-g-g-------g-g-------g-g-----k--g-g----######
-----------##----------##XXXX--XX-----##--XXXXXXXXXXXXXXXXXXXXXXXXXXXXXXXXXXXXXXXXX--XXXXXXXXXXXXXXXXXXXXXXXXXXXXXXXXXXXXXXXXXXX------
----------###----------##XXXX--XX----###--XXXXXXXXXXXXXXXXXXXXXXXXXXXXXXXXXXXXXXXXX--XXXXXXXXXXXXXXXXXXXXXXXXXXXXXXXXXXXXXXXXXXX------
---------####--S@S!S---######-------####----------------------------------------------------------------------------------------------
--------#####----------#-----------#####----------------------------------------------------------------------------------------------
-------######----------#----------######----------------------------------------------------------------------------------------------
------#####-tt---------#-------g------tt----------------------------------------------------------------------------------------------
------#####XXXXXXXXXXXXXXXXXXXXXXXXXXXXXXX--------------------------------------------------------------------------------------------
------#####XXXXXXXXXXXXXXXXXXXXXXXXXXXXXXX--------------------------------------------------------------------------------------------
-M--g------tt-------------------------------------------------------------------------------------------------------------------------
XXXXXXXXXXXXXXX-----------------------------------------------------------------------------------------------------------------------
XXXXXXXXXXXXXXX-----------------------------------------------------------------------------------------------------------------------
