-------------------------------------------------------------------------------------------------------------------------S!!S---------------------------------------------------
--------------------------------------------------------------------------------------------------------------------------------------------------------------------------------
--------------------------------------------------------------------------------------------------------------------------------------------------------------------------------
--------------------------------------------------------------------------------------------------------------------------------------------------------------------------------
--------------------------------------------------------------------------------------------------------------------------SS----------------------------------------------------
---------------------------------------------------------------------------------------##--------------------------------------------------------------------------------##-----
--------------##----------------------------------------------------------------------###-------------------------------------------------------------------------------###-----
-------------###---------------------------------------------------------------------####--------------------S----------####------U----!--------U----!----tt--C--------####-----
------------####------------------------------!-------------------------------------#####-------------------------------####-------------#----------------tt----------#####-----
-----------#####-------------------------------------1-----------------------------######-----tt-#----------------------####--tt-#-------#----------------tt---------######-----
------tt--######-------S-----------------!-----------------------S----------------#-----------tt##----g-g----------gg----g-g--tt##-----k-#-----------k----tt---g-g--------######
------tt-#----------------------tt------------#-----------------------------------#XXXXXXXXXXXXXXXXXXXXXXXXXXXXXXXXXXXXXXXXXXXXXXXXXXXXXXXXXXXXXXXXXXXXXXXXXXXXXXXXXXXXXX-######
------tt-#----------------------tt------------#-----------------------------------#XXXXXXXXXXXXXXXXXXXXXXXXXXXXXXXXXXXXXXXXXXXXXXXXXXXXXXXXXXXXXXXXXXXXXXXXXXXXXXXXXXXXXX-######
-M----tt-#--------g-g-----------tt------------#--------------------#----#-------g------tt---------------------------------------------------------------------------------------
XXXXXXXXXXXXXXXXXXXXXXXXXXXX--XXXXXXXXXXXXXXXXXXXXXXXXXXXX--XXXXXXXXXXXXXXXXXXXXXXXXXXXXXXX-------------------------------------------------------------------------------------
XXXXXXXXXXXXXXXXXXXXXXXXXXXX--XXXXXXXXXXXXXXXXXXXXXXXXXXXX--XXXXXXXXXXXXXXXXXXXXXXXXXXXXXXX-------------------------------------------------------------------------------------
