-------------------------------------------------------------------------------------------!--!-------------------------------
-----------------------------------------------------------------------------------------------------tt-----------------------
-----------------------------------------------------------------------------------------------------tt-----------------------
-----------------------------------------------------------------------------------------------------tt-----------------------
------------------------------------------------S!!S--------------------------------------XXXXXXXXXXXX#####-------------------
------------------------------------------------------------------------------------------XXXXXXXXXXXX#####-##--#-------------
----------------------------------------------------------------------------------S!!S---------------#########--##------------
-----------------------!-----------------------------------------------------------------------------#------##--##---tt-------
-------------------------------------------------SS------------------##------------------------------#------##--##---tt-------
--------------------------------------------------------------------###------------------------------#-------g-g-----tt-------
---------------tt-------------------------U------------------!-----####------------SS------------S--!XXXXXXXXXXXXXXXXX#####---
---------------tt----S@S!S---------------t-------#----------------#####------------------------------XXXXXXXXXXXXXXXXX#####---
---------------tt---------------tt-#-----t-------#---------------######-----tt-#-------------------------------------######---
-M-------------tt---------------tt##-----t-----k-#--------------------------tt##----g-g----gg----------------------g------tt--
XXXXXXXXXXXXXXXXXXXXXXXXXXXXXXXXXXXXXXXXXXXXXXXXXXXXXXXXXXXXXXXXXXXXXXXXXXXXXXXXXXXXXXXXXXXXXXXXXXXXXXXXXXXXXXXXXXXXXXXXXXXXXX
XXXXXXXXXXXXXXXXXXXXXXXXXXXXXXXXXXXXXXXXXXXXXXXXXXXXXXXXXXXXXXXXXXXXXXXXXXXXXXXXXXXXXXXXXXXXXXXXXXXXXXXXXXXXXXXXXXXXXXXXXXXXXX
