--------------------------------------------------------------------------------------------------------------------------------------------------------------------------------
--------------------------------------------------------------------------------------------------------------------------------------------------------------------------------
--------------------------------------------------------------------------------------------------------------------------------------------------------------------------------
--------------------------------------------------------------------------------------------------------------------------------------------------------------------------------
--------------------------------------------------------------------------------------------------------------------------------------------------------------------------------
--------------------------------------------------------------------------------------------------------------------------------------------------------------------------------
----------------------------------------------------S!!S-----------------------------------------------------------!------------------------------------------------------------
-----------------------------------------------------------------------------------------------------!--------------------------------------------------------------------------
--------------------------------------------------------------------------------------------------------------------------------------------------------------------------------
-------------------------------##-------------------------1----------------------------------------------------------------1----------------------------------------------------
------------#--#---C-----S----###--------------------SS-------------------------------!-------!--!---------------S@S!S-------------U----!-----tt--------##--#----!--!----tt-----
-----------##--##------------####---------------------------------------#--------------------------S@S!S--------------------------------------tt-------###--##-----------tt-----
-----tt-#-###--###----------#####---------------------------------------#---------------------------------------------------------------------tt------####--##-----------tt-----
-M---tt######--###--g-g----######---------------gg-tt-------------#----##-------------tt-------------------------gg-tt------------------k-------------####--##-----------tt--g-g
XXXXXXXXXXXXXXXXXXXXXXXXXXXXXXXXXXXXXXXXXXXXXXXXXXXXXXXXXXXXXXX--XXXXXXXXXXXXXXXXXXXXXXXXXXXXXXXXXXXXXX--XXXXXXXXXXXXXXXXXXXXXXX--XXXXXXXXXXXXXXXXXXXXXXXX--XXXXXXXXXXXXXXXXXXXX
XXXXXXXXXXXXXXXXXXXXXXXXXXXXXXXXXXXXXXXXXXXXXXXXXXXXXXXXXXXXXXX--XXXXXXXXXXXXXXXXXXXXXXXXXXXXXXXXXXXXXX--XXXXXXXXXXXXXXXXXXXXXXX--XXXXXXXXXXXXXXXXXXXXXXXX--XXXXXXXXXXXXXXXXXXXX
