---------------------------------------tt-###########--##-------------------tt-------------------
----------------------------------g-g--tt##---------#--##-------------------######-##--#---------
------------------------------XXXXXXXXXXXXXXXXXXXXXX-g-g----ggXXXX--XXXXXXXX#########--##--------
------------------------------XXXXXXXXXXXXXXXXXXXXXXXXXXXXXXXXXXXX--XXXXXXXX#########--##--------
-------------------------------------------------XXXXXXXXXXXXX-------------------####--##--------
-----------------------------------------------------------------------------XXXX---######-------
---------------------------------------##------------------------------------XXXX---######-------
--------------S!!S----------tt--------###--------tt--------SS-C-----SU----!--C-----S######-------
----------------------------tt---#---####--------tt---------------------------------#------------
----------------------------tt---#--#####--------tt---------------------------------#--------F---
---U----!--------------######----#-######--------tt------------g-g--------k---g-g---#--------#---
---------------SS------######XXXXXXXXXXXXXXXXXXXXXXXXXXXXXXXXXXXXXXXXXXXXXXXXXXXXXXXXXXXXXXXXXXXX
-----------------------######XXXXXXXXXXXXXXXXXXXXXXXXXXXXXXXXXXXXXXXXXXXXXXXXXXXXXXXXXXXXXXXXXXXX
-M------k------------g------tt-------------------------------------------------------------------
XXXXXXXXXXXXXX--XXXXXXXXXXXXXXXX-----------------------------------------------------------------
XXXXXXXXXXXXXX--XXXXXXXXXXXXXXXX-----------------------------------------------------------------
