--------------------------------------------------------------------------------------------------------------------------------------------------------------------------------------------------------
--------------------------------------------------------------------------------------------------------------------------------------------------------------------------------------------------------
--------------------------------------------------------------------------------------------------------------------------------------------------------------------------------------------------------
--------------------------------------------------------------------------------------------------------------------------------------------------------------------------------------------------------
--------------------------------------------------------------------------------------------------------------------------------------------------------------------------------------------------------
------------------------------------------------------------------------------------------------------------------------------------------------------##--------------------##--------------------------
----------------------------------------------------S!!S---------------------------------------------------------------------S!!S--------------------###--------tt---------###------C-----S---tt--------
----------------------------------------------------------------------------------------------------------------------------------------------------####--------tt--------####----------------tt--------
---------------------------------------------------------------------------------------------------------------------------------------------------#####--------tt-------#####----------------tt--------
--------------------------------------------------------------------------------------------------------------------------------------------------######--------tt------######-------g-g------tt-----g-g
------------!--!----tt-----S---------C-----S----S----SS----!--!--C-----S----------S-------------------------------C-----S-----SS---------!--!----######XXXXXXXXXXXXXXXX--XXXXXXXXXXXXXXXXXXXXXXXXXXXXXXX
--------------------tt------------------------------------------------------------------------------------#--------------------------------------######XXXXXXXXXXXXXXXX--XXXXXXXXXXXXXXXXXXXXXXXXXXXXXXX
--------------------tt------------------------------------------------------------------------------------#--------------------------------------######-------------------------------------------------
-M--tt--------------tt-----------g-g--g-g----------tt-------------g-g-------gg-------g-g#----#------#----##--------g-g-------g-g-tt------------g------tt------------------------------------------------
XXXXXXXXXXXXXXXXXXXXXXXXXXXXXXXXXXXXXXXXXXXXXXXXXXXXXXXXXXXXXXXXXXXXXXXXXXXXXXXXXXXXXXXXXXXXXXXXXXXXXXXXXXXXXXXXXXXXXXXXXXXXXXXXXXXXXXXXXXXXXXXXXXXXXXXXXX----------------------------------------------
XXXXXXXXXXXXXXXXXXXXXXXXXXXXXXXXXXXXXXXXXXXXXXXXXXXXXXXXXXXXXXXXXXXXXXXXXXXXXXXXXXXXXXXXXXXXXXXXXXXXXXXXXXXXXXXXXXXXXXXXXXXXXXXXXXXXXXXXXXXXXXXXXXXXXXXXXX----------------------------------------------
