-------------------------------------------------------------------------------------------------------------------------------------------------------------------------
-------------------------------------------------------------------------------------------------------------------------------------------------------------------------
-------------------------------------------------------------------------------------------------------------------------------------------------------------------------
-------------------------------------------------------------------------------------------------------------------------------------------------------------------------
-------------------------------------------------------------------------------------------------------------------------------------------------------------------------
-------------------------------------------------------------------------------------------------------------------------------------------------------------------------
---------------------------------------S!!S--------------------------------------------------------------------S!!S------------------------------------------------------
-----------------------------------------------------tt------------------------------------------------------------------------------------------------------------------
-----------------------------------------------------tt------------------------------------------------------------------------------------------------------------------
---------1-------------1-------------------##--------tt-------------------------------------------##--#----------------------##-------------1----------------------------
------------------------------------------###---###########--S--!--!-------------tt----!-U----!--###--##------C-----S-------###----!-------------------------------------
-----------------------------------------####---###########----------------------tt-------------####--##-------------------####------------------------------------------
----------------------------------------#####---###########----------------------tt-------------####--##------------------#####------------------------------------------
-M-----------------------------#-------######---------g-g----------------gg-tt----------------k-----g-g----gg--g-g-------######----------g-g--------#----#---------#----#
XXXXXXXXXXXXXX--XXXXXXXXXXXX--XXXXXXXXXXXXXXXXXXXXXXXXXXXXXXXXXXXXXXXXXXXXXXXXXXXXXXXXXXXXXXXXXXXXXXXXXXXXXXXXXXXXXXXXXXX--XXXXXXXXXXXXXXXXXXXXXX--XXXXXXXXXXXXXXXXXXXXXX
XXXXXXXXXXXXXX--XXXXXXXXXXXX--XXXXXXXXXXXXXXXXXXXXXXXXXXXXXXXXXXXXXXXXXXXXXXXXXXXXXXXXXXXXXXXXXXXXXXXXXXXXXXXXXXXXXXXXXXX--XXXXXXXXXXXXXXXXXXXXXX--XXXXXXXXXXXXXXXXXXXXXX
