-------------------------------------------------------------------------------------------------------------------------------------------------------------------------------------
-------------------------------------------------------------------------------------------------------------------------------------------------------------------------------------
-------------------------------------------------------------------------------------------------------------------------------------------------------------------------------------
----------------------------------------------------------------------------------------------------------------------------------------------------------------!--------------------
-------------------------------------------------------------------------------------------------------------------------------------------------------------------------------------
-------------------------------------------------------------------------------------------------------------------------------------------------------------------------------------
----------------------------------------------------------------------------------------!--------------------------------------------------------------------------------------------
--------------------------------------------------------------------------------------------------------------------------------------------------------------S@S!S------------------
-----------------------------------------------!---------------------------------------------------------------------------------------------------------1---------------------------
----------1---------------------1---------#------------------------------------------------------------------------1-----------------------------------------------------------------
---U----!----------!--!--C-----S---------##---------------------tt--------------------S@S!S----##--#----!--!----tt-----------------S-------------C-----S---------#------------#------
----------------------------------------####--##----------------tt----------------------------###--##-----------tt-----------------------#-----------------------#------------#------
----------------------------------------####--##----------------tt------tt-#-----------------####--##-----------tt-----------------------#-----------------------#----------gg#------
-M------k-----------------g-g---------------g-g#-------------------g-g--tt##-g-g----------g-g####--##-----------tt----------g-g----------#--------g-g----XXXXX--XXXXXXXXXXXXXXXXXXXXX
XXXXXXXXXXXXXXX--XXXXXXXXXXXXXXXXXXXX--XXXXXXXXXXXXXXXXXXXXXXXXXXXXXXXXXXXXXXXXXXXXXXXXXXXXXXXXXX--XXXXXXXXXXXXXXXXXXXXX--XXXXXXXXXXXXXXXXXXXXXXXXXXXXXXXXXXXX--XXXXXXXXXXXXXXXXXXXXX
XXXXXXXXXXXXXXX--XXXXXXXXXXXXXXXXXXXX--XXXXXXXXXXXXXXXXXXXXXXXXXXXXXXXXXXXXXXXXXXXXXXXXXXXXXXXXXX--XXXXXXXXXXXXXXXXXXXXX--XXXXXXXXXXXXXXXXXXXXXXXXXXXXXXXXXXXXX----------------------
