----------------------------------------------------------S!!S----------------------------------------------------------------------------------------------------------------
------------------------------------------------------------------------------------------------------------------------------------------------------------------------------
------------------------------------------------------------------------------------------------------------------------------------------------------------------------------
--------------------------------------------------------------------------------------------------------------------------------------------------------tt--------------------
-----------------------------------------------------------SS-------------------------------------------------------------------------------------------tt--------------------
-------------------------------------------------------------------------------------------------------------------------------------------1------------tt--------------------
--------------------------------------------U----!--!--!-----------------#--#------------S----------tt--C-----S----------tt----!--!-U----!--------------####---tt----######---
-------------------------------------tt------------------#--------------##--##----------------------tt-------------------tt-------------------XXXXXXXXX-####---tt----######---
-------------------------------------tt------------------#--------tt-#-###--###---------------------tt-------------------tt-------------------XXXXXXXXX-####---tt----######---
-------------------------------------tt----------k-------#--------tt######--###----gg---------------tt---g-g-----------------------------k---------------------tt--g------tt--
------------tt------------------##XXXX--XXXXXXXXXXXXXXXXXXXXXXXXXXXXXXXXXXXXXXXXXXXXXXXXXXXXXXXXXXXXXXXXXXXXXXXXXXXXXXXXXXXXXXXXXXXXXXXXXXXXXXXX--XXXXXXXXXXXXXXXXXXXXXXXXXXXX
------------tt------------------##XXXX--XXXXXXXXXXXXXXXXXXXXXXXXXXXXXXXXXXXXXXXXXXXXXXXXXXXXXXXXXXXXXXXXXXXXXXXXXXXXXXXXXXXXXXXXXXXXXXXXXXXXXXXX--XXXXXXXXXXXXXXXXXXXXXXXXXXXX
-----tt-#---tt------------------######----------------------------------------------------------------------------------------------------------------------------------------
-M---tt##---tt-----gg----------------g------tt--------------------------------------------------------------------------------------------------------------------------------
XXXXXXXXXXXXXXXXXXXXXXXXXXXXXXXXXXXXXXXXXXXXXXXX------------------------------------------------------------------------------------------------------------------------------
XXXXXXXXXXXXXXXXXXXXXXXXXXXXXXXXXXXXXXXXXXXXXXXX------------------------------------------------------------------------------------------------------------------------------
