------------------------------------------------------------------------------------------------------------------------------tt---!--!--C-----S
------------------------------------------------------------------------------------------------------------------------------tt----------------
------------------------------------------------------------------------------------------------------------------------------tt----------------
---------------------------------------------------------------------------------------------------------------##--#-----##----g-g--------g-g---
-----------------------------------------------------------------------------##--#-------------------!--------###--##----##XXXXXXXXXXXXXXXXXXXXX
----------------------------------------------------------------------------###--##----------------------tt-#####--##----##XXXXXXXXXXXXXXXXXXXXX
----------------------------!----------------------------------------------####--##----------------------tt##----------g------tt----------------
-------------------------------------------------------------------------tt####--##---C-----S----------XXXXXXXXXXXXXXXXXXXXXXXXXXX--------------
-------------------------------------------------------------------------tt---######---------------S@S!XXXXXXXXXXXXXXXXXXXXXXXXXXX--------------
-------------------------------------------------------------------------tt---#######---------------------------######--------------------------
----------!--!------------S@S!S-----------------!--!--------!--!----######----#######--g-g-------gg-----------g------tt-------------------------
----------------------------------#---------------------------------######XXXXX--XXXXXXXXXXXXXXXXXXXXXX--XXXXXXXXXXXXXXXX-----------------------
-----tt-#-------------------------#--------tt-#--------tt-#---------######XXXXX--XXXXXXXXXXXXXXXXXXXXXX--XXXXXXXXXXXXXXXX-----------------------
-M---tt##-------------------------#--------tt##--------tt##-------g------tt---------------------------------------------------------------------
XXXXXXXXXXXXXXXXXXXXXXXXXXXXXXXXXXXXXXXXXXXXXXXXXXXXXXXXXXXXXXXXXXXXXXXXXXXXX-------------------------------------------------------------------
XXXXXXXXXXXXXXXXXXXXXXXXXXXXXXXXXXXXXXXXXXXXXXXXXXXXXXXXXXXXXXXXXXXXXXXXXXXXX-------------------------------------------------------------------
