--------------------------------------------------------------------------------------------------------------------------------------------------------------------------------
--------------------------------------------------------------------------------------------------------------------------------------------------------------------------------
--------------------------------------------------------------------------------------------------------------------------------------------------------------------------------
--------------------------------------------------------------------------------------------------------------------------------------------------------------------------------
----------!---------------------------------------------------------------------------------------------------------------------------------------------------------------------
--------------------------------------------------------------------------------------------------------------------------------------------------------------------------------
-------------------------------------------------------------##--------------------------------------------------------------S!!S-----------------------------------------------
------------------------------------------------------------###-----------------------------------------------------------------------------------------------------------------
--------S@S!S----------------------------------------------####------------------------------------------------------------------------------##---------------------------------
---1------------------------------------------------------#####--------##-------------------------------------------------------------------###---------------------------------
-----------------------!---------------------------!--!--######-------###--------------#---------tt---C-----S---------tt------SS-----------####----#-----tt-U----!--------------
-----------#-------------------------#------------------#------------####-------------##---------tt-------------------tt------------------#####----##----tt---------------------
-----------#-------------------------#------------------#-----------#####------------###---------tt-------------------tt-----------------######----###---tt---------------------
-M---------#----------------g-g----gg#----------gg------#----------######-------------------gg----g-g--g-g------------tt-----g-g-------------####--###---tt------k-----------g-g
XXXXXXXX--XXXXXXXXXXXXXXXXXXXXXXXXXXXXXXXXXXXXXXXXXXXXXXXXXXXXXXXXXXXXXXX--XXXXXXXXXXXXXXXXXXXXXXXXXXXXXXXXXXXXXXXXXXXXXXXXXXXXXXXXXXXXXXXXXXXXXXXXXXXXXXXXXXXXXXXXXXXXXXXXXXXXX
XXXXXXXX--XXXXXXXXXXXXXXXXXXXXXXXXXXXXXXXXXXXXXXXXXXXXXXXXXXXXXXXXXXXXXXX--XXXXXXXXXXXXXXXXXXXXXXXXXXXXXXXXXXXXXXXXXXXXXXXXXXXXXXXXXXXXXXXXXXXXXXXXXXXXXXXXXXXXXXXXXXXXXXXXXXXXX
