------------------------------------------------S!!S------------------------------------------------------!--------------
----------------------##-------------------------------------------------------------------------------------------------
---------------------###-------------------------------------------------------------------------------------------------
--------------------####-------------------------------------------------------------S!!S--------------------------S!!S--
-------------------#####-----------------##------SS--------------------------------------------------tt-S@S!S------------
------------------######----------------###----------------------------------------------------------tt------------------
------------------tt---#######---------####-------------------##-----##------------------------------tt------------------
------------------tt---#######--------#####----#-------------###----###---------------SS--------############--------SS---
-------------######----#######-------######----#--------tt-#####---####-------------------------############-------------
-------------######XXXX------XXXXXXXXXXXXX-----#--------tt######--#####-------------------------###-tt-----#-------------
----tt-------######XXXX--S@S-XXXXXXXXXXXXX-XXXXXXXXXXXXXXX-------######----------gg-----------g----XXXXXXXXXXXXXXXXXXXXX-
----tt-------#-----------------------------XXXXXXXXXXXXXXXXXXXXXXXXXXXX--XXXXXXXXXXXXXX--XXXXXXXXXXXXXXXXXXXXXXXXXXXXXXX-
----tt-------#--------------------------------------------XXXXXXXXXXXXX--XXXXXXXXXXXXXX--XXXXXXXXXXXXXXXX----------------
-M--g-g------#-----------------------------------------------------------------------------------------------------------
XXXXXXXXXXXXXXXXXXXXXXXXXXXXX--------------------------------------------------------------------------------------------
XXXXXXXXXXXXXXXXXXXXXXXXXXXXX--------------------------------------------------------------------------------------------
