----------------------------------------------------####----------C-----S-------C-----S----------!--!-----------------------U----!--C-----S-------------SS-------------------C-----S
-----------------------------------------SS--------#####----------------------------------------------------------------------------------------------------------------------------
-----------------------##-------------------------######----------------------------------------------------------------------------------------------------------------tt-#--------
----------------------###-------!----------------#---------#----#--g-g---#----#--g-g--------------------------------gg-----------k---g-g-------gg---------#----#--------tt##--g-g---
---------------------####--------------#---------#XXXXXXXXXXXXXXXXXXXXXXXXXXXXXXXXXXXXXXXXXXXXXXXXXXXXXXXX--XXXXXXXXXXXXXXXXXXXXXXXXXXXXXXXXXXXXXXXXXXXXXXXXXXXXXXXXXXXXXXXXXXXXXXXX
--------------------#####--------------#---------#XXXXXXXXXXXXXXXXXXXXXXXXXXXXXXXXXXXXXXXXXXXXXXXXXXXXXXXX--XXXXXXXXXXXXXXXXXXXXXXXXXXXXXXXXXXXXXXXXXXXXXXXXXXXXXXXXXXXXXXXXXXXXXXXX
-------------------######-------tt-----#-------g------tt----------------------------------------------------------------------------------------------------------------------------
-----------tt-----###XXXX--XXXXXXXXXXXXXXXXXXXXXXXXXXXXXXX--------------------------------------------------------------------------------------------------------------------------
-----------tt-----###XXXX--XXXXXXXXXXXXXXXXXXXXXXXXXXXXXXX--------------------------------------------------------------------------------------------------------------------------
-----------tt-----######------------------------------------------------------------------------------------------------------------------------------------------------------------
------##----g-g-g------tt-----------------------------------------------------------------------------------------------------------------------------------------------------------
------##XXXXXXXXXXXXXXXXXXX---------------------------------------------------------------------------------------------------------------------------------------------------------
------##XXXXXXXXXXXXXXXXXXX---------------------------------------------------------------------------------------------------------------------------------------------------------
-M--g------tt-----------------------------------------------------------------------------------------------------------------------------------------------------------------------
XXXXXXXXXXXXXXX---------------------------------------------------------------------------------------------------------------------------------------------------------------------
XXXXXXXXXXXXXXX---------------------------------------------------------------------------------------------------------------------------------------------------------------------
