---------------------------------------------------------------------------------------------------------------------------------------------------------------------------------------------
---------------------------------------------------------------------------------------------------------------------------------------------------------------------------------------------
---------------------------------------------------------------------------------------------------------------------------------------------------------------------------------------------
---------------------------------------------------------S!!S--------------------------------------------------------------------------------------------------------------------------------
---------------------------------------------------------------------------------------------------------------------------------------------------------------------------------------------
---------------------------------------------------------------------------------------------------------------------------------------------------------------------------------------------
----------------------------------------------------------------------------------------------------------------------------!----------------------------------------------------------------
----------------------------------------------------------SS--------------------------------------------------------S!!S---------------------------------------------------------------------
----------------------------------tt---------------------------------------------------------------------------------------------------------------------------------------------------------
----------------------------------tt------------------------------##--#1---------------------------------------------------------------------------------------------------------------------
----------!--!----tt--C-----S-----tt--------------------tt######-###--#-----------------tt------!-------------------------S@S!S---------------------------------U----!-----------S-----------
------------------tt---------#--------------------------tt##########--#-----------------tt---------------------------SS----------------------------tt----------------------------------------
------------------tt---------#--------------------------tt##########--#-----------------tt--------------------------------------------------tt-----tt----------------------------------------
-M-#----#---------tt---g-g---#--------------------------tt-------------------------gg---tt----------#----#--------------------g-g-----------tt#----tt-----#----#-----k-#----#----------------
XXXXXXXXXXXXXXXXXXXXXXXXXXXXXXXXXXXXXXXXX--XXXXXXXXXXXXXXXXXXXXXXXXXXXXXXXXX--XXXXXXXXXXXXXXXXXXXXXXXXXXXXXXXXXXXXXX--XXXXXXXXXXXXXXXXXXXXXXXXXXXXXX--XXXXXXXXXXXXXXXXXXXXXXXXXXXXXXXXX--XXXX
XXXXXXXXXXXXXXXXXXXXXXXXXXXXXXXXXXXXXXXXX--XXXXXXXXXXXXXXXXXXXXXXXXXXXXXXXXX--XXXXXXXXXXXXXXXXXXXXXXXXXXXXXXXXXXXXXX--XXXXXXXXXXXXXXXXXXXXXXXXXXXXXX--XXXXXXXXXXXXXXXXXXXXXXXXXXXXXXXXX--XXXX
