---------------------------------------------------------------------------------------------------------------------------------------------------------------
---------------------------------------------------------------------------------------------------------------------------------------------------------------
---------------------------------------------------------------------------------------------------------------------------------------------------------------
---------------------------------------------------------------------------------------------------------------------------------------------------------------
----------------------------------------------------------------------------------------------------------------------------------------##---------------------
---------------------------------------------------------------------------------------------------------------------------------------###---------------------
--------------##--------------------------------------------------------------------tt---------tt-------------------------------------####------U----!---------
-------------###----------------------------------------S!!S------------------------tt---------tt------------------------------------#####---------------------
------------####--------------------------------------------------------------------tt---------tt--------tt----------------!--------######---------------------
-----------#####--------------##-----------------------------------------------####-tt---------#---------tt------------------------#-----tt----------k--tt-----
------tt--######----S--!-----###-------C-----S--------------------tt-----------####XXXXXXXXXXXX#---------tt------------------------#----XXXXXXXXXXXXXXXXXXXXXXX
------tt-#------------------####-------------------------SS-------tt-----------####XXXXXXXX-g-g#---------tt-----gg#----#----g-g-g-g#----XXXXXXXXXXXXXXXXXXXXXXX
------tt-#-----------------#####----------------------------------tt-----g-g-g------tt-----XXXXXXXXXXXXXXXXXXXXXXXXXXXXXXXXXXXXXXXXXXXXXXX---------------------
-M----tt-#----------------######--------g-g-----------------------XXXXXXXXXXXXXXXXXXXXXX---XXXXXXXXXXXXXXXXXXXXXXXXXXXXXXXXXXXXXXXXXXXXXXX---------------------
XXXXXXXXXXXXXXXXXXXXXXXXXXXXXXXX--XXXXXXXXXXXXXXXXXXXXXX--XXXXXXXXXXXXXXXXXXXXXXXXXXXXXX-----------------------------------------------------------------------
XXXXXXXXXXXXXXXXXXXXXXXXXXXXXXXX--XXXXXXXXXXXXXXXXXXXXXX--XXXXXXXX---------------------------------------------------------------------------------------------
