----------------------------------------------------------------------------------------------------------------------------------------------------------------------
----------------------------------------------------------------------------------------------------------------------------------------------------------------------
----------------------------------------------------------------------------------------------------------------------------------------------------------------------
----------------------------------------------------------------------------------------------------------------------------------------------------------------------
----------------------------------------------------------------------------------------------------------------------------------------------------------------------
-------------------------------------------------------------------------------------------------------------------##-------------------------------------------------
-----S!!S--!----------------------------------------##------------------------------------------------------------###-------------------------------------------------
---------------------------------------------------###-----------------------------------------------------------####--------------------tt---------------------------
--------------------------------------------##----####----------------------------------------------------------#####--------------------tt---------------------------
--------------------------------1----------###---#####---------------------------------------------------------######--------#--#--------tt-----------------------S@S-
------SS-S@S!S-----------C-----S----------####--######------------------#---------------------------##--#-----############--##--##-------#----------------------------
-----------------------------------------#####-------#------------------#--------------------------###--##----############-###--###--tt-##----------------------------
----------------------------------------######-------#--------tt-#------#-------------------------####--##----################--###--tt###----------g-g#----#---------
-M--tt------g-g-----------g-g-----------------g-g-g-g#--------tt###----##----------gg-------------####--##--g------tt-----XXXXXXXXXXXXXXXXXXXXXXXXXXXXXXXXXXXXXXXXXXXX
XXXXXXXXXXXXXXXXXXXXXXXXXXXXXXXXXXXXX--XXXXXXXXXXXXXXXXXXXXXXXXXXXXXXXXXXXXXXXXXXXXXXXXXXXXXXXX--XXXXXXXXXXXXXXXXXXXXXX---XXXXXXXXXXXXXXXXXXXXXXXXXXXXXXXXXXXXXXXXXXXX
XXXXXXXXXXXXXXXXXXXXXXXXXXXXXXXXXXXXX--XXXXXXXXXXXXXXXXXXXXXXXXXXXXXXXXXXXXXXXXXXXXXXXXXXXXXXXX--XXXXXXXXXXXXXXXXXXXXXX-----------------------------------------------
