--------------------------------------------------------------------------------------------------------------------------------------------------------------
--------------------------------------------------------------------------------------------------------------------------------------------------------------
--------------------------------------------------------------------------------------------------------------------------------------------------------------
------------------------------------------------------------------------##------------------------------------------------------------------------------------
-----------------------------------------------------------------------###------------------------------------------------------------------------------------
--------------------------------------------------------##------------####------------------------------------------------------------------------------------
-------------------------------------------------------###-----------#####-------------------------#--##------------------------------------------------------
------------------------------------------------------####----------######-------S----------S-----##-###---!--!-----S----tt------------------#----------S-----
-----------------------------------------------------#####---------#-----------------------------#######-----------------tt-----------------##----------------
----------------------------------------------------######---------#----------------tt-#--------########-----------------tt----------------###--tt-#----------
------tt-U-------tt--!-----!-----------!--!--------#---------#----##--------g-g-----tt##-------tt------g-g----------------g-g--------------g-g--tt##-------g-g
------tt---------tt--------------------------------#XXXXXXXXXXXXXXXXXXXXXXXXXXXXXXXXXXXXXXXXXXXXXXXXXXXXXXXXXXXXXXXXXXXXXXXXXXXXX--XXXXXXXXXXXXXXXXXXXXXXXXXXX
------tt---------tt--------------------------------#XXXXXXXXXXXXXXXXXXXXXXXXXXXXXXXXXXXXXXXXXXXXXXXXXXXXXXXXXXXXXXXXXXXXXXXXXXXXX--XXXXXXXXXXXXXXXXXXXXXXXXXXX
-M----tt------k--g-g-------tt------g-g-------g-g-g------tt----------------------------------------------------------------------------------------------------
XXXXXXXXXXXXXXXXXXXXXXXXXXXXXXXXXXXXXXXXXXXXXXXXXXXXXXXXXXXX--------------------------------------------------------------------------------------------------
XXXXXXXXXXXXXXXXXXXXXXXXXXXXXXXXXXXXXXXXXXXXXXXXXXXXXXXXXXXX--------------------------------------------------------------------------------------------------
