------------------------------------------------------------------------------------------------------------------------------------------------
------------------------------------------------------------------------------------------------------------------------------------------------
------------------------------------------------------------------------------------------------------------------------------------------------
--------------------------------------------------------------------------------------------------------------------------SS--------------------
------------------------------------------------------------------------------------------------------------------------------------------------
-----------------------------------------------------------------------------S!!S--------------------------------------------------#------------
--------------------------##-------------------------------------------------------------tt----------S----------!--!------######--##------------
----!--------------------###--------------------------tt---------------------------------tt-------------------------------######-###--tt--------
------------------------####--------------------------tt---------------------------------tt-------------------------------##########--tt----tt--
-------------##--------#####--------------------------tt----------------------SS----##----g-g-g-g-------tt----------------------XXXX--tt----tt--
----####----###-------######---------tt----------######---------------!-------------##XXXXXXXXXXXXXXXXXXXXXXXXXXXXXXXXXXXXXXXXXXXXXXXXXXXXXXXXXX
----####---####------#---------------tt----------######-----------------------------##XXXXXXXXXXXXXXXXXXXXXXXXXXXXXXXXXXXXXXXXXXXX--XXXXXXXXXXXX
----####--#####------#--------tt-#---tt---tt-#---######-----------------------g-g-g------tt-----------------------------------------------------
-M--tt---######------#--------tt##---tt---tt##-g------XXXXXXXXXXXXXXXXX--XXXXXXXXXXXXXXXXXXXX---------------------------------------------------
XXXXXXXXXXXXXXX--XXXXXXXXXXXXXXXXXXXXXXXXXXXXXXXXXXXXXXXXXXXXXXXXXXXXXX--XXXXXXXXXXXXXXXXXXXX---------------------------------------------------
XXXXXXXXXXXXXXX--XXXXXXXXXXXXXXXXXXXXXXXXXXXXXXXXXXXXXXXXX--------------------------------------------------------------------------------------
