-----------------------------------------------------------------------------------------------------------------------------------------------------
-----------------------------------------------------------------------------------------------------------------------------------------------------
-----------------------------------------------------------------------------------------------------------------------------------------------------
-----------------------------------------------------------------------------------------------------------------------------------------------------
-----------------------------------------------------------------------------------------------------------------------------------------------------
-----------------------------------------------------------------------------------------------------------------------------------------------------
---------------!-------------------------------------------##----------------------------------------------------------------------------------------
----------------------------------------------------------###----------------------------------------------------------------------------------------
---------------------------------------##----------------####----------------------------------------------------------------------------------------
--------------------------------------###------------#--##----------------------------------------------------------------##--#----------------------
-------S-----S@S!S------!--!---------####----!--!---##-###-C-----S--##--#-------S----tt---------!-------C-----S----------###--##---#--#-----------tt-
------------------------------------#####----------#####-----------###--##-----------tt---------------------------------####--##--##--##----------tt-
-----------tt----------------------######---------######----------####--##-----------tt---------------------------------####--##-###--###---------tt-
-M---------tt##-tt------------------------------------------g-g---####--##-----------tt-----g-g-tt-------g-g--------t----g-g----####--###---------tt-
XXXXXXXXXXXXXXXXXXXXXXXXXXXXXXXXXXXXXXXXXXXXXXXXXXXXXXXXXXXXXXXXXXXXXX--XXXXXXXXXXXXXXXXXXXXXXXXXXXXXXXXXXXXXXXXXXXXXXXXXXXXXXXXXXXXXXXXXXXXXXXXXXXXX
XXXXXXXXXXXXXXXXXXXXXXXXXXXXXXXXXXXXXXXXXXXXXXXXXXXXXXXXXXXXXXXXXXXXXX--XXXXXXXXXXXXXXXXXXXXXXXXXXXXXXXXXXXXXXXXXXXXXXXXXXXXXXXXXXXXXXXXXXXXXXXXXXXXX
