----------------------------------------------------------------------------------------------------------------------------------------------------
----------------------------------------------------------------------------------------------------------------------------------------------------
----------------------------------------------------------------------------------------------------------------------------------------------------
----------------------------------------------------------------------------------------------------------------------------------------------------
----------------------------------------------------------------------------------------------------------------------------------------------------
---------------------------------------------------------------------------------------------------------S!!S---------------------------------------
----------------------------------------------------------------------------------------------------------------------------------------------------
---------------!------------------------------------------------------------------------------------------------------------------------------------
-----------------------------------------------#----!----------------------------------------------------------------------------##-----------------
----------------------------------------------##----------------------------------------##--#-------------SS--------------------###-----------------
------------------------##--#----------------###---------------------------------------###--##----##--#------------------------####-----------######
---------#---S@S!S-----###--##--------------#####---#---------tt------------------tt--####--##---###--#---------##--#---------#####-----------######
---------#------------####--##-------------######---#---------tt------------------tt--####--##--####--########-###--##-------######-----------######
-M-#----##------------####--##------g-g----------g-g#---------tt------------------tt-----g-g----####--############--#########-----tt----------------
XXXXXXXXXXXXXXXXXXXXXXXXXX--XXXXXXXXXXXXXXXXXXXXXXXXXXXXXXXXXXX--XXXXXXXXXXXXXXXXXXXXXXXXXXXXXXX--------##########--#########----XXXXXXXXXXXXXXXXX--
XXXXXXXXXXXXXXXXXXXXXXXXXX--XXXXXXXXXXXXXXXXXXXXXXXXXXXXXXXXXXX--XXXXXXXXXXXXXXXXXXXXXXXXXXXXXXX----XXX-g-g-----------#######----XXXXXXXXXXXXXXXXX--
