-------------------------------------------------------------------------------------------------------------------------------------------------------------------------------------
-------------------------------------------------------------------------------------------------------------------------------------------------------------------------------------
-------------------------------------------------------------------------------------------------------------------------------------------------------------------------------------
-------------------------------------------------------------------------------------------------------------------------------------------------------------------------------------
-------------------------------------------------------------------------------------------------------------------------------------------------------------------------------------
-------------------------------------------------------------------------------------------------------------------------------------------------------------------------------------
--------------------------------------------------------------------------------------------S!!S-------------------------------------------------------------------------------------
----------------------------------------------------------!------------------------------------------------------##------------------------------------------------------------------
----------------------------------------------------------------------------------------------------------------###-------------------------------------------1----------------------
---1------------------------------------------------------------------------------------------------SS!S-------####-------#--#-------------------------------------------------------
---------------S--!--!----------------------S-U----!-------------------------tt----U----!----SS---------------#####------##--##------------------------------------------------------
--------------------------------------------------------S@S!S----------------tt------------------------------######-----###--###-------------------------------------------------tt--
-----------------------------------------------------------------------------tt---------------------------gg-#---------####--###-----------------------tt-----------------g-g----tt--
-M-------------------------g-g-g-g----gg-----------k--------------------tt------g-g-----k--tt-------XXXXXXXXXXXXXXXXXXXXXXXXXXXXXXXX--XXXXXXXXXXXXXXXXXXXXXXXXXXXXX--XXXXXXXXXXXXXXXX
XXXXXXXX--XXXXXXXXXXXXXXXXXXXXXXXXXXXXXXXXXXXXXXXXXXXXXXXXXXXXXXXXXXXXXXXXXXXXXXXXXXXXXXXXXXXXXXXXXXXXXXXXXXXXXXXXXXXXXXXXXXXXXXXXXX--XXXXXXXXXXXXXXXXXXXXXXXXXXXXX--XXXXXXXXXXXXXXXX
XXXXXXXX--XXXXXXXXXXXXXXXXXXXXXXXXXXXXXXXXXXXXXXXXXXXXXXXXXXXXXXXXXXXXXXXXXXXXXXXXXXXXXXXXXXXXXXXXXXXXXXXXX--------------------------------------------------------------------------
