----------------------------------------------------------------------------------------------------------------------------------------------------------------------------------------------------------
----------------------------------------------------------------------------------------------------------------------------------------------------------------------------------------------------------
----------------------------------------------------------------------------------------------------------------------------------------------------------------------------------------------------------
----------------------------------------------------------------------------------------------------------------------------------------------------------------------------------------------------------
----------------------------------------------------------------------------------------------------------------------------------------------------------------------------------------------------------
----------------------------------------------------------------------------------------------------------------------------------------------------------------------------------------------------------
----------------------------------------------------------------------------------------------------------------------------------------------------------------------------------------------------------
----------------------------------------------------------------------------------------------------------------------------------------------------------------------------------------------------------
----------------------------------------------------------------------------------------------------------------------------------------------------------------------------------------------------------
----------------------------------------------------------------------------------------------------------------------------------------------------------------------------------------------------------
------tt-----------tt-----------tt-----------tt-----------tt-----------tt-----------tt-----------tt-----------tt-----------tt-----------tt-----------tt-----------tt-----------tt-----------tt-----------t
------tt-----------tt-----------tt-----------tt-----------tt-----------tt-----------tt-----------tt-----------tt-----------tt-----------tt-----------tt-----------tt-----------tt-----------tt-----------t
------tt-----------tt-----------tt-----------tt-----------tt-----------tt-----------tt-----------tt-----------tt-----------tt-----------tt-----------tt-----------tt-----------tt-----------tt-----------t
-M----tt-----g-g---tt-----g-g---tt-----g-g---tt-----g-g---tt-----g-g---tt-----g-g---tt-----g-g---tt-----g-g---tt-----g-g---tt-----g-g---tt-----g-g---tt-----g-g---tt-----g-g---tt-----g-g---tt-----g-g---t
XXXXXXXXXXXXXXXXXXXXXXXXXXXXXXXXXXXXXXXXXXXXXXXXXXXXXXXXXXXXXXXXXXXXXXXXXXXXXXXXXXXXXXXXXXXXXXXXXXXXXXXXXXXXXXXXXXXXXXXXXXXXXXXXXXXXXXXXXXXXXXXXXXXXXXXXXXXXXXXXXXXXXXXXXXXXXXXXXXXXXXXXXXXXXXXXXXXXXXXXXX
XXXXXXXXXXXXXXXXXXXXXXXXXXXXXXXXXXXXXXXXXXXXXXXXXXXXXXXXXXXXXXXXXXXXXXXXXXXXXXXXXXXXXXXXXXXXXXXXXXXXXXXXXXXXXXXXXXXXXXXXXXXXXXXXXXXXXXXXXXXXXXXXXXXXXXXXXXXXXXXXXXXXXXXXXXXXXXXXXXXXXXXXXXXXXXXXXXXXXXXXXX
