-----------------------------------------------------------------------------------------------------------------------------
-----------------------------------------------------------------------------------------------------------------------------
------------------------------------------------------------g----------------------------------------------------------------
----------------------------------------------------------SSSSSSSS-----------------------------------------------------------
-----------------------------------------------------------------------------------------------------------------------------
---------------------------------------------------------g-------------------------------------------------------------------
---------------------#---------------------------------------------------------------------SSSS------------------------------
--------------------##---------------------------------S@S-------------------------------------------------------------------
-------------------###-------------------------------------------------------------------------------------------------------
------------------####-----S--------------------S!!--------------------------------------------------------------------------
--------S@S!S------SS----------tt-------!--------------------SU--------SSSS-------------------------------------##-#---------
-------------------------------tt-------------------#----------------------------------------S@S---------------###-##--------
-------------------------------tt-------------------##----------------t---------------#-----------------------####-###-----F-
-M--------------gg-g--------g---#####--------g---------------tt---g---t--------------##---------------------####---####----#-
XXXXXXXXXXXXXXXXXXXXXXXXXXXXXXXXXXXXXXXXXXXXXXXXXXXXXXX---XXXXXXXXXXXXXXXXXXXXXXXXXXXXXXXXXXXXXXXXXXXXXXXX--XXXXXXXXXXXXXXXXX
XXXXXXXXXXXXXXXXXXXXXXXXXXXXXXXXXXXXXXXXXXXXXXXXXXXXXXX---XXXXXXXXXXXXXXXXXXXXXXXXXXXXXXXXXXXXXXXXXXXXXXXX--XXXXXXXXXXXXXXXXX
