-------------------------------tt-----###-------------#####--------###-------####-####----g---------####----------------g-
-------------------------------tt-g-------------------#####--------###-----------XXXXXXXXXXXXXXXXXXXXXXXXXXXXXXXXXXXXXXXXX
-------------------------------------XXXXXXXX---XXXXXXXXXXXXXXXXX--XXXXXXXXXXXXXXXXXXXXXXXXXXXXXXXXXXXXXXXXXXXXXXXXXXXXXXX
-----------------------------S@S-----XXXXXXXX---XXXXXXXXXXXXXXXXX--XXXXXXXXXXXXXX-----------------------------------------
---------------------#----------------------------------------------------------------------------------------------------
--------S!!---------##----------------------------------------------------------------------------------------------------
----------------#--###---#####--------------------------------------------------------------------------------------------
---------------##-####---#####--------------------------------------------------------------------------------------------
--------------###--------#####------F-------------------------------------------------------------------------------------
----------g--####---------------g---#-------------------------------------------------------------------------------------
--S@S--XXXXXXXXXXXXXXX-----XXXXXXXXXXX------------------------------------------------------------------------------------
-------XXXXXXXXXXXXXXX-----XXXXXXXXXXX------------------------------------------------------------------------------------
-------------------------F------------------------------------------------------------------------------------------------
-M-------g---g-------g---#------------------------------------------------------------------------------------------------
XXXXXXXXXXXXXXXXXXXXXXXXXXX-----------------------------------------------------------------------------------------------
XXXXXXXXXXXXXXXXXXXXXXXXXXX-----------------------------------------------------------------------------------------------
