-------------------------------------------------------------------------------------------------------------------------------
-------------------------------------------------------------------------------------------------------------------------------
-------------------------------------------------------------------------------------------------------------------------------
-------------------------------------------------------------------------------------------------------------------------------
-------------------------------------------------------------------------------------------------------------------------------
-------------------------------------------------------------------------------------------------------------------------------
------------------------------------------------------------------------SSSS-------------------------------------#-------------
--------------------S@S!S---------------------------------------------------------------------------------------##-------------
-------------------------------------------------------------------------------------------------------1-------###-------------
-----------------------------------------------------------------------------SSSS-----------------------------####--------tt---
-----------------------SS---------tt------------##--#-------------------tt------------------------------------------------tt---
---------SS!S---------------------tt-----------###--##---------tt-------tt------------------SS!S-----####----S@S----------tt---
-----#-------------tt-------------tt----------####--###--------tt-------tt---------------------------####-------------g-g-tt---
-M-------------g---ttg-g------g-g-tt--------------------gg-----tt-g-g-g-tt--gg----#####--------------####------------k---------
XXXXXXXXXXXXXXXXXXXXXXXXXXXXXXXXXXXXXXXXXXXXXXXXXXXXXXXXXXXXXXXXXXXXXXXXXXXXXXXXXXXXXXXXXXXXXXXXXXXXXXXXXXXXXXXXXXXXXXXXXXXXXXX
XXXXXXXXXXXXXXXXXXXXXXXXXXXXXXXXXXXXXXXXXXXXXXXXXXXXXXXXXXXXXXXXXXXXXXXXXXXXXXXXXXXXXXXXXXXXXXXXXXXXXXXXXXXXXXXXXXXXXXXXXXXXXXX
