--------------------------------------------------------------------------------##------------####-------
-------------------------------------------------------------------------------###--------#####----------
------------------------------------------------------------------------------####--------#####--------F-
-----------------------------------------------------------------------------#####--------#####--------#-
----------------------------------------------------------------------------######------------------XXXXX
---------------------------------------------------------------------------##XXXXXXXXXXXXXX---------XXXXX
--------------------SS!S----S!!S------------------------------------------###XXXXXXXXXXXXXX--------------
-------------------------------------------------------------------------####--------------SS!S--SSS!----
---------------------------------------------------------------------------------------------------------
-----------------------------------------------S!!S---------------------S@S------------------------------
-------------------S@S--------------SS!SSSS------------------SU----t-------------------------------------
-------------------------------------------------------------------t-----------S@S!S------S@S-------C----
-------------------------------------------------------------------tt------------------------------------
-M---gg-----------g--tt---------------g---------tt-------------------------------------------------------
XXXXXXXXXXXXXXXXXXXXXXXXXXX---XXXXXXXXXXXXXXXXXXXXXXXXXXXXXXXXXXXXXXXXXXXXXXXXXXXXXXXXXXXXXX---------g---
XXXXXXXXXXXXXXXXXXXXXXXXXXX---XXXXXXXXXXXXXXXXXXXXXXXXXXXXXXXXXXXXXXXXXXXXXXXXXXXXXXXXXXXXXX-----XXXXX---
