--------------------------------------------------###-----------####--###-------------
-------------------------------------------------####--g------------#####-------------
---------------------------XXXXX--XXXXXXX---XXXXXXXXXXXXXXXXXXXXX---#####-------------
---------------------------XXXXX--XXXXXXX---XXXXXXXXXXXXXXXXXXXXX---#####-------------
--------------------------------------------------------------------------------------
--------------------------------------------------------------------S@S---------#-----
-------------------------------------------------------------------------------##-----
------------------------------------------------------------------------------###-----
-----------------------------------------------------------------t-----------####-----
------------------------------------S----#-------S!!S-----SS-----t--------------------
-----------------------------tt----------##------------------g-g-t---------S@S--------
-----------##------SU--------tt----------###----------------------------------------F-
----------###----------------tt-g--------####----------####-------------------------#-
-M-------####-------------tt------XXXXXXXXXXXXXXXXXXX--XXXXXXXXXXXXXXXXXXXXXXXXXXXXXXX
XXXXXXXXXXXXXXXXXXXXXXXXXXXXXXXXXXXXXXXXXXXXXXXXXXXXX--XXXXXXXXXXXXXXXXXXXXXXXXXXXXXXX
XXXXXXXXXXXXXXXXXXXXXXXXXXXXXXXXXXXXXX------------------------------------------------
