--------------------------------------------------------------------------------------------------------------------------------
--------------------------------------------------------------------------------------------------------------------------------
--------------------------------------------------------------------------------------------------------------------------------
--------------------------------------------------------------------------------------------------------------------------------
--------------------------------------------------------------------------------------------------------------------------------
--------------------------------------------------------------------------------------------------------------------------------
--------------------------------------------------------------------------------------------------------------------------------
-------------------------------------------------------S@S!S--------------------------------------------------------------------
--------------------------------------------------------------------------------------------------------------------------------
-----------------------------g-----------------------#-------------------tt------------------------------tt---------------------
----------S!!S-----1-------SSSS--------------SS!S---###-#####------------tt--------S@S!S---------tt-----------------------------
-----------------------------------1-----g---------####-#####-------SS---tt----------------------tt-----------------------------
--------------------------g------------------------####-#####--------------------t---------------tt-g---------------------------
-M------------####------g-tt-------------------g--#####----#####-----------------tt--------g---g----------gg---------------tt---
XXXXXXXXXXXXXXXXXXXXXXXXXXXXXXXXXXXXXXXXXXXXXXXXXXXXXXXXXXXXXXXXXXXXXXXXXXXXXXXXXXXXXXXXXXXXXXXXXXXXXXXXXXXXXXXXXXXXXXXXXXXXXXXX
XXXXXXXXXXXXXXXXXXXXXXXXXXXXXXXXXXXXXXXXXXXXXXXXXXXXXXXXXXXXXXXXXXXXXXXXXXXXXXXXXXXXXXXXXXXXXXXXXXXXXXXXXXXXXXXXXXXXXXXXXXXXXXXX
