----------------------------------------------------
---------#####---------tt-------------#-----#-------
---------#####---------tt#####-------##----##-------
---------#####-----#---tt#####------###---###-------
-------tt--------####--tt#####-----####--####-------
-XXXXXXXXXXXXXXXXXXXXXXXXXXXX----------#####--------
-XXXXXXXXXXXXXXXXXXXXXXXXXXXX----------#####--------
---------------------------------------#####--------
----------------------------------------------------
-----------------------------------S@S----------#---
-------!--!------#---------S@S!----------------##---
----------------##--S@S!S---------------------###---
---------------###---------------------------####---
-M---tt-------####------------------------k---------
XXXXXXXXXXXXXXXXXXXXXXXXXXXXXXXXXXXXXXXXXXXXXXXXXXXX
XXXXXXXXXXXXXXXXXXXXXXXXXXXXXXXXXXXXXXXXXXXXXXXXXXXX
