-----------------------------------------------------------------------------------------------------------------------------------------
-----------------------------------------------------------------------------------------------------------------------------------------
-----------------------------------------------------------------------------------------------------------------------------------------
-----------------------------------------------------------------------------------------------------------------------------------------
-----------------------------------------------------------------------------------------------------------------------------------------
-----------------------------------------------------------------------------------------------------------------------------------------
-----------------------------------------------------------------------------------------------------g------------SSS!-------------------
---------------------------------------------------------------------------------------1-----------SSSS----------------------------------
---------------S!!S----------SSSS-----------------------------------------S!!S-----------------------------------------------------------
------------------------SSSS----------------------------------------------------------------------g--------------------------------------
-------##---------------------------------------tt--------------tt--------------------------------SS------------------------------S@S----
------###---------------------------------------tt--------------tt---------------------------------------tt-----------S@S!S--------------
-----####--###---------------------------#------tt-g------#-----tt-----tt--------------------------------tt------------------------------
-M-------#####---------##-#####---------##-#####---------##-------gg---tt-------tt-----gg-------g-g------tt----gg----------------g-------
XXXXXXXX-#####--------###-#####--------###-#####--------###-XXXXXXXXXXXXXXXXXXXXXXXXXXXXXXX---XXXXXXXXXXXXXXXXXXXXXXXXXXXXXXXXXXXXX------
XXXXXXXX-#####-------####-#####-------####-#####-------####-XXXXXXXXXXXXXXXXXXXXXXXXXXXXXXX---XXXXXXXXXXXXXXXXXXXXXXXXXXXXXXXXXXXXX------
