--------------------------------------------------------------------------------------------------------------------------------------------------
--------------------------------------------------------------------------------------------------------------------------------------------------
----------------------------------------------------------------------@---------------------------------------------------------------------------
--------------------------------------------------------------------------------------------------------tt----------------------------------------
--------------------------------------------------------------------------------------------------------tt----------------------------------------
--------------------------------------------------------------------------------------------------------tt----------------------------------------
-----------------------------------------------S!!SSSS!---------------!--!----------------------------------------1----SSS!-----------------------
------------------------------------------------------------------------------------------------------S@S-----------------------------------------
--------------------------------------------------------------------------------------------------------------------------------------------------
---------SU---------------------------------------------------------------------------------------------------------------------------------------
------------------------------SS--#----------S!!S-----C----!--------S@S-----------S@S!S-----------#####---------S@S-------C-----------------------
-----------------#####------------##--------------------------------------------------------------#####-------------------------------------------
-------tt--------#####-----t------###-------------------------------------------------------------#####----------------------g--------------------
-M-g---tt--------#####-----tg-g---####-----------------g---------------#####----------#####--k--------------XXXXXXXXXXX----gXXXXXXXXXXXXXXXXXXXXXX
XXXXXXXXXXXXXX--XXXXXXXXXXXXXXXXXXXXXXXXXXXXXXXXXXXXXXXXXXXXXXXXXXXXXXXXXXXXXXXXXXXXXXXXXXXXXXXXXXXXXXX-----XXXXXXXXXXXXXXXXXXXXXXXXXXXXXXXXXXXXXX
XXXXXXXXXXXXXX--XXXXXXXXXXXXXXXXXXXXXXXXXXXXXXXXXXXXXXXXXXXXXXXXXXXXXXXXXXXXXXXXXXXXXXXXXXXXXXXXXXXXXXX----------------XXXXX----------------------
