---------------------------------------------------------------------------------------------------------------------------------------------
---------------------------------------------------------------------------------------------------------------------------------------------
---------------------------------------------------------------------------------------------------------------------------------------------
---------------------------------------------------------------------------------------------------------------------------------------------
---------------------------------------------------------------------------------------------------------------------------------------------
---------------------------------------------------------------------------------------------------------------------------------------------
---------------------------------------------------------------------------------------------------------------------------------------------
---------------------------------------------------------------------------------------------------------------------------------------------
------#--------------------------------------------------------------------------------------------------------------------------------------
-----##-----------S!!S----------g-----------------tt--------------------SSSS-----------------------------------------------------------------
----###-----------------------SSSSSSSS-------S----tt----SS!--------S@S-------------SS!S---SSSS----------------#----tt------------------------
---####-------------------------------------------tt---------------------------------------------------------##----tt------------------------
-----------------------------g------------------------------------------------------------------------------###----tt------------------------
-M-----------------####---g------------g--####---------tt-------------#####------g---g---------------g-----####------------tt----------------
XXXXXXXX--XXXXXXX--XXXXXXXXXXXXXXXXXXXXX--XXXXXXXXXXXXXXXXXXXXXXXXXXXXXXXXXXXXXXXXXXXXXXXXXXXXXXXXXXXXXXXXXXXXXXXXXXXXXXXXXXXXXXXXXXXXXXXXX--
XXXXXXXX--XXXXXXX--XXXXXXXXXXXXXXXXXXXXX--XXXXXXXXXXXXXXXXXXXXXXXXXXXXXXXXXXXXXXXXXXXXXXXXXXXXXXXXXXXXXXXXXXXXXXXXXXXXXXXXXXXXXXXXXXXXXXXXX--
