---------------------------------------------------------------------------------------------------------------------------------------
---------------------------------------------------------------------------------------------------------------------------------------
---------------------------------------------------------------------------------------------------------------------------------------
---------------------------------------------------------------------------------------------------------------------------------------
--------------------g------------------------------------------------------------------------------------------------------------------
------------------SSSS-----------------------------------------------------------------------------------------------------------------
-----------------------------------------------------------------------1--------------g--------S@S!S-----------------------------------
-----------------g------------------------------------------------------------------SSSS-----------------------------------------------
--------------------------------------------------------------------------------------------------------S@S!S------------------------#-
---------------S@S-----------------SU-----------tt---------------S-----------------g--------------SS--#-----------------------------##-
---------------------------S@S------------------tt--------tt---------------------#####----------------#----------------------------###-
------------------------------------------------tt--------tt---------------------#####----------------###-------------------------####-
-----------tt-g-----------------------------g-g-tt--------tt-g---------gg--------##--####-------g-g---####-----------g----#####-g------
-M-----------------gg----g----#####--------g--------k----------XXXXXXXXXXXX---XXXXX--XXXXXXXXXXXXXXXXXXXXXXXXXXX--XXXXXXXXXXXXXXXXXXXXX
XXXXXXXXXXXXXXXXXXXXXXXXXXXXXXXXXXXXXXXX--XXXXXXXXXXXXXXXXXXXX-XXXXXXXXXXXX---XXXXX--XXXXXXXXXXXXXXXXXXXXXXXXXXX--XXXXXXXXXXXXXXXXXXXXX
XXXXXXXXXXXXXXXXXXXXXXXXXXXXXXXXXXXXXXXX--XXXXXXXXXXXXXXXXXXXX-------------------------------------------------------------------------
