-------------------------------------------------------------------------------------------------------------------------------------------
-------------------------------------------------------------------------------------------------------------------------------------------
-------------------------------------------------------------------------------------------------------------------------------------------
-------------------------------------------------------------------------------------------------------------------------------------------
-------------------------------------------------------------------------------------------------------------------------------------------
-----------------------------------------------------------------------------------------------------------------------------------------tt
--------------------------------------------------------S@S!S----------------------------------------------------@-----------------------tt
----------------#--------------------------------------------------tt--------------------------------------------------------------------tt
----------------##-------------------------------------------------tt-------------tt---------tt------#----------------------S!!S-----g-g-tt
----------------###-------------------#------------#---------------tt-g-!----#----tt---------tt-----##-------1-----------------------------
---------#------SS-------------tt-----##-----------##---------#####---------##----tt-g-------tt----###-----------!--!----------------------
---------##--------------------tt-----###----------###--------#####--------####----------g-g-tt---####-------------------------------------
---------###-------------------tt-g---tt-----------####-------#####---------####------------#####--####--------------------------------gg--
-M----g--####-g-g-----------k--------XXXXXXXXXXXXXXXXXXXX---XXXXXXXXXXXXXX--XXXXXXXXXXX--XXXXXXXX--XXXXXXXXXXXXXXXXXXXXXXXXXXXXXXXX--XXXXX-
XXXXXXXXXXXXXXXXXXXXXXXXXXXXXXXXXXXXXXXXXXXXXXXXXXXXXXXXX---XXXXXXXXXXXXXX--XXXXXXXXXXX--XXXXXXXX--XXXXXXXXXXXXXXXXXXXXXXXXXXXXXXXX--XXXXX-
XXXXXXXXXXXXXXXXXXXXXXXXXXXXXXXXXXXXXX-----------------------------------------------------------------------------------------------------
