--------------------------------------------------------tt-----##-------------------#------------------####-------------------
--------------------------------------------------------tt-----###-----#####-------##------------------####----tt-------------
--------------------------------------------------------tt-g-----------#####------###tt----------------####g---tt--------#####
------------------------------------------------------#####------------#####-----####tt--------------------XXXXXXXXXXXXXXXXXXX
------------------------------------------------------#####----XXXXX--XXXXXXXXXXX----XXXXXXXXXXXXXXXXXXXXXXXXXXXXXXXXXXXXXXXXX
------------------------------------------------------#####----XXXXX--XXXXXXXXXXX----XXXXXXXXXXXXXXXXXXXXXXXXXX---------------
----------------------------------------------------------@-------------------------------------------------------------------
--------------------------------------------------S@S-------------------------------------------------------------------------
------------------------------------------------------------------------------------------------------------------------------
------------------------------------------------------------------------------------------------------------------------------
----------------#-----------------SS----------#####-----!-!--!----------------------------------------------------------------
--------SS!S----##----------------------SU----#####---------------------------------------------------------------------------
----------------###-------tttt----------------#####---------------------------------------------------------------------------
-M--------------------g---tttt--g-g-------------tt----------------------------------------------------------------------------
XXXXXXXXXXXXXXXXXXXXXXXXXXXXXXXXXXXXXXXXXXXXXXXXXXXXXXXXXXXXXXX---------------------------------------------------------------
XXXXXXXXXXXXXXXXXXXXXXXXXXXXXXXXXXXXXXXXXXXXXXXXXXXXXXXXXXXXXXX---------------------------------------------------------------
