-----------------------------------------------------------------------------------------------------------------------------------------------
-----------------------------------------------------------------------------@-----------------------SS!S--------------------------------------
---------------------------------------------------------------tt------------------------------------------------------------------------------
---------------------------------------------------------------tt------------------------------------------------------------------------------
---------------------------------------------------------------tt-g------------------------------------------SS----S!!S------------------------
--------------------------------------------------S--------------------------!-------tt--#------S@S-------------------------S!!S-----#####-----
-----------------@-------------------------tt--------------------------tt------------tt--##-----------------g------------------------#####-----
-------------------------------------------tt--------------------------tt------------tt--###-----------------------------------------#####-----
-------------------------------------------tt-g----------------gg------tt-g------g-g-tt--####---------------------------------------#####-tt---
------------------------------------------------XXXXXXXXXXXXXXXXXXXXXXXXXXXXXXXXXXXXXXXXXXXXXXXXXXXXXXXXXXXXXXXXX--XXXXXXXXXXXXXXXXXXXXXXXXXXXX
-----------------!--!--------------------S@S----XXXXXXXXXXXXXXXXXXXXXXXXXXXXXXXXXXXXXXXXXXXXXXXXXXXXXXXXXXXXXXXXX--XXXXXXXXXXXXXXXXXXXXXXXXXXXX
------------------------------S@S!S------------------------------------------------------------------------------------------------------------
-----------------------------------------------------------------------------------------------------------------------------------------------
-M----------------g-----------------k----------------------------------------------------------------------------------------------------------
XXXXXXXXXXXXXXXXXXXXXXXXXXXXXXXXXXXXXXXXXXXXXX-------------------------------------------------------------------------------------------------
XXXXXXXXXXXXXXXXXXXXXXXXXXXXXXXXXXXXXXXXXXXXXX-------------------------------------------------------------------------------------------------
