------------------------------------------------------------------------------------------------------------------------------------
----------------------------------------------------------##------------------------------------------------------------------------
---------------------------------------------------------###------------------------------------------------------------------------
--------------------------------------------------------####------------------------------------------------------------------------
-------------------------------------------------------------------------SSS!-------------------------------------------------------
----------------------------------------------------S@S-----------------------------------------------------------------------------
------------------------------------------------------------------------------------------------------------------------------------
------------------------------------------------------------------------------------------------------------------------------------
------------------------------------------S!!S------#####-------------------C-------------------------------------------------------
------------S!!S-----------------t------------------#####--------F-------------------SS!S------S!!SSSSS---------------#-----S@S!S---
------------------------tt-----ttt------------------#####--------#-----tt--------------------------------------tt-----##------------
------------------------tt-g---ttt--------------------tt----g------g---tt----g---------------------------------tt-----###-----------
-------t----------------tt-XXXXXXXXXXXXXXXXXXXXX---XXXXXXXXXXXXXXXXXXXXXXXXXXXXXXXXX#####----------------------tt-XXXXXXXXXXXXXXX---
-M-g---tt--tt-----k--------XXXXXXXXXXXXXXXXXXXXX---XXXXXXXXXXXXXXXXXXXXXXXXXXXXXXXXX#####-------------------k-----XXXXXXXXXXXXXXX---
XXXXXXXXXXXXXXXXXXXXXXXXXXXX--------------------------------------------------------#####----------XXXXXXXXXXXXXXXXXXX--------------
XXXXXXXXXXXXXXXXXXXXXXXXXXXX--------------------------------------------------------tt--------XXXXXXXXXXXXXXXXXXXXXXXX--------------
