----------------------------------------------------SSSS-----###-#####--------------
----------------------------------------------#-------------####-#####--------------
--------------------------tt-----------tt-----##------------SS---------------F------
------------------tt------tt-----------tt-----###----------------------------#------
------------------tt------tt-----------tt-g----XXXXXXXXXXX-----XXXXXXXXX--XXXXX-----
------------------tt-g-----XXXXXXXXXXXXXX------XXXXXXXXXXXg-g----tt---------gXX-----
---------------------------XXXXXXXXXXXXXX-----------------XXXXXXXXXXXXXXXXXXXXXXXXXX
-------------S@S------------------------------------------XXXXXXXXXXXXXXXXXXXXXXXXXX
------------------------------------------------------------------------------------
--------------------------------------------------S!!S------------------------------
---------#####------tt--------------------------------------------------------------
-----SU--#####------tt--------------------------------------------------------------
---------#####------tt-g----tt-----------tt----------------F------------------------
-M---------tt----g------g---tt-------g---tt-g--------------#------------------------
XXXXXXXXXXXXXXXXXXXXXXXXXXXXXXXXXXXXXXXXXXXXXXXXXXXXXXXXXXXXX-----------------------
XXXXXXXXXXXXXXXXXXXXXXXXXXXXXXXXXXXXXXXXXXXXXXXXXXXXXXXXXXXXX-----------------------
