---------------------------------------------------------------------------------------------------------------------------------
---------------------------------------------------------------------------------------------------------------------------------
---------------------------------------------------------------------------------------------------------------------------------
---------------------------------------------------------------------------------------------------------------------------------
---------------------------------------------------------------------------------------------------------------------------------
--------------------------------------#-----------S!-----------------------------------------------------------------------------
-------------------------------------##--------------------------------------------------------------tt--------------------------
----------------------tt------------###------##------------------------------------------------------tt--------------------------
----------------------tt-----------####-----###------------------------------------------------------t---------------------------
----------------------tt---------#####-----####----C-----------------------------t---------------g-g-t----------tt---------------
--------------------#####--------#####-----####--------SU--S@S!S---------tt------t-----------S-----SS-----------tt------1--------
-SS!S----------tt---#####-----tt-#####-----####--------------------------tt------t----tt------------------------tt---------------
---------------tt---#####-----tt---tt----g-------------------------------tt-g----S----tt--------------------g-g-tt---------------
---------------tt--k----------XXXXXXXXXXXXXXXXXXXXXXXXXXXXXXXXXXXXXXXXX---------------tt-g-------g-g---------------g-tt-----tt---
XXXXXXXXXXXXXXXXXXXXXXXXXXXXX-XXXXXXXXXXXXXXXXXXXXXXXXXXXXXXXXXXXXXXXXX--------------------XXXXXXXXXXXXXXXXXXXXXXXXXXXXXXXXXXXXXX
XXXXXXXXXXXXXXXXXXXXXXXXXXXXX------------------------------------------XXXXX---g-g---------XXXXXXXXXXXXXXXXXXXXXXXXXXXXXXXXXXXXXX
