----------------------------------------------------------------------------###--------------------------------------
---------------------------------------------------------------------------####--------------------------------------
--------------------------------------------------------------------------#####-----------------------@-------@------
-------------------------------------------------------------------------######--------------------------------------
------------------------------------------------------------------------##---#####-----------------------------------
---------------------------------------------##------g-----------------###XXXXXXXX-----------------------------------
------------------------------SSS!----------###----SSSSSSS------------####XXXXXXXX--------------------!--!----!--!---
-------------------------------------------####----------------------#####-------------------------------------------
------------------------------------------#####---g------------------#####-------------------------------------------
------------------------------------------##-------------------------#####-------------------------------------------
----#---------------------SU-----C--------##----S@S----------tt-----------------#---------tt--------S@S-----S@S------
----##----------#-------------------------##-----------------tt------S@S-------##---------tt-------------------------
----###---------##------------------------##-----------------tt---------------###---------tt-------------------------
-M--####--------###----g----------g---------####-----g-----g-----------------####--------------g---g---k-------------
XXXXXXXXXX---XXXXXXXXXXXXXXXXXXXXXXXXXXXXX--XXXXXXXXXXXXXXXXXXXXXXXXXXXXXXXXXXXXXXXXXXXXXXXXXXXXXXXXXXXXXXXXXXXXX----
XXXXXXXXXX---XXXXXXXXXXXXXXXXXXXXXXXXXXXXX--XXXXXXXXXXXXXXXXXXXXXXXXXXXXXXXXXXXXXXXXXXXXXXXXXXXXXXXXXXXXXXXXXXXXX----
