-------------------------------------------------------------------------------------------------------------------------------------------------
-------------------------------------------------------------------------------------------------------------------------------------------------
-------------------------------------------------------------------------------------------------------------------------------------------------
-------------------------------------------------------------------------------------------------------------------------------------------------
-------------------------------------------------------------------------------------------------------------------------------------------------
-------------------------------------------------------------------------------------------------------------------------------------SSS!--------
---------------------------------------tt-----------------##-------------------------------------------------------------------------------------
---------------------------------------tt----------------###-------------------------------------------------------------------------------------
---------------------------------------tt---------------####-------------------------------------------------------------------------------------
-------------------------------------------------------#####------------------------------------------------!------------------1--------C--------
-------------------------------------S@S---------#----######-----------------------------------------tt-----------#------------------------------
--1---------------------------##----------------##---##--SS------#----#----------------------tt------tt-----------##-----------------------------
-----------------------------###---------------###--###---------##---##-------#----#---------tt------tt-----------###---####-------------g-------
----------------------------####k-------g------###-####--------###--###------##---##----#----tt-gXXXXXXXXXXXXXXXXXXXXX--XXXXXXXXXXXXXXXXXXXXXXXXX
XXXXXXXXXXX---XXXXXXXXXXXXXXXXXXXXXXXXXXXXXXXXXXXXXXX##g-g----####-####-----###--###---###-------XXXXXXXXXXXXXXXXXXXXX--XXXXXXXXXXXXXXXXXXXXXXXXX
XXXXXXXXXXX---XXXXXXXXXXXXXXXXXXXXXXXXXXXXXXXXXXXXXXXXXXXXXX---------------####-####--####-------------------------------------------------------
