-------------------------------------------------------------------------------------------------------------------------------
-------------------------------------------------------------------------------------------------------------------------------
-------------------------------------------------------------------------------------------------------------------------------
-------------------------------------------------------------------------------------------------------------------------------
-------------------------------------------------------------------------------------------------------------------------------
-------------------------------------------------------------------------------------------------S!!S--------------------------
----------------SSS!-----------------------------------------------------------------------------------SSS!--------------------
-------------------------------------------------------------------------------------------------------------------------------
----------------------------------------------------------------------SSSS-----------------------------------------------------
--------------------------------------1-----------#---------------------------------S!!S---------------------------------------
---------S@S-------C-----------------------------##-----#------------S--------------------------S@S-----------------1----------
-----------------------------##-----------------###----##--------------------------------------------------tt------------------
----------------------------###----------------####---###--------------------------------------------------tt----------------F-
-M------------------g------##--tt-----------------#######-------------------------g------------------------tt------------g---#-
XXXX---XXXXXXXXXXXXXXXXXXXXXXXXXXXXXXXXXXXXXXXXXXXXXXXXXXXXXXXXXXXXXXXXXXXXXXXX--XXXXXXXXXXXXXXXXXXXXXXXXXXXXXXXXXXXXXXXXXXXXXX
XXXX---XXXXXXXXXXXXXXXXXXXXXXXXXXXXXXXXXXXXXXXXXXXXXXXXXXXXXXXXXXXXXXXXXXXXXXXX--XXXXXXXXXXXXXXXXXXXXXXXXXXXXXXXXXXXXXXXXXXXXXX
