-------g-g-tt####--------------------------------------------
-------------------------g-----------------------------------
----------------XXXXXXXXXXXXXXXX-----------------------------
---------XXXXX--XXXXXXXXXXXXXXXX--------C--------------------
---------XXXXX-------------------------------##---tt---------
--------------------------------------------###---tt---------
------------------------------SSS!-------g-####---tt---------
-------------------------------------XXXXXXXXXXX#####--------
-------------##----------------------XXXXXXXXXXX#####--------
------------###---------------------------------#####--------
--------#--####------!----S@S----C----!----------------SS!S--
-------##-#####-----------------------------S@S--------------
------###-#####----------------------------------------------
-M---####---####-------------g----g--------------------------
XXXXXXXXXX--XXXXXXXXXXXXXXXXXXXXXXXXXXXXXXXXXXXXXXXXXXXXXXX--
XXXXXXXXXX--XXXXXXXXXXXXXXXXXXXXXXXXXXXXXXXXXXXXXXXXXXXXXXX--
