----------------------------------------------------------------------------------------------------------------------------------
----------------------------------------------------------------------------------------------------------------------------------
-------------------------------------------------------------------##-------------------------------------------------------------
------------------------------------------------------------------###--------------------SSS!-------------------------------------
-----------------------------------------------------------------####---------g---------------------S@S---------------------------
----------------------------------------------------------------#####-------SSSS--------------------------------------------------
-------------------------------------------#-------------------######-------------------------------------------------------------
------------------------------------------##-S@S!S----#--------k-----------g--------#-------C---------------#---------------------
-----------------------------------------###----------##-----XXXXXXXXXXXX#####------##---------------------##---------------------
----------------------------------------####----------###---#XXXXXXXXXXXX#####--------#-------------------###-------tt------------
------------------------S@S------------##--tt---------####---####----tt--#####--------##-----g-tt--------####---g---tt------------
----------tt--------------------------###-XXXXXXXXXXXXXXXXX--XXXXXXXXXXXXXXXXXXXXXXXXXXXXXXXXXXXXXXXX---XXXXXXXXXXXXXXXXXXXXXXXXXX
----------tt-------------------------####-XXXXXXXXXXXXXXXXX--XXXXXXXXXXXXXXXXXXXXXXXXXXXXXXXXXXXXXXXX---XXXXXXXXXXXXXXXXXXXXXXXXXX
-M--------t---------tt----g--------k----------------------------------------------------------------------------------------------
XXXXXXXXXXXXXXXXXXXXXXXXXXXXXXXXXXXXXXXXXXXXX-------------------------------------------------------------------------------------
XXXXXXXXXXXXXXXXXXXXXXXXXXXXXXXXXXXXXXXXXXXXX-------------------------------------------------------------------------------------
