-----------------------------------------------------------------------------------------------------------------------
-----------------------------------------------------------------------------------------------------------------------
---------------------------------------------------------------------------------##------------------------------------
------------------------1----------------------------------------------------------------------------------------------
-----------------------------------------------------------------------------------------------------------------------
-----------------------------------------------------------------------------------------------------------------------
-----------------------------------------------------------------------------------------------------------------------
----------------------S@S---------#-----------------------------------------#SSSS--------------------------------------
---------------------------------##----------------------------------------##------------------------------------------
------------S-------------------###---------------------------------------###-----------------S!!S---------------------
-----tt---------S!#####--------####----------------------------S---------------------------------------------!---------
-----tt-----------#####---------------------------------tt---------------S@S---#####-----------------------------------
-----tt-g---------#####------S@S---------#----#---------tt---------------------#####-----t-----------------------------
-M----g--gXXXXXX--tt--------------------##---##----#----tt-g-------------------#####-g---tt---------------------g------
XXXXXXXXXXXXXXXXXXXXXXXXX--------------###--###---###--------XXXXXXXXXXXXXXXXXXXXXXXXXXXXXXXXXXXXXXXXXXXXXXXXXXXXXXXXXX
XXXXXXXXXXXXXXXXXXXXXXXXXXXX----XXXXXXX###-####--####--------XXXXXXXXXXXXXXXXXXXXXXXXXXXXXXXXXXXXXXXXXXXXXXXXXXXXXXXXXX
