---------------------------------------------------------------------------------------------------------#---------
--------------------------------------------------------------------------------------------#####-------##---------
--------------------------------------------------------------------------------------------#####-------##-------F-
--------------------------------------------------------------------------------------------#####----gg-##-------#-
---------------------------------------------------------------------------------S!!S--------------XXXXXXXXXXXXXXXX
----------------------------------------------------------------------------------------S@S--------XXXXXXXXXXXXXXXX
-------------------------------------------------------------------------------------------------##----------------
-----------------------------------------------##----------S!!S----SU---------------------------###----------------
----------------------------------------------###-------------------------------------S--------####----------------
-----------------------------------------#---####--------------------------S@S----------------#####----------------
------!-------------#-------------tt-----##-#####---------------------------------------------#####----------------
-------------------##------#####---------########-----g---tt------------------------g-g----------------------------
--------------#---###------#####-----g--XXXXXXXXXXXXXXXXXXXXXXXXXXXXXX--XXXXXXXXXXXXXXXX---XXXXXXXXXX--------------
-M-----------##--####------#####--------XXXXXXXXXXXXXXXXXXXXXXXXXXXXXX--XXXXXXXXXXXXXXXX---XXXXXXXXXX--------------
XXXXXXXXXXXXXXXXXXXXXXXXXXXXXXXXXXXXXXXXX--------------------------------------------------------------------------
XXXXXXXXXXXXXXXXXXXXXXXXXXXXXXXXXXXXXXXXX--------------------------------------------------------------------------
