-----------------------------------------------------------------------------------------------------------------------------------------
-------------------------------------------------------------------------------------------------------S!!S------------------------------
---------------------------------------------------------------------------------#-------------------------------------------------------
--------------------------------SSSS---SSS!-------------------------------------##-------------------------------------------------------
-------------------------------------------------------------------------------###-------------------------------------------------------
------------------------------------------------------------------------------####----------------------------------tt-----#-------------
---------------##------------------------------------------------S-------------------------------S@S--------!-------tt-------------------
--------------###-------SS!S--------------C---------------tt----------------S@S-------------------------------------tt-------------------
-------------####--------------SU-------------------------tt---------------------------tt-----------------------g-g-tt-------------------
-----tt-----#####-------------------------------tt--------tt-g---------------------g---tt-g--------####--------g---------------#####-----
-----tt----######-----g--------------------gg---tt--k----------XXXXXXXXXXX--XXXXXXXXXXXXXXXXXXXXX--XXXXXXXXXXXXXXXXXXXX---XXXXXXXXXXXXXXX
-----tt---##XXXXXXXXXXXXXXXXXXXXXXXXXXXXXXXXXXXXXXXXXXXXXXXXXX-XXXXXXXXXXX--XXXXXXXXXXXXXXXXXXXXX--XXXXXXXXXXXXXXXXXXXX---XXXXXXXXXXXXXXX
-g-g-tt--###XXXXXXXXXXXXXXXXXXXXXXXXXXXXXXXXXXXXXXXXXXXXXXXXXX---------------------------------------------------------------------------
-M------####-----------------------------------------------------------------------------------------------------------------------------
XXXXXXXX---------------------------------------------------------------------------------------------------------------------------------
XXXXXXXXXXXXXXX--------------------------------------------------------------------------------------------------------------------------
