------------------------------------------------------------------------------------------------------------------
------------------------------------------------------------------------------------------------------------------
------------------------------------------------------------------------------------------------------------------
------------------------------------------------------------------------------------------------------------------
----------------------------------------------------------------------1-------------------------------------------
-----------------------------------------------------------------#------------------------------------------------
----SS!S-----------------------------SSS!-----tt-----#----------##------------------------------------------------
----------------------------------SU----------------##---------####-------------------------------1------S@S!S----
---------------------------------------------------###--------#####-----S@S!S-------tt----------------#-----------
-------------------------S!!S---------------------####-------######-----------------tt----------------##----------
---S@S-------1--------------------SS----C----S!!S------------g--------g-------------tt-------g-tt-----###--------g
-----------------------------------------------------------#XXXXXXXXXXXXXXXXXXXXXXXXXXXXXXXXXXXXXXXXXXXXXXXXXXXXXX
--------------------------------------------------XXXXX---##XXXXXXXXXXXXXXXXXXXXXXXXXXXXXXXXXXXXXXXXXXXXXXXXXXXXXX
-M----#####---g----#####--####--g-g---------------XXXX--k---------------------------------------------------------
XXXXXXXXXXXXXXXXXXXXXXXX--XXXXXXXXXXXXXXXXXXXXXXXXXXXXXXXXXXXXXXXX------------------------------------------------
XXXXXXXXXXXXXXXXXXXXXXXX--XXXXXXXXXXXXXXXXXXXXXXXXXXXXXXXXXXXXXXXX------------------------------------------------
