-----------------------------------------------------------------------------------------------------------------------------------------------
-----------------------------------------------------------------------------------------------------------------------------------------------
-----------------------------------------------------------------------------------------------------------------------------------------------
-----------------------------------------------------------------------------------------------------------------------------------------------
-----------------------------------------------------------------------------------------------------------------------------------------------
--------------------------------------------------------------------------------#--------------------------------------------------------------
-----------------------------------SSS!---------------------------------SSS!---##--------------------------------------------------------------
-----------------------SS!S---------------------------------------------------###--------------------------------------------------------------
-----------------------------------------------------------------------------####--------------------------------------------------------------
-----------------------------------------------------------------------------------------------------------t-----------------------------------
-------------------------XXXX---------C--#-----SU-------------#-------------S@S-------#--------------------t----tt-----------------------------
------------------S@S----XXXX------------##-------------------##---------------------##----------SS!S------t----tt----------------S@S!S--------
-------------t-------------------tt------###------------------###-------------------###----------------g-g-t----tt-----------------------------
-M-------g---t---------------g---tt----g-####-------g--tt------g------------g------####-------------------g------------------------------------
XXXX---XXXXXXXXXXXXXXXXXXXX--XXXXXXXXXXXXXXXXXXXXXXXXXXXXXXXXXXXXXXXXXXXXXXXXXXXXXXXXXXXXXXXXXXXXXXXXXXXXXXXXXXXXXXX---XXXXXXXXXXXXXXXXXXXXXX--
XXXX---XXXXXXXXXXXXXXXXXXXX--XXXXXXXXXXXXXXXXXXXXXXXXXXXXXXXXXXXXXXXXXXXXXXXXXXXXXXXXXXXXXXXXXXXXXXXXXXXXXXXXXXXXXXX---XXXXXXXXXXXXXXXXXXXXXX--
