-----------------------------------------------------------------------------------------------------------------------------------------
-----------------------------------------------------------------------------------------------------------------------------------------
-----------------------------------------------------------------------------------------------------------------------------------------
--------------------------SU-------------------------------------------------------------------------------------------------------------
-----------------------------------------------------------------------------------------------------------------------------------------
-----------------------------------------------------------------------------------------------------------------------------------------
-----------S!!S------------------------------------SSS!-------------------------------------------------------------SSS!-----------------
------------------------S@S--------------------------------------------------------------------------------------------------------------
-----------------------------------------------------------------------##----------------------------------------------------------------
----------------------------------------------------------------------###------------------------------------S@S!S-----------------------
------------SS-------#----------------SU--------tt----C---S@S!S------####---------------S@S---------#---#--------------C--S@S!S--S@S!S---
----tt--------------##--------------------------tt------------------#####--------------------------##---##-------------------------------
----tt-------------###--------------------------tt------------------#####-------------------------###---###------------------------------
----tt----g-g-----####--------g-------------g-g-tt-----g---g---####------------------------------####---####------------g----------------
XXXXXXXXXXXXXXXXXXXXXXXX---XXXXXXXXXXXXXXXXXXXXXXXXXXXXXXXXXX--XXXXXXXXXXXXXX---XXXXXXXXXXXXXXXXXXXXXXXXXXXXXXXXXX--XXXXXXXXXXXXXXXXXXX--
XXXXXXXXXXXXXXXXXXXXXXXX---XXXXXXXXXXXXXXXXXXXXXXXXXXXXXXXXXX--XXXXXXXXXXXXXX---XXXXXXXXXXXXXXXXXXXXXXXXXXXXXXXXXX--XXXXXXXXXXXXXXXXXXX--
