-----------------------------------------------------------------------------------------------------------------------------
-----------------------------------------------------------------------------------------------------------------------------
-----------------------------------------------------------------------------------------------------------------------------
-----------------------------------------------------------------------------------------------------------------------------
-----------------------------------------------------------------------------------------------------------------------------
-----------------------------------------------------------------------------------------------------------------------------
-----------------------------------------------------------------------------------------------------SSSS--------------------
---------------------------------------------------------------------------------------------------S!------------------------
----------------------------------------------------------------------------------------------##-----------------------------
----------------------------------S!-----------------------------------S!--------------------###-----------------------------
-------tt------##--#-----------------#--------------#--------S@S!S-----------------------#--####-----------------#-----------
-------tt-----###--##----------------##------------##---------------------S@S!S---------##-#####---##-----------##-#####-----
-------tt----####--###---------------###----------###----------------------------------###-#####---##----------###-#####-----
-M-g-g-tt-----------#####--k---------####--------####--------g------------------------####--------###---------####-#####-----
XXXXXXXXXXXXXXXXXXXXXXXXXXXXXXXXXXXXXXXXXXXXXXX-XXXXXXXXXXXXXXXXXXXXXXXXXXXXXXXXXX---XXXXXXXXXXX--tt-XXXXXXXXXXXXXX--SS------
XXXXXXXXXXXXXXXXXXXXXXXXXXXXXXXXXXXXXXXXXXXXXXX-XXXXXXXXXXXXXXXXXXXXXXXXXXXXXXXXXX---XXXXXXXXXXXXXXXXXXXXXXXXXXXXXX----------
