--------------------------------------------------------------------------------------------------------------------------
--------------------------------------------------------------------------------------------------------------------------
-------------------------------------------------##-----------------------------------------------------------------------
------------------------------------------------###----------------------------------------tt-----------------------------
-----------------------------------------------####----------------------------------------tt-----------------------------
----------------------------------------------#####----------------------------------------tt-g---------------------------
----------------------------------------------#####---------------------------------------------------------SSS!----------
--------------@-------------------------------#####--------------------------------------S@S------------------------------
----------------------------------------------#####----------------------------------------------------tt-----------------
----------------------------------------------#####----------##----------------------------------------tt-----------------
------------------------#---------------------------1-------###------------------------SS--------------tt------C--------g-
--------------!--!------##----------------S@S--------------####------------1----tt------------------k-----------------SSSS
------------------------###----------#--------------------#####-----------------tt-------------X--XXXXXXXXXX--------------
-M---tt------------------#####------##-------------------g#####-----------------tt-g-g-g--------------XXXXXX----g----g----
XXXXXXXXXXXXXXXXXXXXXXXXXXXXXXXXXXXXXXXXXXX--XXXXXXXXXXXXXXXXXXXXXXXXXXXXXXXXXXXXXXXXXXXXXXXXXXXXXXXXXXXXXXXXXXXXXXXXXXXX-
XXXXXXXXXXXXXXXXXXXXXXXXXXXXXXXXXXXXXXXXXXX--XXXXXXXXXXXXXXXXXXXXXXXXXXXXXXXXXXXXXXXXXXXXXXXXXXXXXXXXXXXXXXXXXXXXXXXXXXXX-
