--------------------------------------------------------------------------------------------------------------------------------------
--------------------------------------------------------------------------------------------------------------------------------------
--------------------------------------------------------------------------------------------------------------------------------------
--------------------------------------------------------------------------------------------------------------------------------------
--------------------------------------------------------------------------------------------------------------------------------------
--------------------------------------------------------------------------------------------------------------------------------------
-----------------------SS!S-------@----------------------------------------------------------SSS--------------------------------------
--------------------------------------------------------------------------------------------------------------------------------------
-----------------------------------------------------------------------------##-------------------------------------------------------
---------------------------------------S@S!S--------------------------------###------SS!S---------------------------------------------
----S@S----1----------S@S---------!----------------SS---------tt-SSSS------####--------------------tt---------------t------------1----
--------------------------------------------------------------tt----------#####--------------------tt------tt-------t-----------------
--------------------------------------------------------------tt----------#####--------------------tt------tt----M--t-----------------
-M---tt---------g--gg----#####--tt-----gg--------g-g----------tt-------------g-------------------g---------tt-XXXXXXXXXXXXXXXXXXXX----
XXXXXXXXXXXXXXXXXXXXXXXXXXXXXXXXXXXXXXXXXXXXXXX--XXXXXXXXXXXXXXXXXXXXXXXXXXXXXXXXXXXXXXXXXX--XXXXXXXXXXXXXXXX-XXXXXXXXXXXXXXXXXXXX----
XXXXXXXXXXXXXXXXXXXXXXXXXXXXXXXXXXXXXXXXXXXXXXX--XXXXXXXXXXXXXXXXXXXXXXXXXXXXXXXXXXXXXXXXXX--XXXXXXXXXXXXXXXXXXX----------------------
