-------------------------------------------------------------------------------------------------------------------------------------------------------------
-------------------------------------------------------------------------------------------------------------------------------------------------------------
-------------------------------------------------------------------------------------------------------------------------------------------------------------
-------------------------------------------------------------------------------------------------------------------------------------------------------------
-------------------------------------------------------------------------------------------------------------------------------------------------------------
-------------------------------------------------------------------------------------------------------------------------------------------------------------
-----------------------------------------------------------------------------------------------------------------SSS-----------------------------------------
-------------------------------------------------------------------------------------------------------------------------------------------------------------
--------------------------------------------------------##---------------------------------------------------------------------------------------------------
-------------------------------------------------------###--------------------------------------------------S!!S---------------------------------------------
-----------------tt----tt----#----------------##--#---####--------------##----------------------SS!S-------------------#-------------------------------------
-----------------tt----tt----##--------S-----###--##-#####-------------###--------------------------------------------##-------------------------------------
-------tt--------tt----tt----###------------####--########------------####-------------------------------------------###-------------------------------------
-M-g---tt--------------------####------------------g---####--------------g----------g-----------------tt------------####-------------------------tt----------
XXXXXXXXXXXXXXXXXXXXXXXXXXXXXXXXXXXXXXXXXXXXXXXXXXXXX--XXXXXXX---XXXXXXXXXXXXXXXXXXXXXXXXXXXXXXXXXXXXXXXXXXXXXXXXXXXXXXXXXXXXXXXXXXXXXXXXXXXXXXXXXXXXXXXXXXXX
XXXXXXXXXXXXXXXXXXXXXXXXXXXXXXXXXXXXXXXXXXXXXXXXXXXXX--XXXXXXX---XXXXXXXXXXXXXXXXXXXXXXXXXXXXXXXXXXXXXXXXXXXXXXXXXXXXXXXXXXXXXXXXXXXXXXXXXXXXXXXXXXXXXXXXXXXX
