---------------------------------------tt------###-----------g----------------------------------
----------------------------------------------####---------SSSSSSSS-----------------------------
---------------------------------------XXXXX-------------tt-------------------------------------
---------------------------------------XXXXX---------g---tt-------------------------------------
----------------------------------------------XXXXX--XXXXXXXXXXXX-------------------------------
--------------------------------------S!!S----XXXXX--XXXXXXXXXXXX----------#--------------------
--------------------------------------------------------------------------##--------------------
--------S!!S-------------------------------------------------------------###-S@S!S--------------
------------------------------------------------------------------------####--------------------
-----------------------------------------------#------------------------------------------------
----------------------------------------------##---#-------S!!S-------S@S---------------S@S!S---
-------#####---------------SU-----------tt---###---##-------------------------------------------
-------#####----------tt------------g---tt--####---###------------------------------------------
-M-----#####------g---tt------------XXXXXX-------g-####-----------------####----gg---k----------
XXXXXXXXXXXXXXXXXXXXXXXXXXXXXXXXXXXXXXXXXXXXXXXXXXXXXXXXXXXXXXXXXXXXXX--XXXXXXXXXXXXXXXXXXXXXXX-
XXXXXXXXXXXXXXXXXXXXXXXXXXXXXXXXXXXXXXXXXXXXXXXXXXXXXXXXXXXXXXXXXXXXXX--XXXXXXXXXXXXXXXXXXXXXXX-
