-------------------------------S@S------------------------------------------------------------------------------------------
----------------------------------------------------------------------------------------------------------------------------
----------------------------------------------------------------------------------------------------------------------------
---------------------------#####-------------------------------------@------------------------------------------------------
---------------------------#####--------------------------------------------------------------------------------------------
---------------------------#####---------------------@----------------------------------------------------------------------
-------------------------------------SSS!-----------------------------------------------------------------------------------
---------------------------S@S---------------------------------------!--!---------------------------------------------------
----------------------------------------------------------------------------------------------------------------------------
-------------------------------S@S!S-----------------!--!---------------------------------------------g-g-------------------
----S@S!S----!--------------------------C--------1--------------#----SS-------------------------1-----####------------------
----------------------------------------------------------------##-------------------#----------------####------------------
-------------------tt-------------------------------------------###-----------#------##---------------####---F--------------
-M-------g-----g---tt--------gg----------g----g---------------tt---g-g----tt-----------------tt-----####-----#--XXXXXXXXXXXX
XXXXXXXXXXXXXXXXXXXXXX---XXXXXXXXXXXXXXXXXXXXXXXXXXXXXXXXX--XXXXXXXXXXXXXXXXXXXX---XXXXXXXXXXXXXXX--XXXXXXXXXXX-XXXXXXXXXXXX
XXXXXXXXXXXXXXXXXXXXXX---XXXXXXXXXXXXXXXXXXXXXXXXXXXXXXXXX--XXXXXXXXXXXXXXXXXXXX---XXXXXXXXXXXXXXX--XXXXXXXXXXX-------------
