--------------#-----------------------------tt-----##-------------------------
--------------##----------------------------tt-----###------------------------
--------gg----###---g-----g-----------------tt-g-#####------------------------
------XXXXXXXXXXXXXXXXXXXXXXXXXXXXXXXXXXXXXXXXXXX#####------------------------
------XXXXXXXXXXXXXXXXXXXXXXXXXXXXXXXXXXXXXXXXXXX#####------------------------
------------------------------------------------------------------------------
-------------------------------------------------S@S---------#----------------
------------------------------------------------------------#-----------------
-----------------##----------------------------------------##-----------------
----------------###---------------------------------------###-----------------
---------1-----####-------tt--#---------------tt-----------S-----tt-----------
--------------#####-------tt--##-----SS!S-----tt------1----------tt-----------
--------------#####-------tt--###-------------tt-g---------------tt-g-------F-
-M----g--tt------#####--------####---------------------------------g--gg----#-
XXXXXXXXXXXXXXXXXXXXXXXXXXXXXXXXXXXXXXXXXXXXXXXXXXXXXXXXXXXXXXXXXXXXXXXXXXXXXX
XXXXXXXXXXXXXXXXXXXXXXXXXXXXXXXXXXXXXXXXXXXXXXXXXXXXXXXXXXXXXXXXXXXXXXXXXXXXXX
