-------------------------------------------------------------------------------------------------------------------------------------------------------
-------------------------------------------------------------------------------------------------------------------------------------------------------
-------------------------------------------------------------------------------------------------------------------------------------------------------
-------------------------------------------------------------------------------------------------------------------------------------------------------
-------------------------------------------------------------------------------------------------------------------------------------------------------
-----------------------------------------------------g-----------------#--------------------##---------------------------------------------------------
---------------------------------------------------SSSSSSSS-----------##-------------------###---------------------------------------------------------
---------------------------------------------------------------------###------------------####---------------------------------------------------------
--------------------------------------------------g-----------------####-----------------#####----------------------------------------------S----------
------tt---------------------------------------------------------------------------------#####------#----------------------1---------tt----------------
------tt-----!--#------tt-------S@S-------------S@S-----#----------S@S-------------------#####------##--#----------------------------tt----------------
------tt--------##-----tt-------------------------------##-------------------------------#####------##--##---------------------------tt-g-------------g
--g-g-tt--------###----tt--------------#----------------###------------------------------#####------##--###-------------tt-----k----------XXXXXXXXXXXXX
-M-------g------####---####----------####---tt----tt----####---------tt-----------------k----------XXXXXXXXXXXXXXXXXXXXXXXXXXXXXXXXXXXXXX-XXXXXXXXXXXXX
XXXXXXXXXXXXXXXXXXXXX--XXXXXXXXXXXXXXXXXXXXXXXXXXXXXXXXXXXXXXXXXXXXXXXXXXXXXXXXXXXXXXXXXXXXXXXXXXX-XXXXXXXXXXXXXXXXXXXXXXXXXXXXXXXXXXXXXX--------------
XXXXXXXXXXXXXXXXXXXXX--XXXXXXXXXXXXXXXXXXXXXXXXXXXXXXXXXXXXXXXXXXXXXXXXXXXXXXXXXXXXXXXXXXXXXXXXXXX-----------------------------------------------------
