----------------------------------------------------------------------------------------------------------------------------------------------
------------------------------------------------------------------------------------------------------------------##--------------------------
-----------------------------------------------------------------------------------------------------------------###--------------------------
----------------------------------------------------------------------------------------------------------------####--------------------------
---------------------------------------------------------------------------------------------------------------#####--------------------------
--------------------------------------------------------------------------------------------------------------######--------------------------
--------------------------------------------------------------------------------------------------------S----##-----------#####---------####--
--------------------------------------------------------------------------------------tt---------tt---------###-XXXXXXXXXXXXXXXXXXXXXX--XXXXXX
--------------------------------------------------------------------------------------tt---------tt--------####-XXXXXXXXXXXXXXXXXXXXXX--XXXXXX
-------------------------------------------------------------------g------------------tt---------tt-g-----------------------------------------
------!--#--------#----#------#----------------------------------SSSSSSSS----------------------#####--XXXXXXXXXXX-----------------------------
---------##-------##---##----##-------S@S!S----------tt----------------------------------------#####--XXXXXXXXXXX-----------------------------
---------###------###--##---###----------------------tt---------g------------------------------#####------------------------------------------
-M-------tt----g-------##--####----------------------tt-g-####--------------------g---gg------------------------------------------------------
XXXXXXXXXXXXXXXXXXXXXXXXXXXXXXXXXXXXXXXXXXXXXXXXXXXXXXXX--XXXXXXXXXXXXXXXXXXXXXXXXXXXXXXXXXXXXXX-XXXXX----------------------------------------
XXXXXXXXXXXXXXXXXXXXXXXXXXXXXXXXXXXXXXXXXXXXXXXXXXXXXXXX--XXXXXXXXXXXXXXXXXXXXXXXXXXXXXXXXXXXXXX-XXXXX----------------------------------------
