-------------------------------------------------------------------------------------------------------------------------------
-------------------------------------------------------------------------------------------------------------------------------
-------------------------------------------------------------------------------------------------------------------------------
-------------------------------------------------------------------------------------------------------------------------------
-------------------------------------------------------------------------------------------------------------------------------
-------------------------------##----------------------------------------------------------------------------------------------
------------------------------###----------------------------------------------------------------------------------------------
-----------------------------####-------SS!S----------------------------------------------S!!SSSSS-----------------------------
----------------------------#####------------------------------------------#---------------------------------------------------
---------------------------######-----------------#---------SS!S---S@S!S---##--------------------------------S!!SSSSS----------
-------SU-----####--------##--SS-------#####------##-----------------------###-------------------------------------------------
--------------####-------###-----------#####------###---------------------------g--k--------------SS---------------------------
--------------####----tt####-----------###--------####----#####-g-XXXXXXXXXXXXXXXXXXXXXXXXXXX----------------------------------
-M--g------------gg---tt--##g-g---k-------XXXXXXXXXXXXXXXXXXXXXXXXXXXXXXXXXXXXXXXXXXXXXXXXXXX-----------###--------------------
XXXXXXXXXXXXXXXXXXXXXXXX--XXXXXXXXXXXXXXXXXXXXXXXXXXXXXXXXXXXXXXXXXXXXX-------------------------g-g----####----XXXXXXXXXXXXXXXX
XXXXXXXXXXXXXXXXXXXXXXXX--XXXXXXXXXXXXXXXXXX----------------------------------------------------XXXXXXXXXXXXXXXXXXXXXXXXXXXXXXX
