--------------------------------------------------------------------------------------------------------------------------------------------
--------------------------------------------------------------------------------------------------------------------------------------------
--------------------------------------------------------------------------------------------------------------------------------------------
-------------------------------------------------------------------------------------------------------------@------------------------------
--------------------------------------------------------------------------------------------------------------------------------------------
----------------------------------------SSSS------------------------------------------------------------------------------------------------
-----------------------------------------------------------------------------------------------------------------------##-------------------
-------------------------------------------------------------------------------------------------------------!--!-----###-------------------
----------------------------------------------------------------------------------------------------S@S!S------------####-------------------
----------g----------------------------------------SSSS----------------------------------tt-------------------------#####-------------------
--------SSSSSSS---tt--------1-----------!----------------------#-#---------------tt------tt-------------------------#####-------------------
------------------tt------------------------------#-----------##-##--------------tt------tt-----------------g----------g------------------g-
-------g----------tt-----------------------------##--------------###------tt-----tt-g---XXXXXXXXXXXXXXXXXXXXXXXXXX--XXXXXXXXXXXXXXXXXXXXXXXX
-M--g-------------####---tt---------g-------------#####----------####-g---tt--k---------XXXXXXXXXXXXXXXXXXXXXXXXXX--XXXXXXXXXXXXXXXXXXXXXXXX
XXXXXXXXXXXXXXXX--XXXXXXXXXXXXXXXXXXXXXXXXXXXXXXXXXXXXXXXXXXXX--XXXXXXXXXXXXXXXXXXXXXXXX----------------------------------------------------
XXXXXXXXXXXXXXXX--XXXXXXXXXXXXXXXXXXXXXXXXXXXXXXXXXXXXXXXXXXXX--XXXXXXXXXXXXXXXXXXXXXXXX----------------------------------------------------
