------------------------------#--------------g-------------------------------------
----------------------------SS------#----#XXXXXXXXXXXX-----------------------------
-----------------------------------##---##XXXXXXXXXXXX---------#-------------------
--------------tt------------------###--###--------------------##-------------------
--------------tt----------g-g----####-####-------------------###-------------------
--------------tt----------XXXXX-----------------------------####-------------------
----------g-g-tt------SSS!XXXXX----------------------------------------------------
----------#####-------------------------------------------S@S---------#------------
----------#####------------------------------------------------------##------------
----------#####-----------------------------------------------------###------------
------------SS----#####-------!----#---tt-----------------#--------####---------##-
----SU------------#####-----------##---tt--------S@S!S----##-----#####---------###-
------------------#####----------###---tt-----------------###----#####--------####-
----------g-g--------g----g--------g----#####-------------####---#####-------------
XXXXXXXXXXXXXXXXXXXXXXXXXXXXXXXXXXXXXXXXXXXXXXXXXXXXXXXXXXXXXXXXXXXXXXXXXXXXXXXXXXX
XXXXXXXXXXXXXXXXXXXXXXXXXXXXXXXXXXXXXXXXXXXXXXXXXXXXXXXXXXXXXXXXXXXXXXXXXXXXXXXXXXX
