-------------------------------------------------------------------------------------------------------------------------------------------
-------------------------------------------------------------------------------------------------------------------------------------------
-------------------------------------------------------------------------------------------------------------------------------------------
-------------------------------------------------------------------------------------------------------------------------------------------
-------------------------------------------------------------------------------------------------------------------------------------------
---------------g---------------------------------------------------------------------------------------------------------------------------
-------------SSSSSSS!-----------------------------------------------------------------SS!S-------------------------------------------------
--------------------------------------------------S@S!S------------------------------------------------------------------------------------
------------g---------------------------------------------------------------------------------##-------------------------------------------
----------------------------------------------------------------------S@S!S------------------###--------#----------------------------------
----------S@S-------C------------------------------------------------------------S@XX-------####-------##-----------g-----SU----------#----
---------------------------------1-------------------------------------------------XX------#####------###---------SSSS----------S@S!S-##---
-------------------------------------------------------------------------------------------#####-----###------------------------------###--
-M------tt-----------g-------------------------------gg---tt-------------------####----------####-----g----------g-----g--------------####-
XXXXXXXXXXXXXXXXXXXXXXXXXXXXXXXXXXXXXXXXXXXXXXXXXXXXXXXXXXXXXXXXXXXXXXXXXXX----XXXXXXX---XX--XXXXXXXXXXXXXXXX--XXXXXXXXXXXXXXXXXXXXXXXXXXXX
XXXXXXXXXXXXXXXXXXXXXXXXXXXXXXXXXXXXXXXXXXXXXXXXXXXXXXXXXXXXXXXXXXXXXXXXXXX----XXXXXXX---XX--XXXXXXXXXXXXXXXX--XXXXXXXXXXXXXXXXXXXXXXXXXXXX
