------------------------------------------------------------------------------------------------------------------------------------------
------------------------------------------------------------------------------------------------------------------------------------------
------------------------------------------------------------------------------------------------------------------------------------------
------------------------------------------------------------------------------------------------------------------------------------------
------------------------------------------------------------------------------------------------------------------------------------------
----------------------------------------------------------------##------------------------------------------------------------------------
---------------------------------------------------------------###--------------------------------------@---------------------------------
--------------------------------------------SU----------------####------------------------------------------------------------------------
-------------------------------------------------------------#####------------------------------------------------------------------------
-------#----#------------------------------------------------#####----------#-------------------------------------------------------------
SS----##---##----#------------SS!---------------------SS!S---#####---------##---------------------------!--!---!--------------------------
-----###--###----##-----------------SU-----------------------#####--------###------SU---tt------------------------------------------------
----####-####----###-----------------------------------------#####-------####-----------tt----------------------------------tt------------
-----------------####-------g---------------gg--g-------------------g---------g---------tt-----------g------------------g---tt--k---------
XXXXXXXXXXXXXXX-XXXXXXXXXXXXXXXXXXXXXXXXXXXXXXXXXXXXXXXXXXXXXXXXXXXXXXXXXXXXXXXXXXXXXXXXXXXXXXX---XXXXXXXXXXXXXXXXXXXX--XXXXXXXXXXXXXXXXXX
XXXXXXXXXXXXXXX-XXXXXXXXXXXXXXXXXXXXXXXXXXXXXXXXXXXXXXXXXXXXXXXXXXXXXXXXXXXXXXXXXXXXXXXXXXXXXXX---XXXXXXXXXXXXXXXXXXXX--XXXXXXXXXXXXXXXXXX
