------------------------------------------------------------------------------------------------------------------------
------------------------------------------------------------------------------------------------------------------------
------------------------------------------------------------------------------------------------------------------------
------------------------------------------------------------------------------------------------------------------------
------------------------------------------------------------------------------------------------------------------------
--------------------------------------------------------------------------------------------------------------#---------
-------------------------------------------------------------------------------------------------------------##---------
----------------SSSS-----------------##----#-------------------------------1--------------------------------###---------
------------------------------------###---##-------g--------#-----tt---------------1-----------------!-#---####---------
---------------#-------------------####--###-----SSS---SS!S-#-----tt-----------------------------------#-#####----------
--------tt-----#------------------#####-####----------------#-----tt----------------------------tt-----#-#####--------F-
--------tt-----###----------#----######--tt-----g-----------#-g-g-tt------------g---------g-g---tt-----#-#####--------#-
--------tt-g-#####---------##---XXXXXXXXXXXXXXXXXXXXXXXXXXXXXXXXXXXXXXXXXXXXX--XXXXXXXXXXXXXXXXXXXXXXXX------------XXXXX
-M----g------#####--------###--#XXXXXXXXXXXXXXXXXXXXXXXXXXXXXXXXXXXXXXXXXXXXX--XXXXXXXXXXXXXXXXXXXXXXXX----XXXXX---XXXXX
XXXXXXXXXXXXX#####-------####-####-------------------------------------------------------------------------XXXXX--------
XXXXXXXXXXX------------XXXXXXX------------------------------------------------------------------------------------------
