--------------------------------------------------------------------------------------------------------------------------------------------
--------------------------------------------------------------------------------------------------------------------------------------------
--------------------------------------------------------------------------------------------------------------------------------------------
--------------------------------------------------------------------------------------------------------------------------------------------
--------------------------------------------------------------------------------------------------------------------------------------------
-------------------------------------------------------------------------------------------------------------------@------------------------
--------------------------------------------------------------------------------------------------------------------------------------------
------1-------SS!S-----tt-------------------------------------------------------------------------------------------------------------------
-----------------------tt-----------------------tt------#-----------------------------------------------------------------------------------
-----------------------tt-------#---------------tt-----##----------------------------SS--SS---------------------#--!--!-------S@S-----------
-----------SS--------####-------##--------------tt----###--------tt--------S@S-----------------------#---------##---------------------------
---------------------####----tt-###---------g-g-tt---####--------tt----------------------------------##-------###-------------------------tt
---------------------####g---tt-####----------####---tt-----#----tt-g-------------tt---g-g-----------###-----####--####-----g----#####g---tt
-M-------g-g----k--------XXXXXXXXXXXXXXXXXXX--XXXXXXXXXXXX--XXXXXXXXXXXXXXXXXXXXXXXXXXXXXXXXXXXXXXXXXXXXXXXXXXXXX--XXXXXXXXXXXXXXXXXXXXXXXXX
XXXX---XXXXXXXXXXXXXXXXXXXXXXXXXXXXXXXXXXXXX--XXXXXXXXXXXX--XXXXXXXXXXXXXXXXXXXXXXXXXXXXXXXXXXXXXXXXXXXXXXXXXXXXX--XXXXXXXXXXXXXXXXXXXXXXXXX
XXXX---XXXXXXXXXXXXXXXXXXX------------------------------------------------------------------------------------------------------------------
