--------------------------------------------------------------------------------SSS!------------------------------------------------
------------------------------------------------------------------------------------------------------------------------------------
------------------------------------------------------------------------------------------------------------------------------------
------------------------------------------------------------------------------------------------------------------------------------
-------------------------------------------------------------------------S@S-------C-----------tt-------S@S!S-----------------------
-----------------------------------------------------------------------------------------------tt-----------------------------------
-----------------------------------------------------------------------------------------------tt-g---------------------------------
-------------------------------------------------------------------------#####------g------------g---g---------g---------------tt---
-------------------------------------------------------------------------#####--XXXXXX---XXXXXXXXXXXXXXXXXXXXXXXXXXXXXXXXXXXXXXXXXXX
----------------------------------------------------------------SSSSS----#####--XXXXXX---XXXXXXXXXXXXXXXXXXXXXXXXXXXXXXXXXXXXXXXXXXX
--S@S!S--------------------------#---------S!!S--------tt---------------------------------------------------------------------------
---------------S@S!S-------------##--S@----------------tt----------------S@S--------------------------------------------------------
---------------------------------###-------------------tt-------------------------F-------------------------------------------------
-M---####------------------tt----###----------------g-------tt--------------------#-------------------------------------------------
XXX--XXXXXXXXXXXXXXXXXXXXXXXXXXXXXXXXXXXXXXXXXXXXXXXXXXXXXXXXXXXXXXXXXXXXXXXXXXXXXXX------------------------------------------------
XXX--XXXXXXXXXXXXXXXXXXXXXXXXXXXXXXXXXXXXXXXXXXXXXXXXXXXXXXXXXXXXXXXXXXXXXXXXXXXXXXX------------------------------------------------
