------------------------------------------------------------------------------------------------------------------------------------------------
------------------------------------------------------------------------------------------------------------------------------------------------
------------------------------------------------------------------------------------------------------------------------------------------------
------------------------------------------------------------------------------------------------------------------------------------------------
------------------------------------------------------------------------------------------------------------------------------------------------
-------------------------------------------------------------------------------------------------------------------------tt---------------------
-------------------------------------------------------------S------------------SSS!-------------------------------------tt---------------------
-------------------------------------------------------------------------------------------------------------------------tt-g----------------#--
-------------------------tt-----------------------------------------------------------------------------------------#--------------------g--##--
-------------------------tt----------------------------------------------------------------------------------tt-----##-----------------SSSS###--
------------------!------tt---------------tt-----#---------##----SS!S--------tt----C-------------------------tt-----###--------------------###--
-----------------------#####--------------tt-----##-------###----------------tt------------------------------tt---tt-----gg---tt------g----tt---
-----------------------#####--------------tt-g---###-----####----------------tt------------------------k--------XXXXXXXXXXXXXXXXXXXXXXXXXXXXXXXX
-M---tt----------------#####--------g------------####--tt-----gg-------g--####------gXXXXXXXXXXX---XXXXXXXXXXXXXXXXXXXXXXXXXXXXXXXXXXXXXXXXXXXXX
XXXXXXXXXXXXXXXXXXXXXXXXXXXXXXXXXXXXXXXXXXXXXXXXXXXXXXXXXXXXXXXXXXXXXXXX--XXXXXXXXXXXXXXXXXXXXXX---XXXXXXXXXXXXXX-------------------------------
XXXXXXXXXXXXXXXXXXXXXXXXXXXXXXXXXXXXXXXXXXXXXXXXXXXXXXXXXXXXXXXXXXXXXXXX--XXXXXXXXXXX-----------------------------------------------------------
