--------------------------------------------------------------------------------------------------------------------------------------
--------------------------------------------------------------------------------------------------------------------------------------
--------------------------------------------------------------------------------------------------------------------------------------
--------------------------------------------------------------------------------------------------------------------------------------
--------------------------------------------------------------------------------------------------------------------------------------
--------------------------------------------------------------------------------------------------------------------------------------
---------------------------------------------------------------------------------------------------------S!!S-------------------------
--------------------------------------------------------------------------------------------------------------------------------------
------------------------------------------------------------------------------------tt------------------------------------------------
----------------------------------------------------#--------------------SS----#----tt------------------------------------------------
----tt----------------------------------------!----##-------------SS!S--------##----tt-------#--------------------#----!--------------
----tt-----tt-------SS!S------------1-------------###------------------------###--#####------##------------------##-------------------
----tt-----tt------------------------------------####------------------g-g--####--#####------###----------------###-------------------
g-g-tt-----tt-g----------------------------------tt-----gg-g---tt---g--XXXXX------#####------####--------------####-------tt----------
XXXXXXXXXXXXXXXXXXXXXXXXXXXXXXXXXXXXXXXXXXXXXXXXXXXXXXXXXXXXXXXXXXXXXXXXXXXXXXXXXX----------XXXXXXXXXXXXXXXXXXXXXXXXXXXXXXXXXXXXXXXXXX
XXXXXXXXXXXXXXXXXXXXXXXXXXXXXXXXXXXXXXXXXXXXXXXXXXXXXXXXXXXXXXXXXXXXXXXXXXXXXXXXXX----------XXXXXXXXXXXXXXXXXXXXXXXXXXXXXXXXXXXXXXXXXX
