--------------------------------------------------------------------------------------------------------------------------------------
--------------------------------------------------------------------------------------------------------------------------------------
--------------------------------------------------------------------------------------------------------------------------------------
--------------------------------------------------------------------------------------------------------------------------------------
--------------------------------------------------------------------------------------------------------------------------------------
--------------------------------------------------------------------------------------------------------------------------------------
---------------------------S!!-----------------------------------------------------------------------------##-------------------------
---------------------------------tt-----------------------------------------------------------------------###-------------------------
---------------------------------tt----------------------------------------------------------------------####--------##----#----------
------------#--------------------tt----------SS--------------tt-------------------#--------tt-----1-----#####-------###---##----------
------S!!S-##SSSS---------------------#####----------tt------tt-------------------##-------tt-----------#####------####--###----------
----------###-------------------------#####----------tt------tt----------------tt-###------tt---------------------#####-####----------
----------###-------------------------#####g-g-------tt-g------------------g---tt-####-------g-tt-----------------#####---t------#####
-M-------------------------------gg--------XXXXXXXXXXXXXXXXXXXXXXXXXXXXXXXXXXXXXXXXXXXXXXXXXXXXXXXXXXXXXXXXXXXX--XXXXXXXXXXXXXXXXXXXXX
XXXXXXXXXXXXXXXXXXXXXXXXXX---XXXXXXXXXXXXXXXXXXXXXXXXXXXXXXXXXXXXXXXXXXXXXXXXXXXXXXXXXXXXXXXXXXXXXXXXXXXXXXXXXX--XXXXXXXXXXXXXXXXXXXXX
XXXXXXXXXXXXXXXXXXXXXXXXXX---XXXXXXXXXXXXXXXXX----------------------------------------------------------------------------------------
