------------------------------------------------------------------------------------------------------------------------------------
------------------------------------------------------------------------------------------------------------------------------------
------------------------------------------------------------------------------------------------------------------------------------
------------------------------------------------------------------------------------------------------------------------------------
------------------------------------------------------------------------------------------------------------------------------------
---------------------------------------------------------------------------------------------------------------------#--------------
-----------------------------SSS!-----------------------------------------------------------------------------tt--------------------
--------------------------------------------------------------------------------------------------------------tt--------------------
--------------------------------------------------------------------------------------------------------#-----tt--------------------
------------------------------------------------SSS-----S@S!S-----------------S@S!S--------------SS!S--#######-----------tt---------
----#-----------#-----------t---C---------------------------------SU--------#-------------------------########-----------tt---------
----##----#####-------------t----------------------------------------------##------------------------#########-----------tt-g-------
----###---#####-------------t---------------------------g-----------------###--tt----------g----------------#####g---tt--####----gg-
-M--####--#####-------g----------g--k----XXXXXXXXXXXXXXXXXXXXXXXXXXXXXXXXXXXXXXXXXXXXXXXXXXXXXXXXXXXXXXXXXXXXXXXXXXXXXX--XXXXXXXXXXX
XXXXXXXXXXXXXXXXXXXXXXXXXXXXXXXXXXXXXXXXXXXXXXXXXXXXXXXXXXXXXXXXXXXXXXXXXXXXXXXXXXXXXXXXXXXXXXXXXXXXXXXXXXXXXXXXXXXXXXX--XXXXXXXXXXX
XXXXXXXXXXXXXXXXXXXXXXXXXXXXXXXXXXXXXXXXXXXXXX--------------------------------------------------------------------------------------
