----------------------------------------------------------------------------------------------------------------------------------------------
----------------------------------------------------------------------------------------------------------------------------------------------
----------------------------------------------------------------------------------------------------------------------------------------------
----------------------------------------------------------------------------------------------------------------------------------------------
----------------------------------------------------------------------------------------------------------------------------------------------
---------------------------------##-----------------------------------------------------------------------------------------------------------
--------------------------------###-----------------------------------------------------#-----------------------------------------------------
-------------------------------####-----------------------------------------------------##----------------------------------------------------
------------------------------#####-----1-----------------------------------------------###---------------------------------------------------
------------------------------#####-------------------------------------------------------------------------S!!S------------------------------
----tt---------------S@S!-------SS----------------------g-----------------------------S@S--------------------------------tt-#-----#------S!!S-
----tt--------------------------------#####-----------SSSSSSSS-----------------------------------------------------------tt-##---##-----------
----tt--------------------------------#####---------------------------#-----#----#-------------#-----#-------------------tt-###-###-----------
g-g-tt------------g--------gg-g-g-----####-----------g---------------##----##---#######-------##----##---#######-----g-g-tt-#######-----------
XXXXXXXXXXXXXXXXXXXXXXXXXXXXXXXXXXXXXXXXXXXXXXXXXXXXXXXXX-----------###---###--########------###---###--########-----------XXXXXXXXXXXXXXXXXXX
XXXXXXXXXXXXXXXXXXXXXXXXXXXXXXXXXXXXXXXXXXXXXXXXXXXXXXXXX----------####--####-#########-----####--####-#########-----------XXXXXXXXXXXXXXXXXXX
