--------------------------------------------------------------------------------------------------------------------------
------------------------------------------------------------------------------------------tt------------------------------
----------------------------------------------------------------------------------tt------tt------------------------------
----------------------------------------------------------------------------------tt------tt------------------------------
----------------------------------------------------------------------------------tt--------------------------------------
----------------------------------------------------------------------------------------S@S----------------SSS!-----------
-----------------------------------------------------SS!S-----------------------S-----------------------------------------
-----------------------------------##-------------------------------------------------------------------------------------
---------------SS!S---------------###-------------------------------------------------------------------------------------
---------------------------------####-----------------SS-----tt-----SS!S------SS------#--#------SU------------C---------!-
--------------------------SSSS--#####-----------S@S----------tt----------------------##--##-------------------------------
--------------#####-------------#####------------------------tt-g-------------------###--###------------------------------
------------tt--------------------------------------g-g---tt------g--g------g-g----#####-####---####-----------g--gg------
-M----g-g---tt------g----------------------k--------XXXXXXXXXXXXXXXXXXXXXXXXXXXXXXXXXXXXXXXXXX--XXXXXXXXXXXXXXXXXXXXXXXXXX
XXXXXXXXXXXXXXXXXXXXXXXXXXXXXXXXXXXXXXX--XXXXXXXXXXXXXXXXXXXXXXXXXXXXXXXXXXXXXXXXXXXXXXXXXXXXX--XXXXXXXXXXXXXXXXXXXXXXXXXX
XXXXXXXXXXXXXXXXXXXXXXXXXXXXXXXXXXXXXXX--XXXXXXXXXXXX---------------------------------------------------------------------
