--------------------------------------------------------------------####------------------------###------------------------SSSS
-------------------------------------------------------------------#####-----------------------####-------------tt-------------
------------------------------------------------------------------######------g-----------------------------g---tt----g---g----
-----------------------------------------------------------------##XXXXXXXXXXXX--XXXXXXXXXXXXXXXXXXXXXXXXXXXXXXXXXXXXXXXXXXXXX-
----------------------------------------------------------------###XXXXXXXXXXXX--XXXXXXXXXXXXXXXXXXXXXXXXXXXXXXXXXXXXXXXXXXXXX-
---------------------------------------------------------------####------------------------------------------------------------
-------------------------------------------------------------------------------------------------------------------------------
---------------------------------SS!S-------------------------S@S--------------------------------------------------------------
---------------------------------------------F---------------------------------------------------------------------------------
---------------------------------------------#--------tt-----------------------------------------------------------------------
------!----------------!-----------XXXXXXXXXXXX-------tt----!-#####------------------------------------------------------------
----------------------------S@S----XXXXXXXXXXXXSS!----tt------#####------------------------------------------------------------
--------------------------------------------------------------#####------F-----------------------------------------------------
-M--------------------------------------####---------------------#####---#-----------------------------------------------------
XXXXXXXXXXXXXXXXXXXXXXXXXXXXXXXXXXXXXXXXXXXXXXXXXXXXXXXXXXXXXXXXXXXXXXXXXXX----------------------------------------------------
XXXXXXXXXXXXXXXXXXXXXXXXXXXXXXXXXXXXXXXXXXXXXXXXXXXXXXXXXXXXXXXXXXXXXXXXXXX----------------------------------------------------
