--------------------------------------------------------------------------------------------------------------------------------------
--------------------------SSSS------------------------------------------------------------------------------SSSS----------------------
-------------------------S---------@----------------------------------------------------------------tt--------------------------------
----------------------------------------------------------------------------------------------------tt--------------------------------
-----------------------------------------------------------------------------------S@S!S------------tt----##--------------------------
-------------------------------------------S!!---tt-------------------------S!!S-------------------------###---------------g----------
---SSS!------------#####-----------!--!----------tt---------tt------------------------------------------####-------------SSSS---------
-------------------#####-------------------------tt---------tt----tt-----------------------------------#####--------------------------
-------------------#####------------------------------------tt-g--tt--------------g---------tt---------#####----gg------g-------------
--------------------XXXXXXXX---XXXXXXXXXXXXXXXXXXXXXXXXXXXXXXXXXXXXXXXXXXXXXXXXXXXXXXXXX--XXXXXXXX---XXXXXXXXXXXXXXX---XXXXXXXXXXXXXXX
------C--------S@S--XXXXXXXX---XXXXXXXXXXXXXXXXXXXXXXXXXXXXXXXXXXXXXXXXXXXXXXXXXXXXXXXXX--XXXXXXXX---XXXXXXXXXXXXXXX---XXXXXXXXXXXXXXX
--------------------------------------------------------------------------------------------------------------------------------------
--------------------------------------------------------------------------------------------------------------------------------------
-M-----g--k---------------------------------------------------------------------------------------------------------------------------
XXXXXXXXXXXXXXXXXXXX------------------------------------------------------------------------------------------------------------------
XXXXXXXXXXXXXXXXXXXX------------------------------------------------------------------------------------------------------------------
