--------------------------------#####------###tt------------------tt--------###---------------------------
--------------------------------#####-----####tt----tt--------g---tt--------####--g----------------XXXXXXX
----------------------------------------------XXXXXXXXXXXXXXXXXXXXXXXXXXX--XXXXXXXXXXXXXXX---XXXXXXXXXXXXX
--------------------------------S@S-----------XXXXXXXXXXXXXXXXXXXXXXXXXXX--XXXXXXXXXXXXXXX---XXXXXXXXX----
----------------------------------------------------------------------------------------------------------
---------------------------------------------##-----------------------------------------------------------
--------------@-----------------#####-------###-----------------------------------------------------------
--------------------------------#####------####-----------------------------------------------------------
-------SS!S---------------------#####-----#####-----------------------------------------------------------
-------------------------------g------------g##-----------------------------------------------------------
--------------!--!------------XXXXXXXXXXXXXXXXXXXXXX------------------------------------------------------
--#####-----------------------XXXXXXXXXXXXXXXXXXXXXX#-----------------------------------------------------
--#####-------------------------------####---------###------F---------------------------------------------
-M#####-----tt----------------------g--------tt---------g---#---------------------------------------------
XXXXXXXXXXXXXXXXXXXXXXXXXXXXXXXXXXXXXXXXXXXXXXXXXXXXXXXXXXXXXX--------------------------------------------
XXXXXXXXXXXXXXXXXXXXXXXXXXXXXXXXXXXXXXXXXXXXXXXXXXXXXXXXXXXXXX--------------------------------------------
