------------------------------------------------------------------------------------------------------------------------------------
------------------------------------------------------------------------------------------------------------------------------------
------------------------------------------------------------------------------------------------------------------------------------
------------------------------------------------@-----------------------------------------------------------------------------------
--------------------------------------------------------------------SSS!-----------------------------------------------tt-----------
-----------------------------------------------------------------------------------------------------------------------tt-----------
------------------------------------------------------------------------------------------------------g----------------tt-----------
------------------------------tt----------------!--!------------------------------------------------SSSS-----------g-g-tt-----------
------------------------------tt---------------------------------------C--------------#-----S@S!-----------------!-----------#------
------------------------------tt---#---------------------------#----------------------##-----------g------#------------------##-----
----#----SS!S-----------------SS--##--------------------tt-----##---------------------###-----------------##-----------------###----
----##---------------tt----------###----------S@S-------tt-----###------g---g---------####--tt------------###--------gg---k---------
----##---------------tt---------####--tt----------------tt-g-XXXXXXXXXXXXXXXXXXXXXXXXXXXXXXXXXXXXXXXXXXXXXXXXXXXXXXXXXXXXXXXXXXXXXXX
-M--####-------g-----tt-----g-g-------tt---------------------XXXXXXXXXXXXXXXXXXXXXXXXXXXXXXXXXXXXXXXXXXXXXXXXXXXXXXXXXXXXXXXXXXXXXXX
XXXXXXXXXXXXXXXXXXXXXXXXXXXXXXXXXXXXXXXXXXXXXXXXXXXXXX------------------------------------------------------------------------------
XXXXXXXXXXXXXXXXXXXXXXXXXXXXXXXXXXXXXXXXXXXXXXXXXXXXXXXXXXX-------------------------------------------------------------------------
