-----------------------------S!!SSSSS-------------------
--------------------------------------------------------
--------------------------------------------------------
--XXXXXXX------------#####------------------------------
--XXXXXXX--XXXXX--XXXXXXXXXXXXXX-------------#----------
-----------XXXXX--XXXXXXXXXXXXXXXXX---------##----------
------------------------------XXXXX--------###----------
------------------------------------------####----------
--------------------------------------------------------
----------------------------------------S@S---------#---
-----------#-----------SS!-------------------------##---
----------##-----------------tt-------------------###---
---------###-----------------tt------------------####---
-M------####------#####------tt---------------k---------
XXXX---XXXXXXXXXXXXXXXXXXXXXXXXXXXXXXXXXXXXXXXXXXXXXXXXX
XXXX---XXXXXXXXXXXXXXXXXXXXXXXXXXXXXXXXXXXXXXXXXXXXXXXXX
