-------------------------------------------------------------------------------------------------------------------------
-------------------------------------------------------------------------------------------------------------------------
-------------------------------------------------------------------------------------------------------------------------
-------------------------------------------------------------------------------------------------------------------------
-------------------------------------------------------------------------------------------------------------------------
-------------------------------------------S!!S--------------------------------------------------------------------------
-----------------------S!!S-------------------------------#-----------------------------------SS!------------------------
---------------------------------------------------------##-----------------------------------------##-------------------
--------------------------------------------------------###-------------1--------------------------###-------S!!S--------
----------------tt---------------#------------------#--####----!-------------------S@S!S----------####--------------#----
--------g-------tt--#######------##----1-----------#######---------------------------------------#####--------------##---
------SSSS------tt-########------##---------------########---------------------------------------#####--------------###--
------------g-g-tt####-----------##--------------#########-------------g--------g---------g-------------------------####-
-M---g------tt------g--------XXXXXXXXXXXXXXXXXXXXXXXXXXXXXXXXXXXXXXXXXXXXXXXX--XXXXXXXXXXXXXX---XXXXXXXXXXXXXXXXXXXXXXXXX
XXXXXXXXXXXXXXXXXXXXXXXXXXX--XXXXXXXXXXXXXXXXXXXXXXXXXXXXXXXXXXXXXXXXXXXXXXXX--XXXXXXXXXXXXXX---XXXXXXXXXXXXXXXXXXXXXXXXX
XXXXXXXXXXXXXXXXXXXXXXXXXXX----------------------------------------------------------------------------------------------
