------------------------------------------------------------------------------------------------------
------------------------------------------------------------------------------------------------------
------------------------------------------------------------------------------------------------------
--------------------------------------------------#----------------------------------------------1----
--------------------------------------------------##--------------------------------------------------
--------------------------------------------------###--------!S---------------------------------------
---SSS!--------@--------------------------------#####-----------------------------!-----------S---g---
----------------------------S!!S----------------#####---------------------1--------------------XXXXX--
------------------------------------------------#####------------------------------------------XXXXX--
---------------------------------------------------g----------------------------------------g-g-------
------C--------!--!--#----------------------S@S-XXXX--SSSSSS---XX-------------!--#----XXXXXXXXXXX-----
---------------------##----#####----------------XXXX-----------XX---S@S!S--------##---XXXXXXXXXXX-----
------------tt-------###---#####-------------------------------------------------###------------------
-M-----gg---tt-tt----####--#####-------g-----------gg-g--------------------------####-----------------
XXXXXXXXXXXXXXXXXXXXXXXXXXXXXXXXXXXXXXXXXXXXXXXXXXXXXXXXXXXXXXXXXXXXXXXXXXXXXXXXXXXXXX----------------
XXXXXXXXXXXXXXXXXXXXXXXXXXXXXXXXXXXXXXXXXXXXXXXXXXXXXXXXXXXXXXXXXXXXXXXXXXXXXXXXXXXXXX----------------
