----------------------------------------------------------------------------------------------------------------------------------------------------
----------------------------------------------------------------------------------------------------------------------------------------------------
----------------------------------------------------------------------------------------------------------------------------------------------------
----------------------------------------------------------------------------------------------------------------------------------------------------
----------------------------------------------------------------------------------------------------------------------------------------------------
----------------------------------------------------------------------------------------------------------------------------------------------------
--------------------------------------------------------------------------------------------------SSS!----------------------------------------------
--------------------------1--------------------------SS!S-------------------------------------------------------------------------------------------
----------------------------------------------------------------------------------------------------------------------------------------------------
---------------------------------------------------------------------------------------g----------------------------------S!!S------------S---------
----SS!S----#-------------------#---------------#####------------tt------------------SSSS------------C-----------------------------tt---------------
------------##----------S@S-----##--------------#####------------tt---------------------------1--------S@S!S-----------------------tt---------------
------------###-----------------###-------------#####------------tt-g---------------g-----------------------------tt---------------tt-g--------tt---
-M----#####-####-----------------g-------g-g---------------------tt----------------------g--------------------g---tt--------g---k-------XXXXXXXXXXXX
XXXXXXXXXXXXXXXXXXXXXXXXXXXXXXXXXXXXXXXXXXXXXXXXXXXXXXXXXXXXXXXXXXXXXXXXXXXXXX---XXXXXXXXXXXXXXXXXXXXXXXXXXXXXXXXXXXXXXXXXXXXXXXXXXXXXXXXXXXXXXXXXXX
XXXXXXXXXXXXXXXXXXXXXXXXXXXXXXXXXXXXXXXXXXXXXXXXXXXXXXXXXXXXXXXXXXXXXXXXXXXXXX---XXXXXXXXXXXXXXXXXXXXXXXXXXXXXXXXXXXXXXXXXXXXXXXXXXXXXXXXX----------
