---------------------------------------------------------------------------------------------------------------------------------------------
---------------------------------------------------------------------------------------------------------------------------------------------
---------------------------------------------------------------------------------------------------------------------------------------------
---------------------------------------------------------------------------------------------------------------------------------------------
---------------------------------------------------------------------------------------------------------------------------------------------
---------------------------------------------------------------------------------------------------------------------------------------------
---------------------g-----------------------------------------------------------------------------------------------------------------------
-------------------SSSS--------------S@S!S---------------------------------------------------------------------------------------------------
--------------------------------------------------------------------------------------------------#------------------------------------------
---------S@S!S----g------------------------------------------------------------------------------##------------------------------------------
-------------------------!-------------------------#####--------tt-------------#-------tt-------###-----tt-------SS!S------------------------
----------------S@S----------------S@S-------------#####--------tt----SS!S----##-------tt------####-----tt-----------------------------------
---------------------------------------------------#####--------tt-----------###-------tt------####-----tt-----------------------------------
-M-----------------------------------------------####------------##---------####---g-g-tt---------#-g-g-tt---------#####----------------tt---
XXXXXXXXXXXXXXXXXXXXXXXXXXXXXXXXXXXXXXXXXXXXXXX--XXXXXXXXXXXXXXXXXXXXXXXXXXXXXXXXXXXXXXXXXXXXXXXXXXXXXXXXXXXXXXXXXXXXXXXXXXXXXXXXXXX--XXXXXXX
XXXXXXXXXXXXXXXXXXXXXXXXXXXXXXXXXXXXXXXXXXXXXXX--XXXXXXXXXXXXXXXXXXXXXXXXXXXXXXXXXXXXXXXXXXXXXXXXXXXXXXXXXXXXXXXXXXXXXXXXXXXXXXXXXXX--XXXXXXX
