--------------------------------------------------------------------------------------------------
--------------------------------------------------------------------------------------------------
---------------------------S!!S---------------------------------##--------------------------------
-------------tt---------------------------------tt-------------###--------------------------------
-------------tt-------------------------tt------tt---tt-------####--#-------!---------------------
-------------tt-g-----------------------tt------tt---tt------#####--##--------------#-------------
-----------#####-------##---------------tt-g---------tt------#####--###-------------##------------
-----------#####------###----------##-#####-----------#####-g-------####------------###-----------
-----------#####-----####---------###-#####---XXXXXXXXXXXXXXXXXXXXXXXXXXXXXXXXXXXXXXXXXXXXXXXXXXXX
-------------------g--------gg---####-#####---XXXXXXXXXXXXXXXXXXXXXXXXXXXXXXXXXXXXXXXXXXXXXXXXXXXX
-------S@S--------XXXXXXXXXXXXX------XXXXXXX------------------------------------------------------
------------------XXXXXXXXXXXXXSS!S--XXXXXXXS!S---------------------------------------------------
-----------------###------------------------------------------------------------------------------
-M--------------####------------------------------------------------------------------------------
XXXXXXXXXXXXXXXXXXXXXXXXXXXXXXXXXXXXXXXXXXX---g---------------------------------------------------
XXXXXXXXXXXXXXXXXXXXXXXXXXXXXXXXXXXXXXXXXXXXXXXX--------------------------------------------------
