-------------------------------------------------------------------------------------------------------------------
-------------------------------------------------------------------------------------------------------------------
-------------------------------------------------------------------------------------------------#-----------------
------------------------------------------------------------------------------------------tt-----------------------
------------------------------------------------------------------------------------------tt-----------------------
------------------------------------------------------------------------------------------tt-g---------------------
------------------------------------------tt-----------------------------------------------------------------------
------------------------------------------tt--------------------------------------------S@S---------#--#-----------
------------------------------------------tt-------------------------------------------------------##--##----------
-----------g----------------##------t-g-g-tt-----------------------------SSSS---------------------###--###---------
---------SSSSSSSS----------###------tt#####-----#----SSSS-------------------------------#####----####--####--------
--------------------------####------tt#####-----##--------------------------------------#####-------F-XXXXXXXXXXXXX
--------g-------------#####-----g-g-tt#####-----###--------------------#####----------#######-------#-XXXXXXXXXXXXX
-M--------------------#####----------g----------####-----------tt---XXXXXXXXXXXXXXXXXXXXXXXXXXXXXXXXXX-------------
XXXXXXXXXXXXX---------#####-------XXXXXXXXXXXXXXXXXXXXXXXXXXXXXXXXXXXXXXXXXXXXXXXXXXXXXXXXXXXXXXXXXXXX-------------
XXXXXXXXXXXXX----XXXXX-------g--XXXXXXXXXXXXXXXXXXXXXXXXXXXXXXXXXXXXXXXXX------------------------------------------
