------------------------------------------------------------------------------------------------------g-----------#####-------g
-------------------------------------------------------------S!!S----------------------g-------------------g--tt---XXXXXXXXXXXX
----------------------------------------------------------------------XXXXXXXXXXXXXXXXXXXXXXXXXXXXXXXXXXXXXXXXXXXXXXXXXXXXXXXXX
--------------------------------------------------tt------------------XXXXXXXXXXXXXXXXXXXXXXXXXXXXXXXXXXXXXXXXXXXXX------------
--------------------------------------------------tt---------------------------------------------------------------------------
--------------------------------------------------tt-g-------------gg-g----k---------------------------------------------------
-------------------------------------------------------XXXXXXXXXXXXXXXXXXXXXXXXXXXXXX------------------------------------------
--------------------1---------------------------S@S----XXXXXXXXXXXXXXXXXXXXXXXXXXXXXX------------------------------------------
-------------------------------------------------------##----------------------------------------------------------------------
--------------------------------tt---------------------##----------------------------------------------------------------------
--------------------------------tt----------#####-----###----------------------------------------------------------------------
----------1-----------------1---tt----------#####-----###----------------------------------------------------------------------
--------------------------------------------#####-----###----------------------------------------------------------------------
-M------------------gg----------------------tt-----k---------------------------------------------------------------------------
XXXXXXXXXXXXXXXXXXXXXXXXXXXXXXXXXXXXXXXXXXXXXXXXXXXXXXXXXXXXX------------------------------------------------------------------
XXXXXXXXXXXXXXXXXXXXXXXXXXXXXXXXXXXXXXXXXXXXXXXXXXXXXXXXXXXXX------------------------------------------------------------------
