----------------------------------------------------------------------------------------------------------------------------------------------------------
----------------------------------------------------------------------------------------------------------------------------------------------------------
----------------------------------------------------------------------------------------------------------------------------------------------------------
----------------------------------------------------------------------------------------------------------------------------------------------------------
----------------------------------------------------------------------------------------------------------------------------------------------------------
----------------------------------------------------------------------------------------------------------------------------------------------------------
--------------------------------------------------------------------------------------------------------------SSS!----------------------------------------
----------------------------------------------------------------------------------------------------------------------------------------------------------
----------------------------------------------------------------------------------------------------------------------------------------------------------
-----------------------------------tt------------------------------------------------------------S@S!S----------------------------------------------------
-------------!----------------#----tt--------------S@S!S-----tt--------------------------------------------------C--------#-----1-------------------------
---------t--------#----------##----tt------------------------tt----------tt---------1------------------------------------##-------------------------------
---------t--------##--------###tt----------------------------tt----------tt---------------------------------------------###-------------------------------
-M-------t--------###------####tt-------------------#####----------------tt---------------------------------------g----####------#####--------------------
XXXXXXXXXXXXXXXXXXXXXXXXXXX----XXXXXXXXX--XXXXXXXXXXXXXXXXXXXXXXXXXXX--XXXXXXXXXXXXXXXXXXXXXXXXXXXXXXXXXXXXX--XXXXXXXXXXXXXXXXXXXXXXXXXXXXXXXXXXX--XXXXXXX
XXXXXXXXXXXXXXXXXXXXXXXXXXX----XXXXXXXXX--XXXXXXXXXXXXXXXXXXXXXXXXXXX--XXXXXXXXXXXXXXXXXXXXXXXXXXXXXXXXXXXXX--XXXXXXXXXXXXXXXXXXXXXXXXXXXXXXXXXXX--XXXXXXX
