---------------------------------------------------------------------------------------------------------------------
---------------------------------------------------------------------------------------------------------------------
--------------------------------------------------##-----------------------------------------------------------------
-------------------------------------------------###-----------------------------------------------------------------
------------------------------------------------####-----------------------------------------------------------------
-----------------------------------------------#####-----------------------------------------------------------------
-------------------------SSS!------------tt---######---------#--------------------SSSS-------------------------------
-----------------------------------------tt--##-------------##-#####-------------------------------------------------
-----------------------------------------------------------###-#####-------------------------#-----------------------
-------------------------------------g-g------------------####-#####---------S!!S-----------##-----------------------
-------1--------------------C-----------------------------SS----------!--------------------###-------tt------S@S!S---
--------------------tt--------------------S@S!S------SS!------#####-----------------S@S---####-------tt--------------
--------------------tt----------------------------------------#####----------------------------------tt--------------
-M--g---------------tt-g-----g--tt-----gg---------------g-g---#####------tt-------------------------------tt----tt---
XXXXXXXXXXXXXXXXXXXXXXXXXXXXXXXXXXXXXXXXXXXXXXXXXXXXXXXXXXXXXXXXXXXXXXXXXXXXXXXXXXXXXXXXXXXXXXX--XXXXXXXXXXXXXXXXXXXX
XXXXXXXXXXXXXXXXXXXXXXXXXXXXXXXXXXXXXXXXXXXXXXXXXXXXXXXXXXXXXXXXXXXXXXXXXXXXXXXXXXXXXXXXXXXXXXX--XXXXXXXXXXXXXXXXXXXX
