----------tt-----###------------------####----###------------------------------------------###-----#####----------------tt---
----------tt-g---####------g-------------g-------------g-------####------------------------####--tt------------------g-------
-----#####-------XXXXXXXXXXXXXXXXXXXXXXXXXXXXXXXXXXXXXXXXXXXX--XXXXXXXXXXXXXXXXXXXXXXXXXXXXXXXXXXXXXXXXXXXXXXXXXXXXXXXXXXXXX-
-----#####-------XXXXXXXXXXXXXXXXXXXXXXXXXXXXXXXXXXXXXXXXXXXX--XXXXXXXXXXXXXXXXXXXXXXXXXXXXXXXXXXXXXXXXXXXXXXXXXXXXXXXXXXXXX-
-----#####-------------------------------------------------------------------------------------------------------------------
-----------------------------------------------------------------------------------------------------------------------------
-----S@S---------------------------------------------------------------------------------------------------------------------
--------------S@S!S----------------------------------------------------------------------------------------------------------
-----------------------------------------------------------------------------------------------------------------------------
-#####-----------------------------------------------------------------------------------------------------------------------
-#####-----------------------------------------------------------------------------------------------------------------------
-#####------S@S--------------------------------------------------------------------------------------------------------------
--------------------------F--------------------------------------------------------------------------------------------------
-M------------------------#--------------------------------------------------------------------------------------------------
XXXXXXXX--XXXXXXXXXXXXXXXXXX-------------------------------------------------------------------------------------------------
XXXXXXXX--XXXXXXXXXXXXXXXXXX-------------------------------------------------------------------------------------------------
