---------------------------------------------------------------------------------------------------------------------------------
---------------------------------------------------------------------------------------------------------------------------------
---------------------------------------------------------------------------------------------------------------------------------
---------------------------------------------------------------------------------------------------------------------------------
---------------------------------------------------------------------------------------------------------------------------------
---------------------------------------------------------------------------S!!S-----------#--------------------------------------
-------------------------------SSS!-------------------------------------------------SS---##--------------#--------!--------------
----------------S@S!S---------------------------##---tt---------------------------------###--------------##----------------------
-----------------------------------------------###---tt--------------------------------####------tttt----###---------------------
----------------------------------------------####---tt-------#--------------#####g-g---tt---g---tttt----####--------------------
----#---------#####---------SS----C--------#-------#####------##-----S@S--XXXXXXXXXXXXXXXXXXXXXXXXXXXXX--XXXXXXXXXXXXXXXXXXXXXXXX
---##---------#####------------------------##------#####------###---------XXXXXXXXXXXXXXXXXXXXXXXXXXXXX--XXXXXXXXXXXXXXXXXXXXXXXX
--###---------#####---------------------tt-###-----#####------###-----------------------g--------tt------------------------------
-####-------####---g------g-g------gg---tt-####---k----------XXXXXXXXXXXXXXXXXXXXXXXXXXXXXXXXXXXXXXXXXXXXXXX---------------------
XXXXXXXXXX--XXXXXXXXXXXXXXXXXXXXXXXXXXXXXXXXXXXXXXXXXXXXXXXX-XXXXXXXXXXXXXXXXXXXXXXXXXXXXXXXXXXXXXXXXXXXXXXX---------------------
XXXXXXXXXX--XXXXXXXXXXXXXXXXXXXXXXXXXXXXXXXXXXXXXXXXXXXXXXXX---------------------------------------------------------------------
