-------------------------------------------------------------------------------------------------------#####------------
-------------------------------------------------------------------------------------------------------#####------------
------------------------------------------------------------------------------------------------------------------------
----------------------@----------------SS!S------------------------------------------------------------S@S--------------
------------------------------------------------------------------------------------------------------------------------
------------------------------------------------------------------------------------------------------------------------
---------------------------------------------------------------------------------------------------#####----------------
----------------------!--!------------S@S----------------------------------------------------------#####-----tt---------
---------------------------------------------------------------##-------1--------------------------#####-----tt---------
--------------------------------------------------------------###--------------------------------------------XXXXXX-----
-------------S!!S---#####-------------------------1----------####------------------------------S@S-------------------gg-
--------------------#####-----------------------------------#####---####-----------------------------XXXXX--XXXXXXXXXXXX
--------------------#####-----------------------------------#####---####--------------tt-------------XXXXX--XXXXXXXXXXXX
-M---tt------------g-------####---gg--------g--------gg-g---tt-----#####-------gg-g---tt--k-----------------------------
XXXXXXXXXXXXXXXXXXXXXXXXXXXXXXXXXXXXXX---XXXXXXXXXXXXXXXXXXXXXXXXXXXXXXXXXXXXXXXXXXXXXXXXXXXXXXXXXXX--------------------
XXXXXXXXXXXXXXXXXXXXXXXXXXXXXXXXXXXXXX---XXXXXXXXXXXXXXXXXXXXXXXXXXXXXXXXXXXXXXXXXXXXXXXXXXXXXXXXXXX--------------------
