------------------------------------------------------------------------------------------------------------------------------------------
------------------------------------------------------------------------------------------------------------------------------------------
------------------------------------------------------------------------------------------------------------------------------------------
------------------------------------------------------------------------------------------------------------------------------------------
------------------------------------------------------------------------------------------------------------------------------------------
------------------------------------------------------------------------------------------------------------------------------------------
------------------------------------------------------------------------------------------------------------------------------------------
------------------SS!----1-------------------------------------------------------------------------------------------------S!!S-----------
------------------------------------------------------------------------------------------------------------------------------------------
-----------------------------------g----------------------------------------------------------------------#-------------------------------
----------SS!S-------------------SSSS-------1-----------1-----#-----------SS!S---SSSS--------------------##-----tt------------------------
--------------------------------------------------------------##----------------------------------------###-----tt---#####----------------
--------------------------------g------------------#----------###--------------------------------------####-----tt---#####-----tt---------
-M-----------------gg--------g--------tt---------g-tt---------####------------------------------------------g-g-tt---####---g--tt---------
XXXXXXXXXXXXXXXXXXXXXXX---XXXXXXXXXXXXXXXXXXXXXXXXXXXXXXXXXXXXXXXXXXXXXXXXXXXXXXXXXXXXXXXXXXXX---XXXXXXXXXXXXXXXXXXXXXXXXXXXXX-XXXXXXXXXXX
XXXXXXXXXXXXXXXXXXXXXXX---XXXXXXXXXXXXXXXXXXXXXXXXXXXXXXXXXXXXXXXXXXXXXXXXXXXXXXXXXXXXXXXXXXXX---XXXXXXXXXXXXXXXXXXXXXXXXXXXXX-XXXXXXXXXXX
