----------------------------####------------------#------------------------------------------------------------------------
---------------------------#####-----------tt-----##-----------------------------------------------------------------------
--------------------------######-----------tt-----###----------------------------------------------------------------------
-------------------------##-------g--------tt-g---SS--#--------1---------------------#-------!------------------------#----
------------------------###-XXXXXXXXXXXX--XXXXXX------##-----------------------------##---------------S@S---------#---##---
-----------------------####-XXXXXXXXXXXX--XXXXXX------###-----------#-------------tt-###-------------------------##---###--
------------------------------------------------g-g---####--tt----####--------g---tt-####-----------------------###---####-
----------------------S@S-----------------------XXXXXXXXXXXXXXXXXXXXXXXXXXXXXXXXXXXXXXXXXXXXXXXXXXXXXXXXXXXXX--####-XXXXXXX
------------------------------------------------XXXXXXXXXXXXXXXXXXXXXXXXXXXXXXXXXXXXXXXXXXXXXXXXXXXXXXXXXXXXXXXXXXXXXXXXXXX
---------------------------------------------------------------------------------------------------------------------------
----#----------#-----------------------------------------------------------------------------------------------------------
----##---------#--------------------------SU-------------------------------------------------------------------------------
----###--------#----tt---------------tt----------F-------------------------------------------------------------------------
-M--####--------g---tt--gg-------g---tt----------#-------------------------------------------------------------------------
XXXXXXXXXXXXXXXXXXXXXXXXXXXX---XXXXXXXXXXXXXXXXXXXX------------------------------------------------------------------------
XXXXXXXXXXXXXXXXXXXXXXXXXXXX---XXXXXXXXXXXXXXXXXXXX------------------------------------------------------------------------
