-----------------------------------------------------------------------------------------------------------------------------------
-----------------------------------------------------------------------------------------------------------------------------------
-----------------------------------------------------------------------------------------------------------------------------------
---------------------------------------------------------------------#####---------------------------------------------------------
---------------------------------------------------------------------#####--------F------------------------------------------------
---------------------------------------------------------------------#####--------#------------------------------------------------
-----------------------------------SSS!-----------------------------k----------XXXXX-----------------------------------------------
-----------------------------------------------------------------SXXXXXXXXXXXX-XXXX------------------------------------------------
------------------------------------------------------------------XXXXXXXXXXXX-----------------------------------------------------
-----------------------------------------------------------------------------------------------------------------------------#-----
-------------------------1------------C--------------SS!S---#----#####-------------------g----tt---------SS----!------tt-----##----
--------------##----------------------------1---------------##---#####--------SS!S-----SSSS---tt----------------------tt-----###---
-------------###--------------------------------------------###--#####------------------------tt-g--------------------tt-g---------
-M---###----####---------tt-----gg-----g--------------------####----g--tt-------------g----------------g-g---------k---------------
XXX--XXXXXXXXXXXXXXXXXXXXXXXXXXXXXXXXXXXXXXXXXXXXXXXXXXXXXXXXXXXXXXXXXXXXXXXXXXXXXXXXXXXXXXXXXXXXXXXXXXXXXXXXXXXXXXXXXXXXXXXX------
XXX--XXXXXXXXXXXXXXXXXXXXXXXXXXXXXXXXXXXXXXXXXXXXXXXXXXXXXXXXXXXXXXXXXXXXXXXXXXXXXXXXXXXXXXXXXXXXXXXXXXXXXXXXXXXXXXXXXXXXXXXX------
