----------------------------------------------------------------------------------------------------------------------------------------------------------------------------------------------------------
----------------------------------------------------------------------------------------------------------------------------------------------------------------------------------------------------------
----------------------------------------------------------------------------------------------------------------------------------------------------------------------------------------------------------
----------------------------------------------------------------------------------------------------------------------------------------------------------------------------------------------------------
----------------------------------------------------------------------------------------------------------------------------------------------------------------------------------------------------------
----------------------------------------------------------------------------------------------------------------------------------------------------------------------------------------------------------
-------------------------------------------------------SSS-----------------------------------------------SSS----------------------------------------------------------------------------------------------
----------------------------------------------------------------------------------------###-----------------------------------------------------------------###-------------------------------------------
------------------------------------------------------g--------------------------------####-------------g--------------------------------------------------####-------------------------------------------
--------------------------------------------------------------------------------------#####---------------------------------------------------------------#####----------SSS------------------------------
-------------------------U----!---------------S@S!S--@S-----SS------#--#-------------######------------@S-----SS------#--#---------------SS---#----------######--------------------------------C----------
----------#-----------------------------#--------------------------##--##-----------#######--------------------------##--##-------------------##---------######---------------------#---------------------
------tt-##-------tt----------------tt-##-------------------------###--###------tt-########-------------------------###--###------------------###--------######-----------------tt-##---------------------
-M----tt###-------tt----------k-----tt###-------t---------g-g----####--####-----tt#########-----------------g-g----####--####----------g-g----####---g-g-######-------g---------tt###-----------g-g---g-g-
XXXXXXXXXXXXXXXXXXXXXXXXXXXXXXXXXXXXXXXXXXXXXXXXXXXXXXXXXXXXXXXXXXXXXXXXXXXXXXXXXXXXXXXXXXXXXXXXXXXXXXXXXXXXXXXXXXXXXXXXXXXXXXXXXX---XXXXXXXXXXXXXXXXXXXXXXXXXXXXXXXXXXXXXXXXXXXXXXXXXXXXXXXXXXXXXXXXXXXXX
XXXXXXXXXXXXXXXXXXXXXXXXXXXXXXXXXXXXXXXXXXXXXXXXXXXXXXXXXXXXXXXXX------XXXXXXXXXXXXXXXXXXXXXXXXXXXXXXXXXXXXXXXXXXXX------XXXXXXXXX---XXXXXXXXXXXXXXXXXXXXXXXXXXXXXXXXXXXXXXXXXXXXXXXXXXXXXXXXXXXXXXXXXXXXX
