----------------------------------------------------------------------------------------------------------------------------------------------------------------------------------------------------------
----------------------------------------------------------------------------------------------------------------------------------------------------------------------------------------------------------
----------------------------------------------------------------------------------------------------------------------------------------------------------------------------------------------------------
----------------------------------------------------------------------------------------------------------------------------------------------------------------------------------------------------------
----------------------------------------------------------------------------------------------------------------------------------------------------------------------------------------------------------
----------------------------------------------------------------------------------------------------------------------------------------------------------------------------------------------------------
----------SSS---------------------------------------------------------------------------------------------------------------------------------------------------------------------------------------------
-------------------------------------------------------------------------------------------###------------------------------------------------------------------------------------------------------------
---------g--------------------------------------------------------------------------------####------------------------------------------------------------------------------------------------------------
-----------------------------------------------------------------------------------------#####-------------------------------SSS--------------------------------------------------------------------------
--------@S----------------!--!----------------------------------------------------------######------------------C------------------------C-----SS!S---------SS------#--#---------------------C-----!--!---
---------------------------------------------------------------------------#------------######---------------------------------------------------------------------##--##---------------------------------
-----------------------------------------------------------------------tt-##------------######--------------------------------------------------------------------###--###----------tt--------------------
-M-------------------------------g-g--------g----t-g-g-----------------tt###--------g-g-######-------------------g-g--------k--g----------g-g--------t----g-g----####--####--g------tt--------g-g---------
XXXXXXXXXXXXXXXX---XXXXXXXXXXXXXXXXXXXXXXXXXXXXXXXXXXXXXXXXXXXXXXXXXXXXXXXXXXXXXXXXXXXXXXXXXXXXXXXXXXXXX---XXXXXXXXXXXXXXXXXXXXXXXXXXXXXXXXXXXXXXXXXXXXXXXXXXXXXXXXXXXXXXXXXXXXXXXXXXXXXXXXXXXXXXXXXXXXXXX
XXXXXXXXXXXXXXXX---XXXXXXXXXXXXXXXXXXXXXXXXXXXXXXXXXXXXXXXXXXXXXXXXXXXXXXXXXXXXXXXXXXXXXXXXXXXXXXXXXXXXX---XXXXXXXXXXXXXXXXXXXXXXXXXXXXXXXXXXXXXXXXXXXXXXXXXXXXXX------XXXXXXXXXXXXXXXXXXXXXXXXXXXXXXXXXXX
