----------------------------------------------------------------------------------------------------------------------------------------------------------------------------------------------------------
----------------------------------------------------------------------------------------------------------------------------------------------------------------------------------------------------------
----------------------------------------------------------------------------------------------------------------------------------------------------------------------------------------------------------
----------------------------------------------------------------------------------------------------------------------------------------------------------------------------------------------------------
----------------------------------------------------------------------------------------------------------------------------------------------------------------------------------------------------------
----------------------------------------------------------------------------------------------------------------------------------------------------------------------------------------------------------
------------------------------------------SSS--------------------------------------------------------------------------------------------------------SSS--------------------------------------------------
-----------------------------------------------------------------------------------###------------------###------------------------------###--------------------------------------------------------------
-----------------------------------------g----------------------------------------####-----------------####-----------------------------####--------g-----------------------------------------------------
---------------------------------------------------------------------------------#####----------------#####----------------------------#####--------------------------------------------------------------
-----SS------#--#-----------------------@S----S@S!---------C----------##--------######---------------######---------------------------######-------@S--------t-----!--!-------##------------------S-------
------------##--##---------------------------------------------------###-------#######--------------#######--------------------------#######-----------------t---------------###-------#-----------------#
-----------###--###---tt--------------------------------------------####---tt-########----------tt-########----------------------tt-########-----------------t--------------####---tt-##----------------##
-M-g-g----####--####--tt-----g-g-------------t--------------g-g----#####---tt#########----------tt#########--------g-g-----------tt#########------------g----t-------------#####---tt###---------------###
XXXXXXXXXXXXXXXXXXXXXXXXXXXXXXXXXXXXXXXXXXXXXXXXXXXXXXXXXXXXXXXXXXXXXXXXXXXXXXXXXXXXXXXXXXXXXXXXXXXXXXXXXXXXXXXXXXXXXXXXXXXXXXXXXXXXXXXXXXXXXXXXXXXXXXXXXXXXXXXXXXXXXXXXXXXXXXXXXXXXXXXXXXXXXXXXXXXXXXXXXX
XXXXXXXXXX------XXXXXXXXXXXXXXXXXXXXXXXXXXXXXXXXXXXXXXXXXXXXXXXXXXXXXXXXXXXXXXXXXXXXXXXXXXXXXXXXXXXXXXXXXXXXXXXXXXXXXXXXXXXXXXXXXXXXXXXXXXXXXXXXXXXXXXXXXXXXXXXXXXXXXXXXXXXXXXXXXXXXXXXXXXXXXXXXXXXXXXXXXX
