--------------------------------------------------------------------------------------------------------------------------------------------------------------------------------------------
--------------------------------------------------------------------------------------------------------------------------------------------------------------------------------------------
--------------------------------------------------------------------------------------------------------------------------------------------------------------------------------------------
--------------------------------------------------------------------------------------------------------------------------------------------------------------------------------------------
--------------------------------------------------------------------------------------------------------------------------------------------------------------------------------------------
--------------------------------------------------------------------------------------------------------------------------------------------------------------------------------------------
-----------------SSS------------------------------------------------------------------------------------------------------------------------------------------------------------------------
----------------------------------------------------------------------------------------------------------------------###-------------------------------------------------------------------
----------------g----------------------------------------------------------------------------------------------------####-------------------------------------------------------------------
-------------------------------------------------------SSS----------------------------------------------------------#####---------SSS-----------------SSS-----------------------------------
------SS!S-----@S---------S@S!S-----tt-------------#-------------------C--------S-------------##--------S----------######----------------------------------------------------------S--------
------------------------------------tt------------##-----------------------------------------###------------------#######-------------------------------------------------------------------
------------------------------------tt-----------###-------------------------------tt-------####--------------tt-########-------------------------------------------------tt----------------
-M-----tt-t---------------k--t----g-------------#####------k------------g-g--------tt------#####t-------------tt#########-------------k-------------------k---------------tt-------------gg-
XXXXXXXXXXXXXXXXXXXXXXXXXXXXXXXXXXXXXXXXXXXXXXXXXXXXXXXXXXXXXXXXXXXXXXXXXXXXXXXXXXXXXXXXXXXXXXXXXXXXXXXXXXXXXXXXXXXXXXXXXXXXXXXXXXXXXXXXXXXXXXXXXXXXXXXXXXXXXXXX---XXXXXXXXXXXXXXXXXXXXXXXXX
XXXXXXXXXXXXXXXXXXXXXXXXXXXXXXXXXXXXXXXXXXXXXXXXXXXXXXXXXXXXXXXXXXXXXXXXXXXXXXXXXXXXXXXXXXXXXXXXXXXXXXXXXXXXXXXXXXXXXXXXXXXXXXXXXXXXXXXXXXXXXXXXXXXXXXXXXXXXXXXX---XXXXXXXXXXXXXXXXXXXXXXXXX
