----------------------------------------------------------------------------------------------------------------------------------------------------------------------------------------------------------
----------------------------------------------------------------------------------------------------------------------------------------------------------------------------------------------------------
----------------------------------------------------------------------------------------------------------------------------------------------------------------------------------------------------------
----------------------------------------------------------------------------------------------------------------------------------------------------------------------------------------------------------
----------------------------------------------------------------------------------------------------------------------------------------------------------------------------------------------------------
----------------------------------------------------------------------------------------------------------------------------------------------------------------------------------------------------------
--------------SSS----------------------------------------SSS----------------------------------------------------------------------------------------------------------------------------------------------
----------------------------------------------------------------------------------------------------------------------------------------------------------------------------------------------------------
-------------g------------------------------------------g-------------------------------------------------------------------------------------------------------------------------------------------------
--------------------------------------------SSS-----------------------------------------------------------------------------------------------------------------------------------------------------------
-------tt---@S----U----!-----------C-----------------##@S--------##-----t----------------------------------------S------tt-------------------------SS---#-------SS------#--#--------S---------------------
-------tt-------------------------------------------###---------###-----t---------------------#-------------------------tt------------------------------##-------------##--##-----------------#-----------
-------tt------------------------------------------####--------####-----t-----------------tt-##-------------------------tt------------------------------###-----------###--###------------tt-##-----------
-M-------k-------------k------------g-g--g--------#####-------#####-----------------gg----tt###---------------------------k-----------g-g--------g-g----####--g-g----####--####-----------tt###-------g---
XXXXXXXXXXXXXXXXXXXXXXXXXXXXXXXXXXXXXXXXXXXXXXXXXXXXXXXXXXXXXXXXXXXXXXXXXXXX---XXXXXXXXXXXXXXXXXXXXXXXXXX---XXXXXXXXXXXXXXXXXXXX---XXXXXXXXXXXXXXXXXXXXXXXXXXXXXXXXXXXXXXXXXXXXXXXXXXXXXXXXXXXXXXXXXXXXXXX
XXXXXXXXXXXXXXXXXXXXXXXXXXXXXXXXXXXXXXXXXXXXXXXXXXXXXXXXXXXXXXXXXXXXXXXXXXXX---XXXXXXXXXXXXXXXXXXXXXXXXXX---XXXXXXXXXXXXXXXXXXXX---XXXXXXXXXXXXXXXXXXXXXXXXXXXXXXXXXX------XXXXXXXXXXXXXXXXXXXXXXXXXXXXXXX
