---------------------------------------------------------------------------------------------------------------------------------------------------------------------------------------------------
---------------------------------------------------------------------------------------------------------------------------------------------------------------------------------------------------
---------------------------------------------------------------------------------------------------------------------------------------------------------------------------------------------------
---------------------------------------------------------------------------------------------------------------------------------------------------------------------------------------------------
---------------------------------------------------------------------------------------------------------------------------------------------------------------------------------------------------
---------------------------------------------------------------------------------------------------------------------------------------------------------------------------------------------------
----------------------------------------------SSS--------------------------------------------------------------------------------------------------------------------SSS---------------------------
------------------------------------------------------------###------------------------------------------------------------------------------------------------------------------------------------
---------------------------------------------g-------------####-----------------------------------------------------------------------------------------------------g------------------------------
----------------------------------------------------------#####----------------------------------SSS-------------------------------------------SSS-------------------------------------------------
--------##-----------------SS------#--#-----@S-----------######---------SS---#-----SS!S-----S-------------------##------tt--------C--------------------------------@S------------------------------
-------###-------#----------------##--##----------------#######--------------##-------------------------tt-----###------tt---------------------------------#---------------------------------------
------####---tt-##---------------###--###-----------tt-########--------------###------------------------tt----####------tt-----------------------------tt-##---------------------------------------
-M---#####---tt###-------g-g----####--####----------tt#########-------g-g----####--g----t------t--------tt---#####---gg-g----------g-g--------g----t---tt###---------------------------------------
XXXXXXXXXXXXXXXXXXXXXXXXXXXXXXXXXXXXXXXXXXXXXXXXXXXXXXXXXXXXXXXXXXXXXXXXXXXXXXXXXXXXXXXXXXXXXXXXXXXXXXXXXXXXXXXXXXXXXXXXXXXXXXXXXXXXXXXXXXXXXXXXXXXXXXXXXXXXXXXXXXXXXXXXXXXXXXXXXXXXXXXXXXXXXXXXXXX
XXXXXXXXXXXXXXXXXXXXXXXXXXXXXXXX------XXXXXXXXXXXXXXXXXXXXXXXXXXXXXXXXXXXXXXXXXXXXXXXXXXXXXXXXXXXXXXXXXXXXXXXXXXXXXXXXXXXXXXXXXXXXXXXXXXXXXXXXXXXXXXXXXXXXXXXXXXXXXXXXXXXXXXXXXXXXXXXXXXXXXXXXXXXXX
