---------------------------------------------------------------------------------------------------------------------------------------------------------------------------------------------
---------------------------------------------------------------------------------------------------------------------------------------------------------------------------------------------
---------------------------------------------------------------------------------------------------------------------------------------------------------------------------------------------
---------------------------------------------------------------------------------------------------------------------------------------------------------------------------------------------
---------------------------------------------------------------------------------------------------------------------------------------------------------------------------------------------
---------------------------------------------------------------------------------------------------------------------------------------------------------------------------------------------
----------------SSS------------------------SSS--------------SSS----------------SSS--------SSS---------------------------------------------------------------------------------------------SSS
--------------------------------------------------------------------------------------------------------------------------S@S!S--------------------------------------------------------------
---------------g--------------------------g-----------------------------------g----------g-----------------------------------------------------------------------------------------------g---
-----SSS-------------------------------------------------------------------------------------------------------------------------------------------------------------------------------------
--------------@S------C-----!--!---------@S---!--!------------S-----------S--@S---!--!--@S--------------------##---C-----------------!--!----SS------#--#----------S@S!S-----SS---#-----@S---
--------------------------------------tt----------------tt---------------------------------------tt----------###------------------------------------##--##------------------------##---------
--------------------------------------tt----------------tt---------------------------------------tt---------####---------------tt------------------###--###-----------------------###--------
-M-t---g---------------g-g------------tt----------------tt---------------------------------------tt--------#####----g-g-----gg-tt----------g-g----####--####--g----tg------g-g----####-------
XXXXXXXXXXXXXXXXXXXXXXXXXXXXXXXXXXXXXXXXXXXXXXXXXXXXXXXXXXXXXXXXXXXXXXXXXXXXXXXXXXXXXXXXXXXXXXXXXXXXXXXXXXXXXXXXXXXXXXXXXXXXXXXXXXXXXXXXXXXXXXXXXXXXXXXXXXXXXXXXXXXXXXXXXXXXXXXXXXXXXXXXXXXXX
XXXXXXXXXXXXXXXXXXXXXXXXXXXXXXXXXXXXXXXXXXXXXXXXXXXXXXXXXXXXXXXXXXXXXXXXXXXXXXXXXXXXXXXXXXXXXXXXXXXXXXXXXXXXXXXXXXXXXXXXXXXXXXXXXXXXXXXXXXXXXXXXXX------XXXXXXXXXXXXXXXXXXXXXXXXXXXXXXXXXXXXX
