-------------------------------------------------------------------------------------------------------------------------------------------------------------------------------------
-------------------------------------------------------------------------------------------------------------------------------------------------------------------------------------
-------------------------------------------------------------------------------------------------------------------------------------------------------------------------------------
-------------------------------------------------------------------------------------------------------------------------------------------------------------------------------------
-------------------------------------------------------------------------------------------------------------------------------------------------------------------------------------
-------------------------------------------------------------------------------------------------------------------------------------------------------------------------------------
-------------------------------------------------------------------------------------------------------------------------------------------------------------------------------------
------------tt----------------------------------------------------------------------------------------------------###------------------------------------------------tt--------------
------------tt---------------------------------------------------------------------------------------------------####------------------------------------------------tt--------------
------------tt--------------------------------------------------------------------------------------------------#####----------------------SSS-----------------------tt--------------
---------------------------SS!S----------------------t---S--SS!S----------------------------------##-----------######----------------------------------------------------------------
-------tt--------------#-----------------------------t-------------------------------------------###-----------######-----------tt---------------------------------------------------
-------tt----------tt-##-----------------------------t------------------------------------------####-----------######-----------tt---------------------------------------------tt----
-M-----tt----gg----tt###-------t-------------gg------------------------------------------------#####g----t-g-g-######-----------tt------g---------------g-g-----------gg-------tt----
XXXXXXXXXXXXXXXXXXXXXXXXXXXXXXXXXXXXXXXXXXXXXXXXXXXXXXXXXXXXXXXXXXXXX---XXXXXXXXXXXXXXXX---XXXXXXXXXXXXXXXXXXXXXXXXXXXXXXXXXXXXXXXXXXXXXXXXXXXXXXX---XXXXXXXXXXXXXXXXXXXXXXXXXXXXXXXX
XXXXXXXXXXXXXXXXXXXXXXXXXXXXXXXXXXXXXXXXXXXXXXXXXXXXXXXXXXXXXXXXXXXXX---XXXXXXXXXXXXXXXX---XXXXXXXXXXXXXXXXXXXXXXXXXXXXXXXXXXXXXXXXXXXXXXXXXXXXXXX---XXXXXXXXXXXXXXXXXXXXXXXXXXXXXXXX
