----------------------------------------------------------------------------------------------------------------------------------------------------------------------------------------------------------
----------------------------------------------------------------------------------------------------------------------------------------------------------------------------------------------------------
----------------------------------------------------------------------------------------------------------------------------------------------------------------------------------------------------------
----------------------------------------------------------------------------------------------------------------------------------------------------------------------------------------------------------
----------------------------------------------------------------------------------------------------------------------------------------------------------------------------------------------------------
----------------------------------------------------------------------------------------------------------------------------------------------------------------------------------------------------------
--------------------------------------------------SSS--------------------------------SSS----------------------------------------SSS-----------------------------------------------------------------------
-------------------------------------------------------------------------###-------------------------------------------------------------------------------------------------###--------------------------
-------------------------------------------------g----------------------####--------g------------------------------------------g--------------------------------------------####--------------------------
-----------------------------------------------------------------------#####------------------------------------------------------------------------------SSS--------------#####--------------------------
--------tt--------tt-----------------SS---#-----@S------C-------------######-------@S------S-------##---------S--!--!---------@S--------##-----------##-------------------######----------C--------S------
--------tt--------tt----------------------##-------------------------#######----------------------###----------------------tt----------###----------###------------------#######--------------------------
--------tt--------tt----------------------###--------------------tt-########---------------------####tt--------------------tt---------####---------####--------------tt-########--------------------------
-M-------t----------k---g-g--------g-g----####-----------g-g-----tt#########--------------------#####tt--------------------tt--------#####--------#####------t-------tt#########-----------g-g--------t---
XXXXXXXXXXXXXXXXXXXXXXXXXXXXXXXXXXXXXXXXXXXXXXXXXXXXXXXXXXXXXXXXXXXXXXXXXXXXXXXXXXXXXXXXXXXXXXXXXXXXXXXXXXXXXXXXXXXXXXXXXXXXXXXXXXXXXXXXXXXXXXXXXXXXXXXXXXXXXXXXXXXXXXXXXXXXXXXXXXXXXXXXXXXXXXXXXXXXXXXXXX
XXXXXXXXXXXXXXXXXXXXXXXXXXXXXXXXXXXXXXXXXXXXXXXXXXXXXXXXXXXXXXXXXXXXXXXXXXXXXXXXXXXXXXXXXXXXXXXXXXXXXXXXXXXXXXXXXXXXXXXXXXXXXXXXXXXXXXXXXXXXXXXXXXXXXXXXXXXXXXXXXXXXXXXXXXXXXXXXXXXXXXXXXXXXXXXXXXXXXXXXXX
