----------------------------------------------------------------------------------------------------------------------------------------------------------------------------------------------
----------------------------------------------------------------------------------------------------------------------------------------------------------------------------------------------
----------------------------------------------------------------------------------------------------------------------------------------------------------------------------------------------
----------------------------------------------------------------------------------------------------------------------------------------------------------------------------------------------
----------------------------------------------------------------------------------------------------------------------------------------------------------------------------------------------
----------------------------------------------------------------------------------------------------------------------------------------------------------------------------------------------
---------------------------------------------------------------------------SSS----------------------------------------------------------------------------------------------------------------
----------------------------------###---------------------------------------------------------SS!S------------------------------------------tt------------------------###---------------------
---------------------------------####-------------------------------------------------------------------------------------------------------tt-----------------------####---------------------
-SSS----------------------------#####-------------------------------------------------------------------------------------------------SS----tt----------------------#####---------------------
-------------------------------######----------S----SS------#--#----------------------------------------C----------------------------------------------------------######----------tt---------
--------------------tt--------#######----------------------##--##----------------------------------------------------------#--------------------------------------#######----------tt---------
--------------------tt----tt-########---------------------###--###-----------------------tt----------------------------tt-##-------------------------tt-------tt-########----------tt---------
-M-g----------------tt----tt#########-------------g-g----####--####-----------gg---------tt-------gg-----g-g-----------tt###-------g---------gg-t----tt-------tt#########---------------------
XXXXXXXXXXXXXXXXXXXXXXXXXXXXXXXXXXXXXXXXXXXXXXXXXXXXXXXXXXXXXXXXXXXXXXXXXXXXXXXXXXXX---XXXXXXXXXXXXXXXXXXXXXXXXXXXXXXXXXXXXXXXXXXXXXXXXXXXXXXXXXXXXXXXXXXXXXXXXXXXXXXXXXXXXXXXXXXXXXXXXXX---XX
XXXXXXXXXXXXXXXXXXXXXXXXXXXXXXXXXXXXXXXXXXXXXXXXXXXXXXXXX------XXXXXXXXXXXXXXXXXXXXX---XXXXXXXXXXXXXXXXXXXXXXXXXXXXXXXXXXXXXXXXXXXXXXXXXXXXXXXXXXXXXXXXXXXXXXXXXXXXXXXXXXXXXXXXXXXXXXXXXX---XX
