--------------------------------------------------------------------------------------------------------------------------------------------------------------------------------------------------------
--------------------------------------------------------------------------------------------------------------------------------------------------------------------------------------------------------
--------------------------------------------------------------------------------------------------------------------------------------------------------------------------------------------------------
--------------------------------------------------------------------------------------------------------------------------------------------------------------------------------------------------------
--------------------------------------------------------------------------------------------------------------------------------------------------------------------------------------------------------
--------------------------------------------------------------------------------------------------------------------------------------------------------------------------------------------------------
--------------------------------------------------------------------------------------------------------------------------------------------------------------------------------------------------------
------------------U----!-----------------------------------------------###------------------------------------------------------------------------------------------------------------------------------
----------------------------------------------------------------------####------------------------------------------------------------------------------------------------------------------------------
---------------------------------------------------------------------#####------------------------------------------------------------------------------------------------------------------------------
-----------S@S!S------------------------------S@S!S----##-----------######-------------------------------------------------------------------------S@S---C----------##-----------------------------SS---
------------------------------------------------------###-----------######--------------------#-----------tt-------------------------------------------------------###------------------tt--------------
---------------------------------------tt------------####-----------######-------tt-------tt-##-----------tt------------------------------------------------------####------------------tt--------------
-M-------k--g---------gg---------g----ttt----t------#####g----t-g-g-######-------tt-------tt###-----------tt--g-g----------------------------------k------g-g----#####------------------tt-------g-g----
XXXXXXXXXXXXXXXXXXXXXXXXXXXX---XXXXXXXXXXXXXXXXXXXXXXXXXXXXXXXXXXXXXXXXXXXXXXXXXXXXXXXXXXXXXXXXXXXXXXXXXXXXXXXXXXXXXXXXXXXXXXXXXXX---XXXXXXXXXXXXXXXXXXXXXXXXXXXXXXXXXXXX---XXXXXXXXXXXXXXXXXXXXXXXXXXXX
XXXXXXXXXXXXXXXXXXXXXXXXXXXX---XXXXXXXXXXXXXXXXXXXXXXXXXXXXXXXXXXXXXXXXXXXXXXXXXXXXXXXXXXXXXXXXXXXXXXXXXXXXXXXXXXXXXXXXXXXXXXXXXXX---XXXXXXXXXXXXXXXXXXXXXXXXXXXXXXXXXXXX---XXXXXXXXXXXXXXXXXXXXXXXXXXXX
