---------------------------------------------------------------------------------------------------------------------------------------------------------------------------------------
---------------------------------------------------------------------------------------------------------------------------------------------------------------------------------------
---------------------------------------------------------------------------------------------------------------------------------------------------------------------------------------
---------------------------------------------------------------------------------------------------------------------------------------------------------------------------------------
---------------------------------------------------------------------------------------------------------------------------------------------------------------------------------------
---------------------------------------------------------------------------------------------------------------------------------------------------------------------------------------
------------------------------------SSS--------------------------------------------------------------------------------------------------------------------------------------SSS-------
-----------------------------------------------------------###-----------------------------------------------------------S@S!S------------------------------###------------------------
----------------------------------------------------------####---------------------------------------------------------------------------------------------####-------------g----------
---------------------------------------------------------#####---------------SSS------------------------------------------------------------SSS-----------#####------------------------
---SS!S--------------------------------------S----------######---------------------------------------------------------------------##------------S-------######---SS!S-----@S--------##
-------------tt----------------------------------------#######-----------------------------------#--------------#-----------------###--------------------######---------------------###
-------------tt---------------tt-------------------tt-########-------------------------------tt-##----------tt-##----------------####--------------------######--------------------####
-M-----------tt--g---------gg-tt-------gg----------tt#########-------------------k--g----t---tt###----------tt###----------gg---#####------k---------g-g-######-------t-----------#####
XXXXXXXXXXXXXXXXXXXXXXXXXXXXXXXXXXXXXXXXXXXXXXXXXXXXXXXXXXXXXXXXXXXXXXXXXXXXXXXXXXXXXXXXXXXXXXXXXXXXXXXXXXXXXXXXXXXXXXXXXXXXXXXXXXXXXXXXXXXXXXXXXXXXXXXXXXXXXXXXXXXXXXXXXXXXXXXXXXXXXXX
XXXXXXXXXXXXXXXXXXXXXXXXXXXXXXXXXXXXXXXXXXXXXXXXXXXXXXXXXXXXXXXXXXXXXXXXXXXXXXXXXXXXXXXXXXXXXXXXXXXXXXXXXXXXXXXXXXXXXXXXXXXXXXXXXXXXXXXXXXXXXXXXXXXXXXXXXXXXXXXXXXXXXXXXXXXXXXXXXXXXXXX
