----------------------------------------------------------------------------------------------------------------------------------------------------------------------------------------------------------
----------------------------------------------------------------------------------------------------------------------------------------------------------------------------------------------------------
----------------------------------------------------------------------------------------------------------------------------------------------------------------------------------------------------------
----------------------------------------------------------------------------------------------------------------------------------------------------------------------------------------------------------
----------------------------------------------------------------------------------------------------------------------------------------------------------------------------------------------------------
----------------------------------------------------------------------------------------------------------------------------------------------------------------------------------------------------------
---------------------------------------------------------------------------SSS----------------------------------------------------------------------------------------------------------------------------
-----------------------------------------------------------------------------------------------------###--------------------------------------------------------###---------------------------------------
--------------------------------------------------------------------------g-------------------------####-------------------------------------------------------####---------------------------------------
---------------------------------------------------------------------------------------------------#####------------------------------------------------------#####---------------------------------------
-------------------S-----------SS---#----------tt-------SS------#--#-----@S-----------------------######------------##-------------------------U----!--------######---------------SS---#------------------
--------------------------tt--------##---------tt--------------##--##----------------------------#######-----------###----tt--------------------------------#######--------------------##-----------------
--------------------------tt--------###--------tt-------------###--###-----------------------tt-########----------####----tt----------------------------tt-########--------------------###----------------
-M------------------------tt-g-g----####-------g------g-g----####--####--------g-g-----------tt#########---------#####----tt---------t------------------tt#########-------g----tg-g----####---------------
XXXXXXXXXXX---XXXXXXXXXXXXXXXXXXXXXXXXXXXXXXXXXXXXXXXXXXXXXXXXXXXXXXXXXXXXXXXXXXXXXXXXXXXXXXXXXXXXXXXXXXXXXXXXXXXXXXXXXXXXXXXXXX---XXXXXXXXXXXXXXXXXXXXXXXXXXXXXXXXXXXXXXXXXXXXXXXXXXXXXXXXXXXXX---XXXXXXX
XXXXXXXXXXX---XXXXXXXXXXXXXXXXXXXXXXXXXXXXXXXXXXXXXXXXXXXXXXX------XXXXXXXXXXXXXXXXXXXXXXXXXXXXXXXXXXXXXXXXXXXXXXXXXXXXXXXXXXXXX---XXXXXXXXXXXXXXXXXXXXXXXXXXXXXXXXXXXXXXXXXXXXXXXXXXXXXXXXXXXXX---XXXXXXX
