--------------------------------------------------------------------------------------------------------------------------------------------------------------------------------------------
--------------------------------------------------------------------------------------------------------------------------------------------------------------------------------------------
--------------------------------------------------------------------------------------------------------------------------------------------------------------------------------------------
--------------------------------------------------------------------------------------------------------------------------------------------------------------------------------------------
--------------------------------------------------------------------------------------------------------------------------------------------------------------------------------------------
--------------------------------------------------------------------------------------------------------------------------------------------------------------------------------------------
-----------S------------------------------------------------------------------------------SSS-----------------------------------------------------------------------------------------------
---------------S@S!S--------------------------------------------------------------------------------------------------------------------------------###-------------------------------------
----------g------------------------------------------------------------------------------g---------------------------------------------------------####-------------------------------------
--------------------------------------------------------------------------------------------------------------------------------------------------#####-------------------------------------
---------@S--------------------------##-SS!S----!-SS!S------------------------U----!----@S--------!--!------------------------!--!---S@S!S-------######-------------------------------------
------------------------------------###---------------------------------------------------------------------tt--------#-------------------------#######---------------------------tt--------
-----------------------------------####---------------------------------------------------------------------tt----tt-##---------------------tt-########---------------------------tt--------
-M---------------gg--g-g----------#####------k--------t----------------k------tt-g-----------t--------------tt----tt###-------------t-------tt#########---------------------------tt-g------
XXXXXXXXXXXXXXXXXXXXXXXXXXXXXXXXXXXXXXXXXXXXXXXXXXXXXXXXXXXXXXXXXXXXXXXXXXXXXXXXXXXXXXXXXXXXXXXXXXXXXXXXXXXXXXXXXXXXXXXXXXXXXXXXXXXXXXXXXXXXXXXXXXXXXXXXXXXXXXXXXXXXXXXXXXXXXXXXXXXXXXXXXXXX
XXXXXXXXXXXXXXXXXXXXXXXXXXXXXXXXXXXXXXXXXXXXXXXXXXXXXXXXXXXXXXXXXXXXXXXXXXXXXXXXXXXXXXXXXXXXXXXXXXXXXXXXXXXXXXXXXXXXXXXXXXXXXXXXXXXXXXXXXXXXXXXXXXXXXXXXXXXXXXXXXXXXXXXXXXXXXXXXXXXXXXXXXXXX
