------------------------------------------------------------------------------------------------------------------------------------------------------------------------------------------------------
------------------------------------------------------------------------------------------------------------------------------------------------------------------------------------------------------
------------------------------------------------------------------------------------------------------------------------------------------------------------------------------------------------------
------------------------------------------------------------------------------------------------------------------------------------------------------------------------------------------------------
------------------------------------------------------------------------------------------------------------------------------------------------------------------------------------------------------
------------------------------------------------------------------------------------------------------------------------------------------------------------------------------------------------------
-----------------SSS-------------------------------------SSS-----------------------------------------------S------------------------------------------------------------------------------------------
------------------------------------------------------------------------------------###------------------------S@S!S----------------------------------------------------###---------------------------
----------------g---------------------------------------g--------------------------####-------------------g------------------------------------------------------------####---------------------------
----------------------------------------------------------------------------------#####--------------------------------------------------------------SSS--------------#####---------------------------
---------------@S------C-----------tt-------SS---#-----@S------------------------######-------!--!---S@S!@S----------------------------------------------------------######------------##-------------
-----------------------------------tt------------##-------------tt--------------#######--------------------------------------tt-------------------------------------#######-----------###-------------
-----------------------------------tt------------###------------tt----------tt-########--------------------------------------tt---------------------------------tt-########----------####-------------
-M--g-g-----------------g-g--------g------g-g----####-----------tt----------tt#########-------------t------------gg----------tt---------------------k--tt-------tt#########---------#####---gg-g------
XXXXXXXXXXXXXXXXXXXXXXXXXXXXXXXXXXXXXXXXXXXXXXXXXXXXXXXXXXXXXXXXXXXXXXXXXXXXXXXXXXXXXXXXXXXXXXXXXXXXXXXXXXXXXXXXXXXXXXXXXXXXXXXXXXXXXXXXX---XXXXXXXXXXXXXXXXXXXXXXXXXXXXXXXXXXXXXXXXXXXXXXXXXXXXXXXXXX
XXXXXXXXXXXXXXXXXXXXXXXXXXXXXXXXXXXXXXXXXXXXXXXXXXXXXXXXXXXXXXXXXXXXXXXXXXXXXXXXXXXXXXXXXXXXXXXXXXXXXXXXXXXXXXXXXXXXXXXXXXXXXXXXXXXXXXXXX---XXXXXXXXXXXXXXXXXXXXXXXXXXXXXXXXXXXXXXXXXXXXXXXXXXXXXXXXXX
