----------------------------------------------------------------------------------------------------------------------------------------------------------------------------------------------------------
----------------------------------------------------------------------------------------------------------------------------------------------------------------------------------------------------------
----------------------------------------------------------------------------------------------------------------------------------------------------------------------------------------------------------
----------------------------------------------------------------------------------------------------------------------------------------------------------------------------------------------------------
----------------------------------------------------------------------------------------------------------------------------------------------------------------------------------------------------------
----------------------------------------------------------------------------------------------------------------------------------------------------------------------------------------------------------
---------------------------------------------SSS-------------------------------------SSS------------------------------------------------------------------------------------------------------------------
---------------------------------------------------------------U----!----------------------------------------------------------------------------------------------------------------------###------------
--------------------------------------------g---------------------------------------------------------------------------------------------------------------------------------------------####------------
--------------------------------------------------------------------------------------------------SSS------------------------------------------------------------------------------------#####------------
--------------------SS------#--#-----------@S---------------------S-----C----------##-------------------------------------!--!---------SS------#--#-------------------------##----------######------------
----------#----------------##--##----------------------#--------------------------###---------------------------------------------------------##--##--------tt-------------###----------######------------
------tt-##---------------###--###-----------------tt-##-------------------------####------tt------------------------------------------------###--###-------tt------------####----------######------------
-M----tt###-------g-g----####--####----------------tt###-----------------g-g----#####---gg-tt----g----tg-------g-g-------------------g-g----####--####------tt-----------#####------g-g-######------------
XXXXXXXXXXXXXXXXXXXXXXXXXXXXXXXXXXXXXXXXXXXXXXXXXXXXXXXXXXXXXXXXXXXXXXXXXXXXXXXXXXXXXXXXXXXXXXXXXXXXXXXXXXXXXXXXXXXXXXXXXXXXXXXXXXXXXXXXXXXXXXXXXXXXXXXXXXXXXXXXXX---XXXXXXXXXXXXXXXXXXXXXXXXXXXXXXXXXXX--
XXXXXXXXXXXXXXXXXXXXXXXXX------XXXXXXXXXXXXXXXXXXXXXXXXXXXXXXXXXXXXXXXXXXXXXXXXXXXXXXXXXXXXXXXXXXXXXXXXXXXXXXXXXXXXXXXXXXXXXXXXXXXXXXXXXXXXX------XXXXXXXXXXXXXXXX---XXXXXXXXXXXXXXXXXXXXXXXXXXXXXXXXXXX--
