--------------------------------------------------------------------------------------------------------------------------------------------------------------------
--------------------------------------------------------------------------------------------------------------------------------------------------------------------
--------------------------------------------------------------------------------------------------------------------------------------------------------------------
--------------------------------------------------------------------------------------------------------------------------------------------------------------------
--------------------------------------------------------------------------------------------------------------------------------------------------------------------
--------------------------------------------------------------------------------------------------------------------------------------------------------------------
---------------------------------------------------------------SSS---------------------------------------SS----------------------SSS--------------------------------
-----------------------S@S!S--------------------------------------------------------------------------------SS!S--------------------------SS!S----------------------
--------------------------------------------------------------g-----------------------------------------g-----------------------g-----------------------------------
--------------------------------------------------------------------------------------------------------------------------------------------------------------------
---------------------S---------!--!-------S@S!S--------------@S------S@S!S---------------S@S!S---SS!S--@S------S-----U----!----@S--------------------SS!S-----------
----------#-----------------tt----------------------------------------------------------------------------------------------------------tt--------------------------
------tt-##-----------------tt----------------------------------------------------------------------------------------------------------tt--------------------------
-M----tt###-----------------tt-------------g----t-g-g-------------------k----------------k--t------------------------gg-g---------------tt----gg---------t----------
XXXXXXXXXXXXXXXXXXXXXXXXXXXXXXXXXXXXXXXXXXXXXXXXXXXXXXXXXXXXXXXXXXXXXXXXXXXXXX---XXXXXXXXXXXXXXXXXXXXXXXXXXXXXXXXXXXXXXXXXXXXXXXXXXXXXXXXXXXXXXXXXXX---XXXXXXXXXXXXX
XXXXXXXXXXXXXXXXXXXXXXXXXXXXXXXXXXXXXXXXXXXXXXXXXXXXXXXXXXXXXXXXXXXXXXXXXXXXXX---XXXXXXXXXXXXXXXXXXXXXXXXXXXXXXXXXXXXXXXXXXXXXXXXXXXXXXXXXXXXXXXXXXX---XXXXXXXXXXXXX
