--------------------------------------------------------------------------------------------------------------------------------------------------------------------------------------------
--------------------------------------------------------------------------------------------------------------------------------------------------------------------------------------------
--------------------------------------------------------------------------------------------------------------------------------------------------------------------------------------------
--------------------------------------------------------------------------------------------------------------------------------------------------------------------------------------------
--------------------------------------------------------------------------------------------------------------------------------------------------------------------------------------------
--------------------------------------------------------------------------------------------------------------------------------------------------------------------------------------------
-----------SS------------------------SSS----------------------------SSS---------------------------------------------------------------------------------------------------------------------
------tt-----------------------------------------------------------------------------------------------------------------------------------------------------------###----------------------
------tt--g-------------------------------------------------------------------------------------------------------------------------------------------------------####----------------------
------tt--------SSS-----------------------------------------------------------------------------------------------------------------------------SSS--------------#####----------------------
------S--@S--------------!--!-----S-----------------SS---#------------------SS---#---------------------------!--!-----------------------SS----------------------######----------C-----------
-----------------------------------------------tt--------##----------------------##--------tt--------#---------------------------------------------------------#######----------------------
-------------------tt--------------------------tt--------###---------------------###-------tt----tt-##-----------------------------------------------------tt-########----------------------
-M------------t----tt-------------------gg-----tt-g-g----####----------gg-g-g----####------tt----tt###-------------t------------------g-g----####--t-------tt#########-----------g-g--g----t
XXXXXXXXXXXXXXXXXXXXXXXXXXXXXXXXXXXXXXXXXXXXXXXXXXXXXXXXXXXXXXXXXXXXXXXXXXXXXXXXXXXXXXXXXXXXXXXXXXXXXXXXXXXXXXXXXXXXXXXXXXX---XXXXXXXXXXXXXXXXXXXXXXXXXXXXXXXXXXXXXXXXXXXXXXXXXXXXXXXXXXXXXX
XXXXXXXXXXXXXXXXXXXXXXXXXXXXXXXXXXXXXXXXXXXXXXXXXXXXXXXXXXXXXXXXXXXXXXXXXXXXXXXXXXXXXXXXXXXXXXXXXXXXXXXXXXXXXXXXXXXXXXXXXXX---XXXXXXXXXXXXXXXXXXXXXXXXXXXXXXXXXXXXXXXXXXXXXXXXXXXXXXXXXXXXXX
