----------------------------------------------------------------------------------------------------------------------------------------------------------------------------------------------------------
----------------------------------------------------------------------------------------------------------------------------------------------------------------------------------------------------------
----------------------------------------------------------------------------------------------------------------------------------------------------------------------------------------------------------
----------------------------------------------------------------------------------------------------------------------------------------------------------------------------------------------------------
----------------------------------------------------------------------------------------------------------------------------------------------------------------------------------------------------------
----------------------------------------------------------------------------------------------------------------------------------------------------------------------------------------------------------
-----SSS-------------------------------------------------------------------------------SSS----------------------------------------------------------------------------------------------------------------
----------------###--------------------------------###---------------------------------------------------------------------------------------U----!-------------------------------------------------------
----g----------####-------------------------------####--------------------------------g-------------------------------------------------------------------------------------------------------------------
--------------#####------------------------------#####----------------------------------------------------------------------------------------------------------------------------------------------------
---@S--------######-----------------------------######----------------tt-------------@S-------------------SS------#--#-------SS------#--#---------------------S-------------------------------------------
-------------######----------------------------#######----------------tt-----------------------------------------##--##-------------##--##--------------tt------------------------tt--------------tt------
-------------######------------------------tt-########-------tt-------tt--------------------------tt------------###--###-----------###--###-------------tt------------------------tt--------------tt------
-M-------g-g-######------------------------tt#########-------tt---------------g-------------------tt----g-g----####--####--g-g----####--####-----gg-----tt------------------------tt-------k------tt--g-g-
XXXXXXXXXXXXXXXXXXXXXXXXXXXXXXXXXXX---XXXXXXXXXXXXXXXXXXXXXXXXXXXXXXXXXXXXXXXXXXXXXXXXXXXXXXX---XXXXXXXXXXXXXXXXXXXXXXXXXXXXXXXXXXXXXXXXXXXXXXXXXXXXXXXXXXXXXXXXXXXX---XXXXXXXXXXXXXXXXXXXXXXXXXXXXXXXXXXX
XXXXXXXXXXXXXXXXXXXXXXXXXXXXXXXXXXX---XXXXXXXXXXXXXXXXXXXXXXXXXXXXXXXXXXXXXXXXXXXXXXXXXXXXXXX---XXXXXXXXXXXXXXX------XXXXXXXXXXXXX------XXXXXXXXXXXXXXXXXXXXXXXXXXXX---XXXXXXXXXXXXXXXXXXXXXXXXXXXXXXXXXXX
