----------------------------------------------------------------------------------------------------------------------------------------------------------------------------------------------------------
----------------------------------------------------------------------------------------------------------------------------------------------------------------------------------------------------------
----------------------------------------------------------------------------------------------------------------------------------------------------------------------------------------------------------
----------------------------------------------------------------------------------------------------------------------------------------------------------------------------------------------------------
----------------------------------------------------------------------------------------------------------------------------------------------------------------------------------------------------------
----------------------------------------------------------------------------------------------------------------------------------------------------------------------------------------------------------
-------------------------------------------------------------------------------------------------------------------------------SS-------------------------------------------------------------------------
-----------S@S!S-----------------------------------------------###---------------------------------------------------------------U----!-------------------------------------------------------------------
--------------------------------------------------------------####------------------------------------------------------------g---------------------------------------------------------------------------
-------------------------------------------------------------#####----------------------------------------------------------------------------------------------------------------------------------------
---!--!-----S-----C----------##-----------------------------######---------SS------#--#-----------------##-------------!--!--@S---------!--!-----tt-----------------SS------#--#----------##--------------
----------------------------###-----------------------------######----------------##--##--------tt-----###----------tt---------------------------tt------------------------##--##--------###-------------#
---------------------------####------tt---------------------######---------------###--###-------tt----####----------tt---------------------------tt---------tt------------###--###------####tt-------tt-##
-M-----------------g-g----#####g----ttt----g----t-------g-g-######-------g-g----####--####------tt---#####---gg-----tt---------------gg-------g----t--------tt----g-g----####--####----#####tt-------tt###
XXXXXXXXXXXXXXXXXXXXXXXXXXXXXXXXXXXXXXXXXXXXXXXXXXXXXXXXXXXXXXXXXXXXXXXXXXXXXXXXXXXXXXXXXXXXXXXXXXXXXXXXXXXXXXXXXXXXXXXXXXXXXXXXXXXXXXXXXXXXXXXXXXXXXXX---XXXXXXXXXXXXXXXXXXXXXXXXXXXXXXXXXXXXXXXXXXXXXXXX
XXXXXXXXXXXXXXXXXXXXXXXXXXXXXXXXXXXXXXXXXXXXXXXXXXXXXXXXXXXXXXXXXXXXXXXXXXXXXXXX------XXXXXXXXXXXXXXXXXXXXXXXXXXXXXXXXXXXXXXXXXXXXXXXXXXXXXXXXXXXXXXXXX---XXXXXXXXXXXXXXX------XXXXXXXXXXXXXXXXXXXXXXXXXXX
