------------------------------------------------------------------------------------------------------------------------------------------------------------------------------
------------------------------------------------------------------------------------------------------------------------------------------------------------------------------
------------------------------------------------------------------------------------------------------------------------------------------------------------------------------
------------------------------------------------------------------------------------------------------------------------------------------------------------------------------
------------------------------------------------------------------------------------------------------------------------------------------------------------------------------
------------------------------------------------------------------------------------------------------------------------------------------------------------------------------
------------------------------------------------------------------------------------------------------------------------------------------------------------------------------
-----tt---------------------###---------------------------------------------------------------------------------------------------------------------###-----------------------
-----tt--------------------####--------------------------------------------------------------------------------------------------------------------####-----------------------
-----tt-------------------#####------------------SSS----------------------------------------------------------------------------SSS---------------#####-----------------------
-------------------------######--------------!------------SS!S--SS!S-----S----------------S--------S@S!S-----------------------------------------######---------tt--------tt--
------------------------#######-----------tt-----------------------------------#----------------------------------------------------------------#######---------tt--------tt--
--------------------tt-########-----------tt--------------------------------t-##------------------------------------------------------------tt-########---------tt--------tt--
-M----gg------------tt#########-----------tt-------g------------g----t------t###-------------------k--g----t-----g----t------g--------------tt#########-------g-------g-g-tt--
XXXXXXXXXXXX---XXXXXXXXXXXXXXXXXXXXXXXXXXXXXXXXXXXXXXXXXXXXXXXXXXXXXXXXXXXXXXXXXXXXXXXXXXXXXXXXXXXXXXXXXXXXXXXXXXXXXXXXXXXXXXXXXXXXXXXXXXXXXXXXXXXXXXXXXXXXXXXXXXXXXXXXXXXXXXX
XXXXXXXXXXXX---XXXXXXXXXXXXXXXXXXXXXXXXXXXXXXXXXXXXXXXXXXXXXXXXXXXXXXXXXXXXXXXXXXXXXXXXXXXXXXXXXXXXXXXXXXXXXXXXXXXXXXXXXXXXXXXXXXXXXXXXXXXXXXXXXXXXXXXXXXXXXXXXXXXXXXXXXXXXXXX
