----------------------------------------------------------------------------------------------------------------------------------------------------------------------------------------------------
----------------------------------------------------------------------------------------------------------------------------------------------------------------------------------------------------
----------------------------------------------------------------------------------------------------------------------------------------------------------------------------------------------------
----------------------------------------------------------------------------------------------------------------------------------------------------------------------------------------------------
----------------------------------------------------------------------------------------------------------------------------------------------------------------------------------------------------
----------------------------------------------------------------------------------------------------------------------------------------------------------------------------------------------------
-------------------------------------------------------------------------------------------------------------------------------------SSS------------------------------------SSS---------------------
------------------------------------------###---------------------------------------------------------------------------------------------------###-------------------------------------------------
-----------------------------------------####---------------------------------------------------------------------------------------g----------####------------------------g------------------------
----------------------------------------#####-------------------------------------------------------------------------------------------------#####-------------------------------------------------
-----U----!------S---------------------######-------------------S@S!S----------SS------#--#-----------------!-U----!------S--!--!--@S--------######-----------------------@S-------------------SS---
---------------------------------------######-----------------------------------------##--##-------------------------------------------------######-------------------------------------------------
---------------------------------------######----------------------------------------###--###------------------------------------------------######-------------------------------------------------
-M-------t-------------------------g-g-######---------------#####g-----------g-g----####--####--------------------t----------------------g-g-######-------------k--g-------------------------g-g----
XXXXXXXXXXXXXXXXXXXXXXXXXXXXX---XXXXXXXXXXXXXXXXXXXXXXXXXXXXXXXXXXXXXXXXXXXXXXXXXXXXXXXXXXXXXXXXXXXXXXXXXXXXXXXXXXXXXXXXXXXXXXXXXXXXXXXXXXXXXXXXXXXXXXXXXXXXXXXXXXXXXXXXXXXXXXXXXXXXXXXX---XXXXXXXXX
XXXXXXXXXXXXXXXXXXXXXXXXXXXXX---XXXXXXXXXXXXXXXXXXXXXXXXXXXXXXXXXXXXXXXXXXXXXXXXXXXX------XXXXXXXXXXXXXXXXXXXXXXXXXXXXXXXXXXXXXXXXXXXXXXXXXXXXXXXXXXXXXXXXXXXXXXXXXXXXXXXXXXXXXXXXXXXXXX---XXXXXXXXX
