-------------------------------------------------------------------------------------------------------------------------------------------------------------------------------------------------------
-------------------------------------------------------------------------------------------------------------------------------------------------------------------------------------------------------
-------------------------------------------------------------------------------------------------------------------------------------------------------------------------------------------------------
-------------------------------------------------------------------------------------------------------------------------------------------------------------------------------------------------------
-------------------------------------------------------------------------------------------------------------------------------------------------------------------------------------------------------
-------------------------------------------------------------------------------------------------------------------------------------------------------------------------------------------------------
--------------------SSS---------------------------------------------------------------------------------------------------------------------------------------SSS--------------SSS-----------SSS-------
-----------U----!--------------------------------------------------------------------------------------------------------------###---------------------------------------------------------------------
-------------------g----------------------------------------------------------------------------------------------------------####----------------------------------------------------------g----------
-----------------------------------------------------------------------------------------------------------------------------#####---------------------------------------------------------------------
------C-----------@S-------------C-------------------------C---------------------------------------SS------#--#-------------######--------------U----!----------S--------------------------@S--------##
---------------------------tt-------------------------------------------------------#---------------------##--##-----------#######------------------------------------------------------------------###
---------------------------tt---------------------------------------------------tt-##--------------------###--###------tt-########-------tt--------------------------------------------------------####
-M-----g-g-----gg----------tt-----g-g--t----g----t----------g-g--g----t---------tt###------------g-g----####--####-----tt#########-------tt----------k-------------g----t---------gg-g----t-------#####
XXXXXXXXXXXXXXXXXXXXXXXXXXXXXXXXXXXXXXXXXXXXXXXXXXXXXXXXXXXXXXXXXXXXXXXXXXXXXXXXXXXXXXXXXXXXXXXXXXXXXXXXXXXXXXXXXXXXXXXXXXXXXXXXXXXXXXXXXXXXXXXXXXXXXXXXXXXXXXXXXXXXXXXXXXXXXXXXXXXXXXXXXXXXXXXXXXXXXXX
XXXXXXXXXXXXXXXXXXXXXXXXXXXXXXXXXXXXXXXXXXXXXXXXXXXXXXXXXXXXXXXXXXXXXXXXXXXXXXXXXXXXXXXXXXXXXXXXXXXXXXXX------XXXXXXXXXXXXXXXXXXXXXXXXXXXXXXXXXXXXXXXXXXXXXXXXXXXXXXXXXXXXXXXXXXXXXXXXXXXXXXXXXXXXXXXXX
