---------------------------------------------------------------------------------------------------------------------------------------------------------------------------------------
---------------------------------------------------------------------------------------------------------------------------------------------------------------------------------------
---------------------------------------------------------------------------------------------------------------------------------------------------------------------------------------
---------------------------------------------------------------------------------------------------------------------------------------------------------------------------------------
---------------------------------------------------------------------------------------------------------------------------------------------------------------------------------------
---------------------------------------------------------------------------------------------------------------------------------------------------------------------------------------
------------------------------------------------------------------------SSS------------------------------------------------------------------------------------------------------------
-----------------------------------------------------------------------------------------------------U----!----------------------------------------------------------------------------
-----------------------------------------------------------------------g---------------------------------------------------------------------------------------------------------------
---------------------------------------------------------------------------------------------------------------------------------------------------------------------------------------
------S--!--!----------S@S!S---!--!----SS---#---------------U----!----@S-----------S@S!S-------------------------S-----------------SS!S-------SS------#--#-----!--!--------------------
--------------------------------------------##--------tt-----------------------t--------------#------------------------------------------------------##--##----------------------------
--------------------------------------------###-------tt-tt--------------------t----------tt-##-----------------------------------------------------###--###---------------------------
-M-------------------k--g------------g-g----####------tt-tt----g---------------tt-t-------tt###----------gg-g----t----------------#####t----g-g----####--####-------------g------------
XXXXXXXXXXXXXXXXXXXXXXXXXXXXXXXXXXXXXXXXXXXXXXXXXXXXXXXXXXXXXXXXXXXXXXXXXXXXXXXXXXXXXXXXXXXXXXXXXXXXXXXXXXXXXXXXXXXXX---XXXXXXXXXXXXXXXXXXXXXXXXXXXXXXXXXXXXXXXXXXXXXXXXXXXXXXXXXXXXXXX
XXXXXXXXXXXXXXXXXXXXXXXXXXXXXXXXXXXXXXXXXXXXXXXXXXXXXXXXXXXXXXXXXXXXXXXXXXXXXXXXXXXXXXXXXXXXXXXXXXXXXXXXXXXXXXXXXXXXX---XXXXXXXXXXXXXXXXXXXXXXXXXXX------XXXXXXXXXXXXXXXXXXXXXXXXXXXXXX
