----------------------------------------------------------------------------------------------------------------------------------------------------------------------------------------------------------
----------------------------------------------------------------------------------------------------------------------------------------------------------------------------------------------------------
----------------------------------------------------------------------------------------------------------------------------------------------------------------------------------------------------------
----------------------------------------------------------------------------------------------------------------------------------------------------------------------------------------------------------
----------------------------------------------------------------------------------------------------------------------------------------------------------------------------------------------------------
----------------------------------------------------------------------------------------------------------------------------------------------------------------------------------------------------------
----------------------------------------------------------------------------------------------------------------------------------------------------------------------------------------------------------
--------------------------###-------------------------------------------------------------------------###------------------------------------------------------------------------------###----------------
-------------------------####------------------------------------------------------------------------####-----------------------------------------------------------------------------####----------------
------------------------#####-----------------------------------------------------------------------#####----------------------------------------------------------------------------#####----------------
-----------------------######-------!--!-------##------!--!--------------------------##------------######---------------SS---#-------------------------------C------S@S!S-tt--------######----------------
----------------------#######-----------------###-----------------------------------###----tt------######--------------------##-------------------------------------------tt--------######-----------tt---
------------------tt-########----------------####----------------------------------####----tt------######-------tt-----------###------------------------------------------tt--------######-----------tt---
-M----gg----------tt#########---------------#####---gg-------g----tg--------------#####----tt--g-g-######-------tt----g-g----####-----gg-t-----g-g------------g-g--t----g-------g-g-######-----------tt---
XXXXXXXXXXXXXXXXXXXXXXXXXXXXXXXXXXXXXXXXXXXXXXXXXXXXXXXXXXXXXXXXXXXXXXXXXXXXXXXXXXXXXXXXXXXXXXXXXXXXXXXXXXXXXXXXXXXXXXXXXXXXXXXXXXXXXXXXXXXXXXXXXXXXXXXXXXXXXXXXXXXXXXXXXXXXXXXXXXXXXXXXXXXXXXXXXXXXXXXXXX
XXXXXXXXXXXXXXXXXXXXXXXXXXXXXXXXXXXXXXXXXXXXXXXXXXXXXXXXXXXXXXXXXXXXXXXXXXXXXXXXXXXXXXXXXXXXXXXXXXXXXXXXXXXXXXXXXXXXXXXXXXXXXXXXXXXXXXXXXXXXXXXXXXXXXXXXXXXXXXXXXXXXXXXXXXXXXXXXXXXXXXXXXXXXXXXXXXXXXXXXXX
