----------------------------------------------------------------------------------------------------------------------------------------------------------------------------------------------------------
----------------------------------------------------------------------------------------------------------------------------------------------------------------------------------------------------------
----------------------------------------------------------------------------------------------------------------------------------------------------------------------------------------------------------
----------------------------------------------------------------------------------------------------------------------------------------------------------------------------------------------------------
----------------------------------------------------------------------------------------------------------------------------------------------------------------------------------------------------------
----------------------------------------------------------------------------------------------------------------------------------------------------------------------------------------------------------
--------------------------------------------------------------------------------------------------------------------------------------------------------SSS-----------------------------------------------
----------------------------------------------------------------------------------------------------------------------------------------------------------------------###----------------tt---------------
-------------------------------------------------------------------------------------------------------------------------------------------------------g-------------####----------------tt---------------
------------------------------SSS-----------------------------------------------------------------------------------------------------------------------------------#####----------------tt---------------
---!--!---U----!-----C--------------SS------#--#----------##---C-------tt--------##----------------------------------------!--!-----------------------@S-----------######-----------------------S---------
-------------------------------------------##--##--------###-----------tt-------###----tt--------------------------#--------------------#-------------------------#######-----------tt--------------------
------------------------------------------###--###------####-----------tt------####----tt-tt-------------------tt-##----------------tt-##---------------------tt-########-----------tt--------------------
-M-------------k------g-g--g------g-g----####--####----#####----g-g--g--------#####----tt-tt----------g----t---tt###----------------tt###---------------------tt#########-----------tt----gg--------------
XXXXXXXXXXXXXXXXXXXXXXXXXXXXXXXXXXXXXXXXXXXXXXXXXXXXXXXXXXXXXXXXXXXXXXXXXXXXXXXXXXXXXXXXXXXXXXXXXXXXXXXXXXXXXXXXXXXXXXXXXXXXXXXXXXXXXXXXXXXXXXXXXXXXXXXXXXXXXXXXXXXXXXXXXXXXXXXXXXXXXXXXXXXXXXXXXXXXXX---X
XXXXXXXXXXXXXXXXXXXXXXXXXXXXXXXXXXXXXXXXX------XXXXXXXXXXXXXXXXXXXXXXXXXXXXXXXXXXXXXXXXXXXXXXXXXXXXXXXXXXXXXXXXXXXXXXXXXXXXXXXXXXXXXXXXXXXXXXXXXXXXXXXXXXXXXXXXXXXXXXXXXXXXXXXXXXXXXXXXXXXXXXXXXXXXXXX---X
