----------------------------------------------------------------------------------------------------------------------------------------------------------------------------------------------------------
----------------------------------------------------------------------------------------------------------------------------------------------------------------------------------------------------------
----------------------------------------------------------------------------------------------------------------------------------------------------------------------------------------------------------
----------------------------------------------------------------------------------------------------------------------------------------------------------------------------------------------------------
----------------------------------------------------------------------------------------------------------------------------------------------------------------------------------------------------------
----------------------------------------------------------------------------------------------------------------------------------------------------------------------------------------------------------
------------------------------------------------------------------------------------------------------------------------------------------------------------------------------------------------SSS-------
--------------------------------------------------------------------------------------------------SS!S----------------------------------------------------------------------------------------------------
-----------------------------------------------------------------------------------------------------------------------------------------------------------------------------------------------g----------
----------------------------------------------------------------------------------------------------------------------------------------------------------------------------------------------------------
-----------SS------#--#----------##--SS------#--#----------------------------------------------------------SS------#--#--------S-------------------------S----SS---#--------------------------@S-----SS---
------------------##--##--------###---------##--##-----------------------------#----------------------------------##--##----------------------#--------------------##-----------#-------------------------
---tt------------###--###------####--------###--###------------------------tt-##---------------------------------###--###-----------------tt-##--------------------###------tt-##-------------------------
-M-tt----g-g----####--####----#####g-g----####--####---------g-g-----------tt###-------------g----t---gg-g-g----####--####----------------tt###-------------g-g----####-----tt###------------------g-g----
XXXXXXXXXXXXXXXXXXXXXXXXXXXXXXXXXXXXXXXXXXXXXXXXXXXXXXXXXXXXXXXXXXXXXXXXXXXXXXXXXXXXXXXXXXXXXXXXXXXXXXXXXXXXXXXXXXXXXXXXXXXXXXXXXXXXXXXXXXXXXXXXXXXXXXXXXXXXXXXXXXXXXXXXXXXXXXXXXXXXXXXXXXXXXXXXXXXXXXXXXX
XXXXXXXXXXXXXXXX------XXXXXXXXXXXXXXXXXXXX------XXXXXXXXXXXXXXXXXXXXXXXXXXXXXXXXXXXXXXXXXXXXXXXXXXXXXXXXXXXXXXXX------XXXXXXXXXXXXXXXXXXXXXXXXXXXXXXXXXXXXXXXXXXXXXXXXXXXXXXXXXXXXXXXXXXXXXXXXXXXXXXXXXXXX
