------------------------------------------------------------------------------------------------------------------------------------------------------------------------------------------------------
------------------------------------------------------------------------------------------------------------------------------------------------------------------------------------------------------
------------------------------------------------------------------------------------------------------------------------------------------------------------------------------------------------------
------------------------------------------------------------------------------------------------------------------------------------------------------------------------------------------------------
------------------------------------------------------------------------------------------------------------------------------------------------------------------------------------------------------
------------------------------------------------------------------------------------------------------------------------------------------------------------------------------------------------------
-----------SSS--------------------------------------------------------------------------------------------------------------------------------------SSS--------------------------------------------SSS
----------------------------------------------------------------------------------------------------------###------------------S@S!S------------------------------------###---------------------------
----------g----------------------------------------------------------------------------------------------####--------------------------------------g-------------------####-----------------------g---
--------------------------------------------------------------------------------------------------------#####------------------------------SSS------------------------#####---------------------------
------S--@S------------------------------!--!----------S-----C--------S--------------S---S--!--!-------######-------!--!-----S-----C--------------@S---!--!----------######----------------------@S---
-----------------------------------------------------------------------------tt------------------------######-------------------------------------------------------#######--------------#------------
-----------------------------------------------------------------------------tt------------------------######---------------------------------------------------tt-########----------tt-##------------
-M-------------g-g--------------k--------------t--------------g-g------------tt--------------------g-g-######-----------------------g-g--------k----------------tt#########----------tt###------------
XXXXXXXXXXXXXXXXXXXXXXXXXXXXXXXXXXXXXXXXXXXXXXXXXXXXXXXXXXXXXXXXXXXXXXXXXXXXXXXXXXXXXXXXXXXXXXXXXXXXXXXXXXXXXXXXXXXXXXXXXXXXXXXXXXXXXXXXXXXXXXXXXXXXXXXXXXXXXXXXXXXXXXXXXXXXXXXXXXXXXXXXXXXXXXXXXXXXXX
XXXXXXXXXXXXXXXXXXXXXXXXXXXXXXXXXXXXXXXXXXXXXXXXXXXXXXXXXXXXXXXXXXXXXXXXXXXXXXXXXXXXXXXXXXXXXXXXXXXXXXXXXXXXXXXXXXXXXXXXXXXXXXXXXXXXXXXXXXXXXXXXXXXXXXXXXXXXXXXXXXXXXXXXXXXXXXXXXXXXXXXXXXXXXXXXXXXXXX
