----------------------------------------------------------------------------------------------------------------------------------------------------------------------------------------------------
----------------------------------------------------------------------------------------------------------------------------------------------------------------------------------------------------
----------------------------------------------------------------------------------------------------------------------------------------------------------------------------------------------------
----------------------------------------------------------------------------------------------------------------------------------------------------------------------------------------------------
----------------------------------------------------------------------------------------------------------------------------------------------------------------------------------------------------
----------------------------------------------------------------------------------------------------------------------------------------------------------------------------------------------------
---------------------------------SSS---------------------------------------------------------------------------------------------SSS----------------------------------------------------------------
---------------------------------------------------------------------------------------------------------------------###----------------------------------------------------------------------------
--------------------------------g-----------------------------------------------------------------------------------####----------------------------------------------------------------------------
---------------------------------------------------------------------------------SSS-------------------------------#####----------------------------------------------------------------------------
-----------!--!----------------@S-------------------tt------------------------------C-------tt--------------------######-------@-SS!S-----tt----!--!-----------S--!--!-----C------------------------
----------------------------tt-------------#--------tt--------------------------------------tt-------------------#######------------------tt--------------------------------------------------------
----------------------------tt---------tt-##--------tt--------tt----------------------------tt---------------tt-########------------------tt--------------------------------------------------------
-M---------------g----------tt---------tt###-------t----------tt----g------g----t----g-g--g------------k-----tt#########------------g------t----------g----t----------------g-g------------------gg-
XXXXXX---XXXXXXXXXXXXXXXXXXXXXXXXXXXXXXXXXXXXXXXXXXXXXXXXXXXXXXXXXXXXXXXXXXXXXXXXXXXXXXXXXXXXXXXXXXXXXXXXXXXXXXXXXXXXXXXXXXXXXXXXXXXXXXXXXXXXXXXXXXXXXXXXXXXXXXXXXXXXXXXXXXXXXXXXXXXXXXXX---XXXXXXXX
XXXXXX---XXXXXXXXXXXXXXXXXXXXXXXXXXXXXXXXXXXXXXXXXXXXXXXXXXXXXXXXXXXXXXXXXXXXXXXXXXXXXXXXXXXXXXXXXXXXXXXXXXXXXXXXXXXXXXXXXXXXXXXXXXXXXXXXXXXXXXXXXXXXXXXXXXXXXXXXXXXXXXXXXXXXXXXXXXXXXXXX---XXXXXXXX
