----------------------------------------------------------------------------------------------------------------------------------------------------------------------------------------------
----------------------------------------------------------------------------------------------------------------------------------------------------------------------------------------------
----------------------------------------------------------------------------------------------------------------------------------------------------------------------------------------------
----------------------------------------------------------------------------------------------------------------------------------------------------------------------------------------------
----------------------------------------------------------------------------------------------------------------------------------------------------------------------------------------------
----------------------------------------------------------------------------------------------------------------------------------------------------------------------------------------------
---------------------------------------------------------------------------------------------SSS----------------------------------------------------------------------------------------------
---------------------------------------------------------------------------------------------------------------------------------------------SS!S--------------------------S@S!S--------------
--------------------------------------------------------------------------------------------g-------------------------------------------------------------------------------------------------
----------------------------------------------------------------------------------------------------------------------------------------------------------------------------------------------
---------!--!-------------------!--!----------------------------##---------------S@S!!--!--@S------------------SS---#-----------S@S!S---------------------------------------S-----------S@S!S-
---------------------------------------------------------------###----------tt--------------------------------------##-------------------------------------#----------------------------------
--------------------------------------------------------------####----------tt--------------------------------------###--------------------------------tt-##----------------------------------
-M----gg-------------g-g-------------------------------------#####g----t----tt-------------------------------g-g----####--------k----------------gg----tt###----------------------gg-------k--
XXXXXXXXXXXXXXXXXXXXXXXXXXXXXXXXXXXXXXXXX---XXXXXXXXXX---XXXXXXXXXXXXXXXXXXXXXXXXXXXXXXXXXXXXXXXXXX---XXXXXXXXXXXXXXXXXXXXXXXXXXXXXXXXXXXXXXXXXXXXXXXXXXXXXXXXXXXXXXXXXXXXXXXXXXXXXXXXXXXXXXXX
XXXXXXXXXXXXXXXXXXXXXXXXXXXXXXXXXXXXXXXXX---XXXXXXXXXX---XXXXXXXXXXXXXXXXXXXXXXXXXXXXXXXXXXXXXXXXXX---XXXXXXXXXXXXXXXXXXXXXXXXXXXXXXXXXXXXXXXXXXXXXXXXXXXXXXXXXXXXXXXXXXXXXXXXXXXXXXXXXXXXXXXX
