-----------------------------------------------------------------------------------------------------------------------------------------------------------------------------------
-----------------------------------------------------------------------------------------------------------------------------------------------------------------------------------
-----------------------------------------------------------------------------------------------------------------------------------------------------------------------------------
-----------------------------------------------------------------------------------------------------------------------------------------------------------------------------------
-----------------------------------------------------------------------------------------------------------------------------------------------------------------------------------
-----------------------------------------------------------------------------------------------------------------------------------------------------------------------------------
------------------------------------------------------------------------------------------------------------------------------------------------------SSS--------------------------
-------------------------------------------------------------------------------------------------------###------------------------U----!-------------------------------------------
------------------------------------------------------------------------------------------------------####-------------------------------------------------------------------------
-----------------------------------------------------------------------------------------------------#####---------------------------------------SSS-------------------------------
----!------C--------S----SS------#--#------------SS---#----------------------U----!-----------------######-------------------------------------------------------S----S@S!S--------
--------------------------------##--##----------------##--------------------------------------------######------------------------------------------------------------------------#
-------------------------------###--###---------------###---tt--------------------------------------######--------------------------------------------------------------------tt-##
-M-t--------g-g--------g-g----####--####-------g-g----####--tt----------------------g-g---------g-g-######--------------g-g-----------gg-------t--------------------g---------tt###
XXXXXXXXXXXXXXXXXXXXXXXXXXXXXXXXXXXXXXXXXXXXXXXXXXXXXXXXXXXXXXXXXXXXXXXXXXXXXXXXXXXXXXXXXXXXXXXXXXXXXXXXXXXXXXXXXXXXXXXXXXXXXXXXXXXXXXXXXXXXXXXXXXXXXXXXXXXXXXXXXXXXXXXXXXXXXXXXXXX
XXXXXXXXXXXXXXXXXXXXXXXXXXXXXX------XXXXXXXXXXXXXXXXXXXXXXXXXXXXXXXXXXXXXXXXXXXXXXXXXXXXXXXXXXXXXXXXXXXXXXXXXXXXXXXXXXXXXXXXXXXXXXXXXXXXXXXXXXXXXXXXXXXXXXXXXXXXXXXXXXXXXXXXXXXXXXX
