--------------------------------------------------------------------------------------------------------------------------------------------------------------------------------------------------------
--------------------------------------------------------------------------------------------------------------------------------------------------------------------------------------------------------
--------------------------------------------------------------------------------------------------------------------------------------------------------------------------------------------------------
--------------------------------------------------------------------------------------------------------------------------------------------------------------------------------------------------------
--------------------------------------------------------------------------------------------------------------------------------------------------------------------------------------------------------
--------------------------------------------------------------------------------------------------------------------------------------------------------------------------------------------------------
-------------------------SSS-------------------------------------------------------------------------------------------------------------------------------SSS------------------------------------------
----------------------------------------------------------------------------------------------S@S!S-----------------------------------------------U----!------------------------------------------------
------------------------g---------------------------------------------------------------------------------------------------------------------------------g---------------------------------------------
-------------------------------------------------------------------------------------SSS----------------------------------------------------------------------------------------------------------------
-----S@S!S!--!-------##@S------C-----!--!-----------C---------------C---------------------------------C--------S---SS!S----------------------------------@S------C-----------!--!-----C-----------------
--------------------###--------------------------------------------------------------------------------------------------------------------tt---------------------------------------------------tt------
-------------------####--------------------tt------------------------------------------------------------------------------tt--------------tt---------------------------------------------------tt------
-M-g--------------#####---------g-g--------tt--------g-g--g----------g-g----------------t-------gg-----g-g--------------k--tt--------------tt---------gg----------g-g--g----t----------g-g------tt------
XXXXXXXXXXXXXXXXXXXXXXXXXXXXXXXXXXXXXXXXXXXXXXXXXXXXXXXXXXXXXXXXXXXXXXXXXXXXX---XXXXXXXXXXXXXXXXXXXXXXXXXXXXXXXXXXXXXXXXXXXXXXXXXXXXXXXXXXXXXXXXXXXXXXXXXXXXXXXXXXXXXXXXXXXXXXXXXXXXXXXXXXXXXXXXXXXXXXXX
XXXXXXXXXXXXXXXXXXXXXXXXXXXXXXXXXXXXXXXXXXXXXXXXXXXXXXXXXXXXXXXXXXXXXXXXXXXXX---XXXXXXXXXXXXXXXXXXXXXXXXXXXXXXXXXXXXXXXXXXXXXXXXXXXXXXXXXXXXXXXXXXXXXXXXXXXXXXXXXXXXXXXXXXXXXXXXXXXXXXXXXXXXXXXXXXXXXXXX
