--------------------------------------------------------------------------------------------------------------------------------------------------------------------------------------
--------------------------------------------------------------------------------------------------------------------------------------------------------------------------------------
--------------------------------------------------------------------------------------------------------------------------------------------------------------------------------------
--------------------------------------------------------------------------------------------------------------------------------------------------------------------------------------
--------------------------------------------------------------------------------------------------------------------------------------------------------------------------------------
--------------------------------------------------------------------------------------------------------------------------------------------------------------------------------------
--------------------------SSS---------------------------------------------------------------------------------------------------------------------------------------SSS---------------
-------------------------------------------------------------------------###-----------------------------------------###--------------------------------------------------------------
-------------------------g----------------------------------------------####----------------------------------------####-------------------------------------------g------------------
----------------------------------------------------SSS----------------#####----------SSS--------------------------#####--------------------------------------------------------------
------C--------U----!---@S--------------------------------------------######---------------------------C----------######--------------!--!---------SS!S-----------@S------------------
---------------------------------------tt-----------------------------######--------------------------------------######-----------tt------------------------------------------------#
---------------------------------------tt------------------tt---------######--------------------------------------######-----------tt--------------------------------------------tt-##
-M-----g-g----#####t-------------------tt------t---------ggtt-----g-g-######-------g----tt--------------g-g---g-g-######-----------tt-------t---------g------t---------g---------tt###
XXXXXXXXXXXXXXXXXXXXXXXXXXXXXXXXXXXXXXXXXXXXX--XXXXXXXXXXXXXXXXXXXXXXXXXXXXXXXXXXXXXXXXXXXXXXXXXXXXXXXXXXXXXXXXXXXXXXXXXXXXXXXXXXXXXXXXXXXXXXXXXXXXXXXXXXXXXXXXXXXXXXXXXXXXXXXXXXXXXXX
XXXXXXXXXXXXXXXXXXXXXXXXXXXXXXXXXXXXXXXXXXXXX--XXXXXXXXXXXXXXXXXXXXXXXXXXXXXXXXXXXXXXXXXXXXXXXXXXXXXXXXXXXXXXXXXXXXXXXXXXXXXXXXXXXXXXXXXXXXXXXXXXXXXXXXXXXXXXXXXXXXXXXXXXXXXXXXXXXXXXX
