---------------------------------------------------------------------------------------------------------------------------------------------------------------------------------
---------------------------------------------------------------------------------------------------------------------------------------------------------------------------------
---------------------------------------------------------------------------------------------------------------------------------------------------------------------------------
---------------------------------------------------------------------------------------------------------------------------------------------------------------------------------
---------------------------------------------------------------------------------------------------------------------------------------------------------------------------------
---------------------------------------------------------------------------------------------------------------------------------------------------------------------------------
--------------------------------------------------------------------------------------------------------------------------------------------------------------SS-----------------
----------S@S!S--------------------------------------------------------------------------------------------------S@S!S-----------------------------------------------------------
-------------------------------------------------------------------------------------------------------------------------------------------------------------g-------------------
-------------------------------------------------------------------------------------------------------------------------------------------------------------------SSS-----------
------------------------------S@S!------S@S!S------S@S!S--------------------------------SS---#-----------------------------------SS!S---------------##------@S-----------------##
-------------------tt------------------------------------------------------------------------##------------------------------#---------------------###------------------------###
-------------------tt------------------------------------------------------------------------###-------------------------tt-##--------------------####-----------------------####
-M----------gg-----tt-------g----t----tt-g------------k----------------gg--g-g--------g-g----####------------------gg----tt###-------t-----------#####---gg------------k----#####
XXXXXXXXXXXXXXXXXXXXXXXXXXXXXXXXXXXXXXXXXXXXXXXXXXXXXXXXXXXXXXXXXXXXXXXXXXXXXXXXXXXXXXXXXXXXXXXXXXXXXX---XXXXXXXXXXXXXXXXXXXXXXXXXXXXXXXXXXXXXXXXXXXXXXXXXXXXXXXXXXXXXXXXXXXXXXXX
XXXXXXXXXXXXXXXXXXXXXXXXXXXXXXXXXXXXXXXXXXXXXXXXXXXXXXXXXXXXXXXXXXXXXXXXXXXXXXXXXXXXXXXXXXXXXXXXXXXXXX---XXXXXXXXXXXXXXXXXXXXXXXXXXXXXXXXXXXXXXXXXXXXXXXXXXXXXXXXXXXXXXXXXXXXXXXX
