-----------------------------------------------------------------------------------------------------------------------------------------------------------------------------------------
-----------------------------------------------------------------------------------------------------------------------------------------------------------------------------------------
-----------------------------------------------------------------------------------------------------------------------------------------------------------------------------------------
-----------------------------------------------------------------------------------------------------------------------------------------------------------------------------------------
-----------------------------------------------------------------------------------------------------------------------------------------------------------------------------------------
-----------------------------------------------------------------------------------------------------------------------------------------------------------------------------------------
--------------------------------------------------------------------------S--------------------------------------------------------------------------------------------------------------
--------S@S!S---------------------------------------------------------------SS!S----------------------------------------------------------###--------------------------------------------
-------------------------------------------------------------------------g---------------------------------------------------------------####--------------------------------------------
----------------------------------------------------------------------------------------------------------------------------------------#####--------------------------------------------
------S----------------------------##----------------tt---------S-----##@S---------!--SS!S---------------------------------------------######--------------------SS---#-------SS---#-----
-------------------tt-------------###----------------tt--------------###----------------------------tt---------------------------------######-------------------------##-----------##----
-------------------tt------------####------tt--------tt-------------####----------------------------tt---------------------------------######-------------------------###----------###---
-M----------gg-----tt-----------#####------tt---------t------------#####--------gg-------g----------tt-------k--g----t-g-g---------g-g-######-------t----------g-g----####--g-g----####--
XXXXXXXXXXXXXXXXXXXXXXXXX---XXXXXXXXXXXXXXXXXXXXXXXXXXXXXXXXXXXXXXXXXXXXXXXXXXXXXXXXXXXXXXXXXXXXXXXXXXXXXXXXXXXXXXXXXXXXXXXXXXXXXXXXXXXXXXXXXXXXXXXXXXXXXXXXXXXXXXXXXXXXXXXXXXXXXXXXXXXXX
XXXXXXXXXXXXXXXXXXXXXXXXX---XXXXXXXXXXXXXXXXXXXXXXXXXXXXXXXXXXXXXXXXXXXXXXXXXXXXXXXXXXXXXXXXXXXXXXXXXXXXXXXXXXXXXXXXXXXXXXXXXXXXXXXXXXXXXXXXXXXXXXXXXXXXXXXXXXXXXXXXXXXXXXXXXXXXXXXXXXXXX
