---------------------------------------------------------------------------------------------------------------------------------------------------------------------------------------------------------
---------------------------------------------------------------------------------------------------------------------------------------------------------------------------------------------------------
---------------------------------------------------------------------------------------------------------------------------------------------------------------------------------------------------------
---------------------------------------------------------------------------------------------------------------------------------------------------------------------------------------------------------
---------------------------------------------------------------------------------------------------------------------------------------------------------------------------------------------------------
---------------------------------------------------------------------------------------------------------------------------------------------------------------------------------------------------------
-------------------------------------------SSS--------------------------------------------SSS--------------------------------------------------------------------------------------------SSS-------------
----------------------------------U----!--------------------------------###--------------------------------------------U----!---------------------------------###----------------------------------------
------------------------------------------g----------------------------####--------------g-------------------------------------------------------------------####-----------------------g----------------
----------------------------------------------------------------------#####-----------------------------------------------------SSS-------------------------#####----------------------------------------
--------##---C--------------tt-----------@S---------tt----S----------######-------------@S------------------------!--!-------------------------------------######----------------C-----@S--------------##
-------###------------------tt----------------------tt--------------#######-------------------------------#-----------------------------------------------#######-------------------------------------###
------####------------------tt----------------------tt----------tt-########-------tt---------tt-------tt-##-------------------------------------------tt-########---------------------------tt-------####
-M---#####----g-g--------k--g---------gg------------k-----------tt#########-------tt---------tt-------tt###----------------gg-------k--------g----t---tt#########-----------------g-g-------tt------#####
XXXXXXXXXXXXXXXXXXXXXXXXXXXXXXXXXXXXXXXXXXXXXXXXXXXXXXXXXXXXXXXXXXXXXXXXXXXXXXXXXXXXXXXXXXXXXXXXXXXXXXXXXXXXXXXXXXXXXXXXXXXXXXXXXXXXXXXXXXXXXXXXXXXXXXXXXXXXXXXXXXXXXXXXXXXXXXXXXXXXXXXXXXXXXXXXXXXXXXXXX
XXXXXXXXXXXXXXXXXXXXXXXXXXXXXXXXXXXXXXXXXXXXXXXXXXXXXXXXXXXXXXXXXXXXXXXXXXXXXXXXXXXXXXXXXXXXXXXXXXXXXXXXXXXXXXXXXXXXXXXXXXXXXXXXXXXXXXXXXXXXXXXXXXXXXXXXXXXXXXXXXXXXXXXXXXXXXXXXXXXXXXXXXXXXXXXXXXXXXXXXX
