----------------------------------------------------------------------------------------------------------------------------------------------------------------------------------------------------
----------------------------------------------------------------------------------------------------------------------------------------------------------------------------------------------------
----------------------------------------------------------------------------------------------------------------------------------------------------------------------------------------------------
----------------------------------------------------------------------------------------------------------------------------------------------------------------------------------------------------
----------------------------------------------------------------------------------------------------------------------------------------------------------------------------------------------------
----------------------------------------------------------------------------------------------------------------------------------------------------------------------------------------------------
-----------------------------------------------------------------------------------------------------------------------------------------------SSS-----------------------------------------------SSS
-----------------------------------------------------------------------------------------------------------------------------------###--------------------------------------------------------------
----------------------------------------------------------------------------------------------------------------------------------####--------g-------------------------------------------------g---
----------------------------------------------------------------------SSS--------------------------------------------------------#####--------------------------------------------------------------
--------S@S!S-----S----SS---#-------S@S!S---C--------S-------------------------SS------#--#-------------C----------##-----------######-------@S----------------------------U----!------------##@S---
----------------------------##--------------------------------------------------------##--##----------------------###-----------######----------------------tt------------------------------###-----
----------------------------###------------------------------------------------------###--###--------------------####-----------######----------------------tt------tt---------------------####-----
-M-g----t------------g-g----####--g----------g-g---------g-g--------------k--g-g----####--####-----------g-g----#####g----t-g-g-######---------------gg-----tt-t----tt----------k--t------#####-----
XXXXXXXXXXXXXXXXXXXXXXXXXXXXXXXXXXXXXXXXXXXXXXXXXXXXXXXXXXXXXXXXXXXXXXXXXXXXXXXXXXXXXXXXXXXXXXXXXXXXXXXXXXXXXXXXXXXXXXXXXXXXXXXXXXXXXXXXXXXXXXXXXXXXXXXXXXXXXXXXXXXXXXXXXXXXXXXXXXXXXXXXXXXXXXXXXXXX
XXXXXXXXXXXXXXXXXXXXXXXXXXXXXXXXXXXXXXXXXXXXXXXXXXXXXXXXXXXXXXXXXXXXXXXXXXXXXXXXXXXX------XXXXXXXXXXXXXXXXXXXXXXXXXXXXXXXXXXXXXXXXXXXXXXXXXXXXXXXXXXXXXXXXXXXXXXXXXXXXXXXXXXXXXXXXXXXXXXXXXXXXXXXXXX
