---------------------------------------------------------------------------------------------------------------------------------------------------------------------------------------------------------
---------------------------------------------------------------------------------------------------------------------------------------------------------------------------------------------------------
---------------------------------------------------------------------------------------------------------------------------------------------------------------------------------------------------------
---------------------------------------------------------------------------------------------------------------------------------------------------------------------------------------------------------
---------------------------------------------------------------------------------------------------------------------------------------------------------------------------------------------------------
---------------------------------------------------------------------------------------------------------------------------------------------------------------------------------------------------------
------------------------------------------------------------SSS--------SSS-------------------------------------------------------------------------------------------------SSS---------SSS---------------
---------------------------------------------------------------------------------------------------------------------------------------S@S!S-------------------------------------------------------------
-----------------------------------------------------------g----------g---------------------------------------------------------------------------------------------------g-----------g------------------
---------------------------------------------------------------------------------------------------------------------------------------------------------------------------------------------------------
-----------SS------#--#-------SS------#--#-------------tt-@S---------@S-----SS---#--------C----------------S--!--!-----------------S-----------S---------tt--------C-----@S----------@S------C-----!--!--
------------------##--##-------------##--##------------tt------------------------##----------------------------------------------------------------------tt-----------------------tt---------------------
-----------------###--###-----------###--###-----------tt------------------------###---------------------------------------------------------------------tt-----------------------tt---------------------
-M-g----tg-g----####--####--g-g----####--####-------g----t-----g----t-----g-g----####------g-g-------------------------gg----------------gg-----------tt-g----------g-g-----------tt----------g-g--------
XXXXXXXXXXXXXXXXXXXXXXXXXXXXXXXXXXXXXXXXXXXXXXXXXXXXXXXXXXXXXXXXXXXXXXXXXXXXXXXXXXXXXXXXXXXXXXXXXXX---XXXXXXXXXXXXXXXXXXXXXXXXXXXXXXXXXXXXXXXXXXXXXXXXXXXXXXXXXXXXXXXXXXXXXXXXXXXXXXXXXXXXXXXXXXXXXXXXXXX
XXXXXXXXXXXXXXXX------XXXXXXXXXXXXX------XXXXXXXXXXXXXXXXXXXXXXXXXXXXXXXXXXXXXXXXXXXXXXXXXXXXXXXXXX---XXXXXXXXXXXXXXXXXXXXXXXXXXXXXXXXXXXXXXXXXXXXXXXXXXXXXXXXXXXXXXXXXXXXXXXXXXXXXXXXXXXXXXXXXXXXXXXXXXX
