----------------------------------------------------------------------------------------------------------------------------------------------------------------------------------
----------------------------------------------------------------------------------------------------------------------------------------------------------------------------------
----------------------------------------------------------------------------------------------------------------------------------------------------------------------------------
----------------------------------------------------------------------------------------------------------------------------------------------------------------------------------
----------------------------------------------------------------------------------------------------------------------------------------------------------------------------------
----------------------------------------------------------------------------------------------------------------------------------------------------------------------------------
-----SSS-----------------------------------------------------------------------------SSS--------------------------------SSS--------------SSS--------------------------------------
-------------------------------------------------U----!---------------------------------------------------------------------------------------------------------------------------
----g-------------------------------------------------------------------------------g----------------------------------g----------------------------------------------------------
------------------------------------------------------------------------------------------------------------S---------------------------------------------------------------------
---@S-----------------------------------------------S---U----!---------------------@S-----SS------#--#-------U----!---@S----------------------------##-----------------------SS---
---------------------------#----------------------------------------------------tt---------------##--##--------------------------tt----------------###----------------------------
-----------------------tt-##----------------------------------------------------tt--------------###--###-------------------------tt---------------####----------------------------
-M-------g-g-----------tt###-------g----t--------------------k---g-g------------tt------g-g----####--####--g----tt---------g-----tt-t-------gg---#####------g--------------g-g----
XXXXXXXXXXXXXXXXXXXXXXXXXXXXXXXXXXXXXXXXXXXX---XXXXXXXXXXXXXXXXXXXXXXXXXXXXXXXXXXXXXXXXXXXXXXXXXXXXXXXXXXXXXXXXXXXXXXXXXXXXXXXXXXXXXXXXXXXXXXXXXXXXXXXXXXXXXXXXXXXXXXX---XXXXXXXXX
XXXXXXXXXXXXXXXXXXXXXXXXXXXXXXXXXXXXXXXXXXXX---XXXXXXXXXXXXXXXXXXXXXXXXXXXXXXXXXXXXXXXXXXXXXXXX------XXXXXXXXXXXXXXXXXXXXXXXXXXXXXXXXXXXXXXXXXXXXXXXXXXXXXXXXXXXXXXXXX---XXXXXXXXX
