----------------------------------------------------------------------------------------------------------------------------------------------------------------------------------------------------------
----------------------------------------------------------------------------------------------------------------------------------------------------------------------------------------------------------
----------------------------------------------------------------------------------------------------------------------------------------------------------------------------------------------------------
----------------------------------------------------------------------------------------------------------------------------------------------------------------------------------------------------------
----------------------------------------------------------------------------------------------------------------------------------------------------------------------------------------------------------
----------------------------------------------------------------------------------------------------------------------------------------------------------------------------------------------------------
-----SSS-----------------------------------------------SSS------------------------------------SSS--------------SSS----------------------------------------------------------------------------------------
-------------------------------------------------------------------------------S@S!S-------------------------------------------------------------------------------SS!S--------------###------------------
----g-------------------------------------------------g--------------------------------------g----------------g---------------------------------------------------------------------####------------------
---------------------------------------------SSS-----------------------------------------------------------------------------------------------------------------------------------#####------------------
---@S------------------------------------------------@S-------------------------------------@S---------!--!--@S---------------C--------S-----C----------------S@S!S---------------######------------------
------------tt--------#---------------------------------------tt-----------tt----------------------------------------------------------------------------------------------------#######-----------tt-----
------------tt----tt-##---------------------------------------tt-----------tt------------------------------------------------------------------------------------------------tt-########-----------tt-----
-M----------tt----tt###--------g-g--------tt----t-------------tt-g----t----tt----gg-------------------------------------k------g-g------------g-g----------------k-----gg----tt#########-----------tt-----
XXXXXXXXXXXXXXXXXXXXXXXXXXXXXXXXXXXXXXXXXXXXXXXXXXXXXXXXXXXXXXXXXXXXXXXXXXXXXXXXXXXXXXX---XXXXXXXXXXXXXXXXXXXXXXXXXXXXXXXXXXXXXXXXXXXXXXXXXXXXXXXXXXXX---XXXXXXXXXXXXXXXXXXXXXXXXXXXXXXXXXXXXXXXXXXXXXXXX-
XXXXXXXXXXXXXXXXXXXXXXXXXXXXXXXXXXXXXXXXXXXXXXXXXXXXXXXXXXXXXXXXXXXXXXXXXXXXXXXXXXXXXXX---XXXXXXXXXXXXXXXXXXXXXXXXXXXXXXXXXXXXXXXXXXXXXXXXXXXXXXXXXXXX---XXXXXXXXXXXXXXXXXXXXXXXXXXXXXXXXXXXXXXXXXXXXXXXX-
