--------------------------------------------------------------------------------------------------------------------------------------------------------------------------------------------
--------------------------------------------------------------------------------------------------------------------------------------------------------------------------------------------
--------------------------------------------------------------------------------------------------------------------------------------------------------------------------------------------
--------------------------------------------------------------------------------------------------------------------------------------------------------------------------------------------
--------------------------------------------------------------------------------------------------------------------------------------------------------------------------------------------
--------------------------------------------------------------------------------------------------------------------------------------------------------------------------------------------
--------------------------------------------------------------------------------------------------------------------------------------------------------------------------------------------
---------------------------tt-----------------------------------------------------------------S@S!S-------------------------------------------------------###---------tt-------------###----
---------------------------tt----------------------------------------------------------------------------------------------------------------------------####---------tt------------####----
---------------------------tt---------------------------------------------------------------------------------------------------------------------------#####---------tt-----------#####----
-----------SS---#--------S-----C------SS!S--------------------C-----------S@S!S---!--!---------------SS------#--#-------SS---#--------------C----------######---------------------######tt--
----------------##------------------------------------------------------------------------------------------##--##-----------##------------------------######--------------------#######tt--
----------------###----------------------------------------------------------------------------------------###--###----------###---tt------------------######----------------tt-########tt--
-M-------g-g----####------------g-g-------t-----g-g------------g-g--------k--t----------t-------gg-g-g----####--####--g-g----####--tt--------g-g---g-g-######----------gg----tt#########tt--
XXXXXXXXXXXXXXXXXXXXXXXXXXXXXXXXXXXXXXXXXXXXXXXXXXXXXXXXXXXXXXXXXXXXXXXXXXXXXXXXXXXXXXXXXXXXXXXXXXXXXXXXXXXXXXXXXXXXXXXXXXXXXXXXXXXXXXXXXXXXXXXXXXXXXXXXXXXXXXXXXXXXXXXXXXXXXXXXXXXXXXXXXXXX
XXXXXXXXXXXXXXXXXXXXXXXXXXXXXXXXXXXXXXXXXXXXXXXXXXXXXXXXXXXXXXXXXXXXXXXXXXXXXXXXXXXXXXXXXXXXXXXXXXXXXXXXXX------XXXXXXXXXXXXXXXXXXXXXXXXXXXXXXXXXXXXXXXXXXXXXXXXXXXXXXXXXXXXXXXXXXXXXXXXXXXX
