-----------------------------------------------------------------------------------------------------------------------------------------------------------------------------------------------
-----------------------------------------------------------------------------------------------------------------------------------------------------------------------------------------------
-----------------------------------------------------------------------------------------------------------------------------------------------------------------------------------------------
-----------------------------------------------------------------------------------------------------------------------------------------------------------------------------------------------
-----------------------------------------------------------------------------------------------------------------------------------------------------------------------------------------------
-----------------------------------------------------------------------------------------------------------------------------------------------------------------------------------------------
-----SSS-----------------------------------------------------------------------------------------------------------------------SSS--------------SSS--------------------------------------------
----------------------###----------------------------------------------------------------------------------------------------------------------------------------------------------------------
----g----------------####-----------------------------------------------------------------------------------------------------g----------------g-----------------------------------------------
--------------------#####------------------------------SSS-------------------------------------------------------------------------------------------------------------------------------------
---@S--------------######-------------!--!-----C---------------------------------------------##---------------S--!--!-----tt-@S--------##-----@S--------U----!---------C-U----!-----SS---#-----
-------------------######-------------------------------------------------------------------###---------------------------tt----------###------------------------------------------------##----
--------tt---------######------------------------------------------------------------------####---------------------------tt---------####------------------------------------------------###---
-M------tt-----g-g-######-------g----t----------g-g--------k----------g----t-g-g----------#####-g-g---------------------------------#####---------------g----t----------g-g--t----g-g----####--
XXXXXXXXXXXXXXXXXXXXXXXXXXXXXXXXXXXXXXXXXXXXXXXXXXXXXXXXXXXXXXXXX---XXXXXXXXXXXXXXXXXXXXXXXXXXXXXXXXXXXXXXXXXXXXXXXXXXXXXXXXXXXXXXXXXXXXXXXXXXXXXXXXXXXXXXXXXXXXXXXXXXXXXXXXXXXXXXXXXXXXXXXXXXX
XXXXXXXXXXXXXXXXXXXXXXXXXXXXXXXXXXXXXXXXXXXXXXXXXXXXXXXXXXXXXXXXX---XXXXXXXXXXXXXXXXXXXXXXXXXXXXXXXXXXXXXXXXXXXXXXXXXXXXXXXXXXXXXXXXXXXXXXXXXXXXXXXXXXXXXXXXXXXXXXXXXXXXXXXXXXXXXXXXXXXXXXXXXXX
