----------------------------------------------------------------------------------------------------------------------------------------------------------------------------------------
----------------------------------------------------------------------------------------------------------------------------------------------------------------------------------------
----------------------------------------------------------------------------------------------------------------------------------------------------------------------------------------
----------------------------------------------------------------------------------------------------------------------------------------------------------------------------------------
----------------------------------------------------------------------------------------------------------------------------------------------------------------------------------------
----------------------------------------------------------------------------------------------------------------------------------------------------------------------------------------
---------------------------------------------------------------------------------------------------SSS--------SSS------------------------------------------SSS--------------------------
---------------------------------------------------C-----------------------------------------------------------------------------------------------------------------------------S------
--------------------------------------------------------------------------------------------------g----------g--------------------------------------------g-----------------------------
------------------------------------------------------------tt--------------------------------------------------------------------------------------------------------------------------
-----------SS!S-------S-----------------------------g-g-----tt------------------##----------tt---@S---!--!--@S-------------------------------------------@S---------------##---S--!--!--
-------tt---------------------------------------XXXXXXXXXXXXXX----tt-----------###----------tt--------------------------------------tt-----------------------------------###------------
-------tt----------------------------------tt---XXXXXXXXXXXXXX----tt-tt-------####----------tt----------------------------tt--------tt-------------tt-------------------####------------
-M-----tt-------k--------------------------tt----------g----------tt-tt------#####---gg-------k------------------------k--tt--------tt--g-g--------tt---------g--------#####------------
XXXXXXXXXXXXXXXXXXXXXXXXXXXXXXXXX---XXXXXXXXXXXXXXXXXXXXXXXXXXXXXXXXXXXXXXXXXXXXXXXXXXXXXXXXXXXXXXXXXXXXXXXXXXXXXXXXXXXXXXXXXXXXXXXXXXXXXXXXXXXXXXXXXXXXXXXXXXXXXXXXXXXXXXXXXXXXXXXXXXXX
XXXXXXXXXXXXXXXXXXXXXXXXXXXXXXXXX---XXXXXXXXXXXXXXXXXXXXXXXXXXXXXXXXXXXXXXXXXXXXXXXXXXXXXXXXXXXXXXXXXXXXXXXXXXXXXXXXXXXXXXXXXXXXXXXXXXXXXXXXXXXXXXXXXXXXXXXXXXXXXXXXXXXXXXXXXXXXXXXXXXXX
