----------------------------------------------------------------------------------------------------------------------------------------------------------------------------------------------------
----------------------------------------------------------------------------------------------------------------------------------------------------------------------------------------------------
----------------------------------------------------------------------------------------------------------------------------------------------------------------------------------------------------
----------------------------------------------------------------------------------------------------------------------------------------------------------------------------------------------------
----------------------------------------------------------------------------------------------------------------------------------------------------------------------------------------------------
----------------------------------------------------------------------------------------------------------------------------------------------------------------------------------------------------
-----------------------------------------SSS-----------------------------------------------------------SSS------------------------------------------------------------------------------------------
------------------------------------------------------###-------------------------------------------------------------------------------------------------------------------------------------------
-----------------------------------------------------####---------------------------------------------g---------------------------------------------------------------------------------------------
----------------------------------------------------#####-------------------------------------------------------------------------------------------------------------------------------------------
--------##---------------------------------S-------######-----------------------##------tt-----!--!--@S---!--!-------------tt----!-----------------------------------------C-----------!--!---------
-------###-----------------------------------------######----------------------###------tt---------------------------------tt-----------tt-------------------------------------------------------tt-
------####------------tt---------------------------######------------tt-------####tt----tt---------------------------------tt-----------tt------------------------tt-----------------------------tt-
-M---#####-g-g--------tt-----g-g---------------g-g-######------------tt------#####tt----g----------------------------------k------------tt--g-g-------------------tt--------g-g------------------tt-
XXXXXXXXXXXXXXXXXXXXXXXXXXXXXXXXXXXXXXXXXXXXXXXXXXXXXXXXXXXXXXXXXXXXXXXXXXXXXXXXXXXXXXXXXXXXXXXXXXXXXXXXXXXXXXXXXXXXXXXXXXXXXXXXXXXXXXXXXXXXXXXXXXXXXXXXXXXXXXXXXXXXXXXXXXXXXXXXXXXXXXXXXXXXXXXXXXXX
XXXXXXXXXXXXXXXXXXXXXXXXXXXXXXXXXXXXXXXXXXXXXXXXXXXXXXXXXXXXXXXXXXXXXXXXXXXXXXXXXXXXXXXXXXXXXXXXXXXXXXXXXXXXXXXXXXXXXXXXXXXXXXXXXXXXXXXXXXXXXXXXXXXXXXXXXXXXXXXXXXXXXXXXXXXXXXXXXXXXXXXXXXXXXXXXXXXX
