----------------------------------------------------------------------------------------------------------------------------------------------------------------------------------------------------------
----------------------------------------------------------------------------------------------------------------------------------------------------------------------------------------------------------
----------------------------------------------------------------------------------------------------------------------------------------------------------------------------------------------------------
----------------------------------------------------------------------------------------------------------------------------------------------------------------------------------------------------------
----------------------------------------------------------------------------------------------------------------------------------------------------------------------------------------------------------
----------------------------------------------------------------------------------------------------------------------------------------------------------------------------------------------------------
-------------------------------------------------------SSS-----------------------------------------------------------------------------------SSS----------------------------------------------------------
----------------------------------------------------------------------------------------------S@S!S----------------------###------------------------------------------------------------------------------
------------------------------------------------------g-----------------------------------------------------------------####----------------g-------------------------------------------------------------
-----------------------------------------------------------------------------------------------------------------------#####------------------------------------------------------------------------------
--------##!--!---------------------------------------@S-------------------##---S--SS!S--------------------------------######---------------@S------C---------------------##--------------SS---#-----------
-------###---------------------------------------------------------------###------------------------------------------######--------------------------------------------###----tt-------------##----------
------####-----------------------------tt-------------------------------####-----------------------tt-----------------######-------------------------------------------####----tt-------------###------tt-
-M---#####-------g-g-------------------tt------------------------------#####------g----t--------gg-tt-------------g-g-######------------------------g-g--g----t-------#####----tt------g-g----####-----tt#
XXXXXXXXXXXXXXXXXXXXXXXXXXXXXXXXXXXXXXXXXXXXXXXX---XXXXXXXXXXXXXXXXXXXXXXXXXXXXXXXXXXXXXXXXXXXXXXXXXXXXXXXXX---XXXXXXXXXXXXXXXXXXXXXXX---XXXXXXXXXXXXXXXXXXXXXXXXXXXXXXXXXXXXXXXXXXXXXXXXXXXXXXXXXXXXXXXXX
XXXXXXXXXXXXXXXXXXXXXXXXXXXXXXXXXXXXXXXXXXXXXXXX---XXXXXXXXXXXXXXXXXXXXXXXXXXXXXXXXXXXXXXXXXXXXXXXXXXXXXXXXX---XXXXXXXXXXXXXXXXXXXXXXX---XXXXXXXXXXXXXXXXXXXXXXXXXXXXXXXXXXXXXXXXXXXXXXXXXXXXXXXXXXXXXXXXX
