----------------------------------------------------------------------------------------------------------------------------------------------------------------------------------------------------------
----------------------------------------------------------------------------------------------------------------------------------------------------------------------------------------------------------
----------------------------------------------------------------------------------------------------------------------------------------------------------------------------------------------------------
----------------------------------------------------------------------------------------------------------------------------------------------------------------------------------------------------------
----------------------------------------------------------------------------------------------------------------------------------------------------------------------------------------------------------
----------------------------------------------------------------------------------------------------------------------------------------------------------------------------------------------------------
-----------------------------------------------------------------SSS--------------SSS-----------------------------------SS--------------------------------------------------------------------------------
--------------------###--------------------------------------------------U----!-----------------------------###-----------U----!--------------------------------------------------------------------------
-------------------####-----------------------------------------g----------------g-------------------------####--------g----------------------------------------------------------------------------------
------------------#####-----------------------------------------------------------------------------------#####-------------------------------------------------------------------------------------------
------C----------######-------!--!-------------U----!----------@S---------------@S-----------------------######-------@S---------------------------##--------!--!-----C------------------------##---------
-----------------######---------------------------------------------------------------------------------#######----------------------tt-----------###-----------------------------------------###---------
-----------------######-----------------------------------------------------------------------------tt-########----------------------tt----------####-----------------------tt---------------####---------
-M-----g-g---g-g-######---------------------------g------g----t--------------gg---------------------tt#########---------------gg-----tt---------#####------------------g-g--tt--------------#####---------
XXXXXXXXXXXXXXXXXXXXXXXXXXXXXXXXXXXXXXXXXXXXX---XXXXXXXXXXXXXXXXXXXXXXXXXXXXXXXXXXXXXXXXXXXXXXXXXXXXXXXXXXXXXXXXXXXXXXXXXXXXXXXXXXXXXXXXXXXXXXXXXXXXXXXX---XXXXXXXXXXXXXXXXXXXXXXXXXX---XXXXXXXXXXXX---XXX
XXXXXXXXXXXXXXXXXXXXXXXXXXXXXXXXXXXXXXXXXXXXX---XXXXXXXXXXXXXXXXXXXXXXXXXXXXXXXXXXXXXXXXXXXXXXXXXXXXXXXXXXXXXXXXXXXXXXXXXXXXXXXXXXXXXXXXXXXXXXXXXXXXXXXX---XXXXXXXXXXXXXXXXXXXXXXXXXX---XXXXXXXXXXXX---XXX
