------------------------------------------------------------------------------------------------------------------------------------------------------------------------------------------------------
------------------------------------------------------------------------------------------------------------------------------------------------------------------------------------------------------
------------------------------------------------------------------------------------------------------------------------------------------------------------------------------------------------------
------------------------------------------------------------------------------------------------------------------------------------------------------------------------------------------------------
------------------------------------------------------------------------------------------------------------------------------------------------------------------------------------------------------
------------------------------------------------------------------------------------------------------------------------------------------------------------------------------------------------------
----------SSS-------------------------------------------------------------SSS-------------------------------------------------------------------------------------------------------------------------
---------------------###--------S@S!S------------------------------------------------------------------------###--------------------------------------------------------------------------------------
---------g----------####------------------------------------------------------------------------------------####--------------------------------------------------------------------------------------
-------------------#####-----------------------------------------------------------------------------------#####--------------------------------------------------------------------------------------
--------@S--------######-------------------------------C----------------##-------U----!-----C-------------######---------------------S@S----tt--------------------------------------------C-----------
------------------######--------------------#--------------------------###-------------------------------#######----------------------------tt--------------------------------------------------------
------------------######----------------tt-##-------------------------####---------------------------tt-########----------------------------tt--------------------------------------------------------
-M------------g-g-######----------gg----tt###-----------g-g----------#####---gg-------k------g-g-----tt#########--------------------t----g----t--------g----t---gg---------------g----t----g-g--------
XXXXXXXXXXXXXXXXXXXXXXXXXXXXXXXXXXXXXXXXXXXXXXXXXXXXXXXXXXXXXXXXXXXXXXXXXXXXXXXXXXXXXXXXXXXXXXXXXXXXXXXXXXXXXXXXXXXXXXXXXXXXXXX---XXXXXXXXXXXXXXXX---XXXXXXXXXXXXXXXXX---XXXXXXXXXXXXXXXXXXXXXXXXXXXXX
XXXXXXXXXXXXXXXXXXXXXXXXXXXXXXXXXXXXXXXXXXXXXXXXXXXXXXXXXXXXXXXXXXXXXXXXXXXXXXXXXXXXXXXXXXXXXXXXXXXXXXXXXXXXXXXXXXXXXXXXXXXXXXX---XXXXXXXXXXXXXXXX---XXXXXXXXXXXXXXXXX---XXXXXXXXXXXXXXXXXXXXXXXXXXXXX
