------------------------------------------------------------------------------------------------------------------------------------------------------------------------------------------------
------------------------------------------------------------------------------------------------------------------------------------------------------------------------------------------------
------------------------------------------------------------------------------------------------------------------------------------------------------------------------------------------------
------------------------------------------------------------------------------------------------------------------------------------------------------------------------------------------------
------------------------------------------------------------------------------------------------------------------------------------------------------------------------------------------------
------------------------------------------------------------------------------------------------------------------------------------------------------------------------------------------------
------------------------------------------------------------------------------------------------------------------------------------------------------------------------------------------------
--------------------------------------------------------------U----------------------------------------------------------------------------------###--------------------tt---#---------------###
------------------------------------------------------------------------------------------------------------------------------------------------####--------------------tt---##-------------####
-----------------------------------------------------------------------------------------------------------------------------------------------#####--------------------tt---###-----------#####
-------------------SS---#---------------------------------------------S@S!S-SS------#--#----------##--SS---#--------C-------------------------######-------------------------####---------######
------------------------##-----------------------#---------------------------------##--##--------###-------##--------------------------------#######-----------------XXXXXX--XXXXXX-------######
------------------------###------------------tt-##--------------------------------###--###------####-------###------------------tt-------tt-########-----------------XXXXXX--XXXXXX-------######
-M---------------g-g----####---g-g-----------tt###----------------gg-t----g-g----####--####----#####g-g----####------g-g--------tt-------tt#########---------------------t----g-------g-g-######
XXXXXXXXXXXX---XXXXXXXXXXXXXXXXXXXXXXXXXXXXXXXXXXXXXXXXXXXXXXXXXXXXXXXXXXXXXXXXXXXXXXXXXXXXXXXXXXXXXXXXXXXXXXXXXXXXXXXXXXXXXXXXXXXXXXXXXXXXXXXXXXXXXXXXXXXXXXX---XXXXXXXXXXXXXXXXXXXXXXXXXXXXXXX
XXXXXXXXXXXX---XXXXXXXXXXXXXXXXXXXXXXXXXXXXXXXXXXXXXXXXXXXXXXXXXXXXXXXXXXXXXXXXXX------XXXXXXXXXXXXXXXXXXXXXXXXXXXXXXXXXXXXXXXXXXXXXXXXXXXXXXXXXXXXXXXXXXXXXXX---XXXXXXXXXXXXXXXXXXXXXXXXXXXXXXX
