--------------------------------------------------------------------------------------------------------------------------------------------------------------------------------------------------------
--------------------------------------------------------------------------------------------------------------------------------------------------------------------------------------------------------
--------------------------------------------------------------------------------------------------------------------------------------------------------------------------------------------------------
--------------------------------------------------------------------------------------------------------------------------------------------------------------------------------------------------------
--------------------------------------------------------------------------------------------------------------------------------------------------------------------------------------------------------
--------------------------------------------------------------------------------------------------------------------------------------------------------------------------------------------------------
---------------------------------------------------SSS--------------------------------------------------------------------------------------------------------------SSS---------------------------------
-----------------------------------------------------------------###-----------------------------###----------------------------------------------------------------------------------------------------
--------------------------------------------------g-------------####----------------------------####---------------------------------------------------------------g------------------------------------
---------------------------------------------------------------#####---------------------------#####-------------------------------------------------------------------------SSS------------------------
--------------------##----------------------S@S!S-S-----------######--------------------------######------------S@S!S---------------!--!-------##---C-------------@S-------------------SS------#--#-----
-------------------###------------tt-------------------------#######-------------------------#######------------------------------------------###---------------------------------------------##--##----
---tt-------------####------------tt---------------------tt-########------------tt-------tt-########-----------------------------------------####--------------------------------------------###--###---
-M-tt----g----t--#####------------tt-t----g--------------tt#########------------tt-------tt#########-------------g--------------------------#####----g-g---------------g-g------t----g-g----####--####--
XXXXXXXXXXXXXXXXXXXXXXXXX---XXXXXXXXXXXXXXXXXXXXXXXXXXXXXXXXXXXXXXXXXXXXXXXXXXXXXXXXXXXXXXXXXXXXXXXXXXXXXXXXXXXXXXXXXXXXXXXXXXXXXXXXXXXXXXXXXXXXXXXXXXXXXXXXX---XXXXXXXXXXXXXXXXXXXXXXXXXXXXXXXXXXXXXXXX
XXXXXXXXXXXXXXXXXXXXXXXXX---XXXXXXXXXXXXXXXXXXXXXXXXXXXXXXXXXXXXXXXXXXXXXXXXXXXXXXXXXXXXXXXXXXXXXXXXXXXXXXXXXXXXXXXXXXXXXXXXXXXXXXXXXXXXXXXXXXXXXXXXXXXXXXXXX---XXXXXXXXXXXXXXXXXXXXXXXXXXXX------XXXXXX
