-------------------------------------------------------------------------------------------------------------------------------------------------------------------------
-------------------------------------------------------------------------------------------------------------------------------------------------------------------------
-------------------------------------------------------------------------------------------------------------------------------------------------------------------------
-------------------------------------------------------------------------------------------------------------------------------------------------------------------------
-------------------------------------------------------------------------------------------------------------------------------------------------------------------------
-------------------------------------------------------------------------------------------------------------------------------------------------------------------------
------------SSS-----------------------------------------------------------------------------------------------------------------------------------SSS-----------SSS------
-----------------------###----------------------------------------------------------------------###----------------------------------------------------------------------
-----------g----------####---------------------------------------------------------------------####------------------------------------------------------------g---------
-SSS-----------------#####--------------------------------------------------------------------#####----------------------------------------------------------------------
----------@S--------######--------------------!--!--------S@S!S-S------#--#------------------######---------------tt--------------U----!-----S@S!S------------@S---------
--------------------######-----------tt-------------------------------##--##-----------------######---------------tt-----------------------------------------------------
--------------------######-----------tt------------------------------###--###----------------######---------------tt-----------------------------------------------------
-M-g------------g-g-######-----------tt-------------------k--g-g----####--####-----------g-g-######------------g----t-----------g----tt----g---------gg-g----t-----g----t
XXXXXXXXXXXXXXXXXXXXXXXXXXXXXXXXXXXXXXXXXXXXXXXXXXXXXXXXXXXXXXXXXXXXXXXXXXXXXXXXXXX---XXXXXXXXXXXXXXXXXXXXXXXXXXXXXXXXXXXXXXXXXXXXXXXXXXXXXXXXXXXXXXXXXXXXXXXXXXXXXXXXXXX
XXXXXXXXXXXXXXXXXXXXXXXXXXXXXXXXXXXXXXXXXXXXXXXXXXXXXXXXXXXXXXXXXXXX------XXXXXXXXX---XXXXXXXXXXXXXXXXXXXXXXXXXXXXXXXXXXXXXXXXXXXXXXXXXXXXXXXXXXXXXXXXXXXXXXXXXXXXXXXXXXX
