-----------------------------------------------------------------------------------------------------------------------------------------------------------------------------------------
-----------------------------------------------------------------------------------------------------------------------------------------------------------------------------------------
-----------------------------------------------------------------------------------------------------------------------------------------------------------------------------------------
-----------------------------------------------------------------------------------------------------------------------------------------------------------------------------------------
-----------------------------------------------------------------------------------------------------------------------------------------------------------------------------------------
-----------------------------------------------------------------------------------------------------------------------------------------------------------------------------------------
-----SSS--------------------------------------------------------------------------------------------------------SSS---------------------------------------------SSS-------------------SSS
-----------------------------------------------------------------------------------------------------###---------------------------------------------------------------------------------
----g-----------------------------------------------------------------------------------------------####-------------------------------------------------------g---------------------g---
-----------SSS------------------------------------------------SSS----------------------------------#####--------------------------------------------------------------------SSS----------
---@S-------------!-----C---------tt-----SS---#----------##---------------C---------------S-------######----------S-------------##-U----!-------------------##@S--------------------@S---
----------------------------------tt----------##--------###---------------------------------------######-----------------------###-------------------------###---------------------------
----------------------------------tt----------###------####---------------------------------------######----------------------####------------------------####---------------------------
-M------g----------------g-g--------k--g-g----####----#####g---------------g-g--g-------------g-g-######---------------------#####------k---g-g----------#####------g-g--------t---------
XXXXXXXXXXXXXXXXXXXXXXXXXXXXXXXXXXXXXXXXXXXXXXXXXXXXXXXXXXXXXXXXXXXXXXXXXXXXXXXXXXXXXXXXXXXXXXXXXXXXXXXXXXXXXXXXXXXXXXXXXXXXXXXXXXXXXXXXXXXXXXXXXXXXXXXXXXXXXXXXXXXXXXXXXXXXXXXXXXXXXXXXX
XXXXXXXXXXXXXXXXXXXXXXXXXXXXXXXXXXXXXXXXXXXXXXXXXXXXXXXXXXXXXXXXXXXXXXXXXXXXXXXXXXXXXXXXXXXXXXXXXXXXXXXXXXXXXXXXXXXXXXXXXXXXXXXXXXXXXXXXXXXXXXXXXXXXXXXXXXXXXXXXXXXXXXXXXXXXXXXXXXXXXXXXX
