----------------------------------------------------------------------------------------------------------------------------------------------------------------------------------------
----------------------------------------------------------------------------------------------------------------------------------------------------------------------------------------
----------------------------------------------------------------------------------------------------------------------------------------------------------------------------------------
----------------------------------------------------------------------------------------------------------------------------------------------------------------------------------------
----------------------------------------------------------------------------------------------------------------------------------------------------------------------------------------
----------------------------------------------------------------------------------------------------------------------------------------------------------------------------------------
------------------------------------------------------------------------------------------------------------------------------------------------SSS-------------------------------------
----------------------------------------------------------------###------------------------------------------U----!---------------------------------------------------------------------
---------------------------------------------------------------####----------------------------------------------------------------------------g----------------------------------------
--------------------------------------------------------------#####--------------SS-----------------------------------------------------------------------------------------------------
-----------SS!S---------S----------U----!------!-------t-----######----------------!--!--------------------##---S----SS---#-------------------@S----------------SS------#--#------------
-------------------------------------------------------t-----######--------------------------tt-----------###-------------##-------------------------------------------##--##-----------
-------------------------------------------------------t-----######--------------------------tt-tt-------####-------------###-----------------------------------------###--###----------
-M-------t----g--------------------------------k---------g-g-######-------------k------------tt-tt------#####------g-g----####--------------------------------g-g----####--####--g------
XXXXXXXXXXXXXXXXXXXXXXXXXXXXXX---XXXXXXXXXXXXXXXXXXXXXXXXXXXXXXXXXXXXXXXXXXXXXXXXXXXXXXXXXXXXXXXXXXXXXXXXXXXXXXXXXXXXXXXXXXXXXXXXXX---XXXXXXXXXXXXXXXXXXXXXXXXXXXXXXXXXXXXXXXXXXXXXXXXXX
XXXXXXXXXXXXXXXXXXXXXXXXXXXXXX---XXXXXXXXXXXXXXXXXXXXXXXXXXXXXXXXXXXXXXXXXXXXXXXXXXXXXXXXXXXXXXXXXXXXXXXXXXXXXXXXXXXXXXXXXXXXXXXXXX---XXXXXXXXXXXXXXXXXXXXXXXXXXXXXXX------XXXXXXXXXXXXX
