------------------------------------------------------------------------------------------------------------------------------------------------------------------------------------
------------------------------------------------------------------------------------------------------------------------------------------------------------------------------------
------------------------------------------------------------------------------------------------------------------------------------------------------------------------------------
------------------------------------------------------------------------------------------------------------------------------------------------------------------------------------
------------------------------------------------------------------------------------------------------------------------------------------------------------------------------------
------------------------------------------------------------------------------------------------------------------------------------------------------------------------------------
--------------------------------------------------------------------------------------------------------------------------------SSS-------------------------------------------------
------------------------------------------------------------------------------------------------------------------------------------------------------------------------------------
-------------------------------------------------------------------------------------------------------------------------------g----------------------------------------------------
------------------------------------------------------------------------------------------------------SSS---------------------------------------------------------------------------
--------------#----tt------U----!------------SS---#-------SS---#--------S-------tt-----------##-------------------------------@S------------U----!---!--!-------##------!--!--------
-------------##----tt-----------------------------##-----------##---------------tt----------###----------------tt----------------------tt----------------------###------------------
------------###----tt-----------------------------###----------###--------------tt---------####tt--------------tt----------------------tt-tt------------------####------------------
-M---------#####--------------g------g----tg-g----####--g-g----####----------g----tt------#####tt--------------tt--g-g-----------------tt-tt----t------------#####------------------
XXXXXXXXXXXXXXXXXXXXXXXXX---XXXXXXXXXXXXXXXXXXXXXXXXXXXXXXXXXXXXXXXXXXXXXXXXXXXXXXXXXXXXXXXXXXXXXXXXXXXXXXXXXXXXXXXXXXXXXXXXXXXXXXXXXXXXXXXXXXXXXXXXXXXXXXXXXXXXXXXXXXXXXXXXXXXXXXXX
XXXXXXXXXXXXXXXXXXXXXXXXX---XXXXXXXXXXXXXXXXXXXXXXXXXXXXXXXXXXXXXXXXXXXXXXXXXXXXXXXXXXXXXXXXXXXXXXXXXXXXXXXXXXXXXXXXXXXXXXXXXXXXXXXXXXXXXXXXXXXXXXXXXXXXXXXXXXXXXXXXXXXXXXXXXXXXXXXX
