----------------------------------------------------------------------------------------------------------------------------------------------------------------------------------------------------------
----------------------------------------------------------------------------------------------------------------------------------------------------------------------------------------------------------
----------------------------------------------------------------------------------------------------------------------------------------------------------------------------------------------------------
----------------------------------------------------------------------------------------------------------------------------------------------------------------------------------------------------------
----------------------------------------------------------------------------------------------------------------------------------------------------------------------------------------------------------
----------------------------------------------------------------------------------------------------------------------------------------------------------------------------------------------------------
----------------------------------------------------------------------------------------------------------------------------------------------------------------------------------------------------------
-----------------------------------------------------------------------------------------------tt--------------------------------------------------------------------------###---------------###----------
-----------------------------------------------------------------------------------------------tt-------------------------------------------------------------------------####--------------####----------
-----------------------------------------------------------------------SSS---------------------tt------------------------------------------------------------------------#####-------------#####----------
----U----!----------SS------#--#--------S@S!S-------------------------------------SS---#----------------##----------------------------------------##--------------------######------------######----------
---------------------------##--##--------------------------#---------------------------##--------------###---------------------#-----------------###-------------------#######------------######----------
--------------------------###--###---------------------tt-##---------------------------###------------####-----------------tt-##----------------####---------------tt-########------------######----------
-M-------k--------g-g----####--####--------k-----------tt###----------gg-g------g-g----####-----gg---#####-----------------tt###-------g----t--#####-g-g-----------tt#########--------g-g-######----------
XXXXXXXXXXXXXXXXXXXXXXXXXXXXXXXXXXXXXXXXXXXXXXXXXXXXXXXXXXXXXXXXXXXXXXXXXXXXXXXXXXXXXXXXXXXXXXXXXXXXXXXXXXXXX---XXXXXXXXXXXXXXXXXXXXXXXXXXXXXXXXXXXXXXXXXXXXXXXXXXXXXXXXXXXXXXXXXXXXXXXXXXXXXXXXXXXXXXXXXX
XXXXXXXXXXXXXXXXXXXXXXXXX------XXXXXXXXXXXXXXXXXXXXXXXXXXXXXXXXXXXXXXXXXXXXXXXXXXXXXXXXXXXXXXXXXXXXXXXXXXXXXX---XXXXXXXXXXXXXXXXXXXXXXXXXXXXXXXXXXXXXXXXXXXXXXXXXXXXXXXXXXXXXXXXXXXXXXXXXXXXXXXXXXXXXXXXXX
