-----------------------------------------------------------------------------------------------------------------------------------------------------------------------------------------------
-----------------------------------------------------------------------------------------------------------------------------------------------------------------------------------------------
-----------------------------------------------------------------------------------------------------------------------------------------------------------------------------------------------
-----------------------------------------------------------------------------------------------------------------------------------------------------------------------------------------------
-----------------------------------------------------------------------------------------------------------------------------------------------------------------------------------------------
-----------------------------------------------------------------------------------------------------------------------------------------------------------------------------------------------
-----------------------------------------------------------------------------------------------------------------------------------------------------------------------------------------------
-----------------------------tt------------------------------------------------------------###--------------------------------###---------S@S!S------------------------------------------------
-----------------------------tt-----------------------------------------------------------####-------------------------------####--------------------------------------------------------------
-----------------------------tt--------------------------------------SSS-----------------#####------------------------------#####--------------------------------------------------------------
-------------------------##------!--!---------------------------------------------------######-------!--!------------------######----------S-----------------------!--!------------S@S!S--SS---
------------------------###-----------------------tt------------------------------------######-----------------------------######--------------------#-----------------------------------------
--------------tt-------####-----------------------tt-------------------------tt---------######-----------------------------######----------------tt-##-----------------------------------------
-M------------tt------#####---gg-------g----------tt----gg-g------------t----tt-----g-g-######-------------------t-----g-g-######----------------tt###---------------------------g------g-g----
XXXXXXXXXXXXXXXXXXXXXXXXXXXXXXXXXXXXXXXXXXXXXXXXXXXXXXXXXXXXXXXXXXXXXXXXXXXXXXXXXXXXXXXXXXXXXXXXXXXXXXXXXXXXXXXXXXXXXXXXXXXXXXXXXXXXXXXXXXXXXXXXXXXXXXXXXXXXXXXXXXXXXXXXXXXX---XXXXXXXXXXXXXXXX
XXXXXXXXXXXXXXXXXXXXXXXXXXXXXXXXXXXXXXXXXXXXXXXXXXXXXXXXXXXXXXXXXXXXXXXXXXXXXXXXXXXXXXXXXXXXXXXXXXXXXXXXXXXXXXXXXXXXXXXXXXXXXXXXXXXXXXXXXXXXXXXXXXXXXXXXXXXXXXXXXXXXXXXXXXXX---XXXXXXXXXXXXXXXX
