----------------------------------------------------------------------------------------------------------------------------------------------------------------------------------------------------------
----------------------------------------------------------------------------------------------------------------------------------------------------------------------------------------------------------
----------------------------------------------------------------------------------------------------------------------------------------------------------------------------------------------------------
----------------------------------------------------------------------------------------------------------------------------------------------------------------------------------------------------------
----------------------------------------------------------------------------------------------------------------------------------------------------------------------------------------------------------
----------------------------------------------------------------------------------------------------------------------------------------------------------------------------------------------------------
-----------------------------------------------------------------------------------------------------------------------------------------------------------------------------------------------------SSS--
-----------------------------------------------------------------------------------------------------------------------------U----!-----------------------------------------------------------------------
----------------------------------------------------------------------------------------------------------------------------------------------------------------------------------------------------g-----
----------------------------------------------------------------------------------------------------------------------------------------------------------------------------------------------------------
-----SS------#--#-------------SS------#--#-------------S@S!---S@S!S--------------------------------C-------SS---#----------##---S----SS---#--------C-------------------------##---------C----------@S-----
------------##--##-------------------##--##---------------------------------------------------------------------##--------###-------------##--------------------------------###---------------------------
-----------###--###-----------------###--###--------------------------------------------------------------------###------####-------------###------------------------------####tt-------------------------
-M-g-g----####--####--------g-g----####--####-----gg-g------------g------g----t------t--------------g-g--g-g----####----#####------g-g----####------g-g--g----t------k----#####tt--------g-g--t-----------
XXXXXXXXXXXXXXXXXXXXXXXXXXXXXXXXXXXXXXXXXXXXXXXXXXXXXXXXXXXXXXXXXXXXXXXXXXXXXXXXXXXXXXXXXXXXXXXXXXXXXXXXXXXXXXXXXXXXXXXXXXXXXXXXXXXXXXXXXXXXXXXXXXXXXXXXXXXXXXXXXXXXXXXXXXXXXXXXXXXXXXXXXXXXXXXXXXXXXXXXXX
XXXXXXXXXX------XXXXXXXXXXXXXXXXXXX------XXXXXXXXXXXXXXXXXXXXXXXXXXXXXXXXXXXXXXXXXXXXXXXXXXXXXXXXXXXXXXXXXXXXXXXXXXXXXXXXXXXXXXXXXXXXXXXXXXXXXXXXXXXXXXXXXXXXXXXXXXXXXXXXXXXXXXXXXXXXXXXXXXXXXXXXXXXXXXXXX
