----------------------------------------------------------------------------------------------------------------------------------------------------------------------------------------------------------
----------------------------------------------------------------------------------------------------------------------------------------------------------------------------------------------------------
----------------------------------------------------------------------------------------------------------------------------------------------------------------------------------------------------------
----------------------------------------------------------------------------------------------------------------------------------------------------------------------------------------------------------
----------------------------------------------------------------------------------------------------------------------------------------------------------------------------------------------------------
----------------------------------------------------------------------------------------------------------------------------------------------------------------------------------------------------------
----------------------------------------------------------------------------------------------------------------------------------------------------------------------------------------------------------
--------------------------------------------------------###------------------------------------------------------###----------------------------------------tt-------------------------------------------#
-------------------------------------------------------####-----------------------------------------------------####----------------------------------------tt------------------------------------------##
------------------------------------------------------#####----------------------------------------------------#####----------------------------------------tt-----------------------------------------###
--------------------------------S-------##!--!-------######----------S--------------------------!--!----------######-------!--!------------##---------------S-------------------S--SS---#-------------####
---------------------------------------###-----------######-----------------tt-------------------------------#######----------------------###-------------------------------------------##-----------#####
--------------------------------------####-----------######-----------------tt---------------------------tt-########---------------------####-------------------------------------------###------tt-######
-M----------------g-g----------------#####-------g-g-######-----------------tt---------------k-----------tt#########--------------------#####g----t---gg-------------------g----tg-g----####-----tt#######
XXXXXX---XXXXXXXXXXXXXXXXXXXXXXXXXXXXXXXXXXXXXXXXXXXXXXXXXXXXXXXXXXXXXXXXXXXXXXXXX---XXXXXXXXXXXXXXXXXXXXXXXXXXXXXXXXXXXXXXXXXXXXXXXXXXXXXXXXXXXXXXXXXXXXXXXXXXXXXXXXXXXXXXXXXXXXXXXXXXXXXXXXXXXXXXXXXXXXX
XXXXXX---XXXXXXXXXXXXXXXXXXXXXXXXXXXXXXXXXXXXXXXXXXXXXXXXXXXXXXXXXXXXXXXXXXXXXXXXX---XXXXXXXXXXXXXXXXXXXXXXXXXXXXXXXXXXXXXXXXXXXXXXXXXXXXXXXXXXXXXXXXXXXXXXXXXXXXXXXXXXXXXXXXXXXXXXXXXXXXXXXXXXXXXXXXXXXXX
