----------------------------------------------------------------------------------------------------------------------------------------------------------------------------------------------------------
----------------------------------------------------------------------------------------------------------------------------------------------------------------------------------------------------------
----------------------------------------------------------------------------------------------------------------------------------------------------------------------------------------------------------
----------------------------------------------------------------------------------------------------------------------------------------------------------------------------------------------------------
----------------------------------------------------------------------------------------------------------------------------------------------------------------------------------------------------------
----------------------------------------------------------------------------------------------------------------------------------------------------------------------------------------------------------
-----------------------------------------------------------------------------------------------------SSS--------------------------------------------------------------------------------------------------
-------------------------------------------------###------------------------------------------------------------------------------------------------------------------------------------------------------
------------------------------------------------####------------------------------------------------g-----------------------------------------------------------------------------------------------------
-----------------------------------------------#####------------------------------------------------------------------------------------------------------------------------------------------------------
-------------------S@S!S----------------------######--------------------------------------------S--@S--------------------------------!--!-----C-----!--!---------------S@S!S------------------------------
-----------------------------------tt--------#######-----------------tt--------------------------------------------------------------------------------------------------------------------tt-------------
-----------------------------------tt----tt-########-----------------tt--------------------------------------------------------------------------------------------------------------------tt-------------
-M------------------t--------------tt----tt#########-------g----t----tt-g----t---gg-------k--------------------g-g-----------------------------g-g----------------g----tg------------------tt-------------
XXXXXXXXXXXXXXXXXXXXXXXXXXXXXXXXXXXXXXXXXXXXXXXXXXXXXXXXXXXXXXXXXXXXXXXXXXXXXXXXXXXXXXXXXXXXXXXXXXXXXXXXXXXXXXXXXXXXXXXXXXXXXXXXXXXXXXXXXXXXXXXXXXXXXXXXXXXXX---XXXXXXXXXXXXXXXXXX---XXXXXXXXXXXX---XXXXXX
XXXXXXXXXXXXXXXXXXXXXXXXXXXXXXXXXXXXXXXXXXXXXXXXXXXXXXXXXXXXXXXXXXXXXXXXXXXXXXXXXXXXXXXXXXXXXXXXXXXXXXXXXXXXXXXXXXXXXXXXXXXXXXXXXXXXXXXXXXXXXXXXXXXXXXXXXXXXX---XXXXXXXXXXXXXXXXXX---XXXXXXXXXXXX---XXXXXX
