----------------------------------------------------------------------------------------------------------------------------------------------------------------------------------------------------------
----------------------------------------------------------------------------------------------------------------------------------------------------------------------------------------------------------
----------------------------------------------------------------------------------------------------------------------------------------------------------------------------------------------------------
----------------------------------------------------------------------------------------------------------------------------------------------------------------------------------------------------------
----------------------------------------------------------------------------------------------------------------------------------------------------------------------------------------------------------
----------------------------------------------------------------------------------------------------------------------------------------------------------------------------------------------------------
----------------------------------------------------------------------------------------------------------------------------------------------------------------------------------------------------------
------------------------------------------------------###-------------------------------------------------------------------------------------------------------------------------------------------------
-----------------------------------------------------####-------------------------------------------------------------------------------------------------------------------------------------------------
----------------------------------------------------#####-------------------------------------------------------------------------------------------------------------------------------------------------
----S@S!S------------------------------------------######---------SS------#--#---------------------------!--!-----C----------##!--!-------------------------##!--!-----S-----------------!--!-----------!-
---------------------#-----------------------------######----------------##--##---------------------------------------------###----------------------------###-------------------#------------------------
-----------------tt-##-------tt--------------------######---------------###--###-------------------------------------------####------------------tt-------####---------------tt-##------------------------
-M-t-------------tt###-------tt----------------g-g-######-------g-g----####--####--------g-g-----------------------g-g----#####-------g-g--------tt------#####---------------tt###-------------------k----
XXXXXXXXXXXXXXXXXXXXXXXXXXXXXXXXXXXXXXXXXXXXXXXXXXXXXXXXXXXXXXXXXXXXXXXXXXXXXXXXXXXXXXXXXXXXXXXXXXXXXXXXXXXXXXXXXXXXXXXXXXXXXXXXXXXXXXXXXXXXXXXXXXXXXXXXXXXXXXXXXXXXXXXXXXXXXXXXXXXXXXXXXXXXXXXXXXXXXXXXXX
XXXXXXXXXXXXXXXXXXXXXXXXXXXXXXXXXXXXXXXXXXXXXXXXXXXXXXXXXXXXXXXXXXXXXXX------XXXXXXXXXXXXXXXXXXXXXXXXXXXXXXXXXXXXXXXXXXXXXXXXXXXXXXXXXXXXXXXXXXXXXXXXXXXXXXXXXXXXXXXXXXXXXXXXXXXXXXXXXXXXXXXXXXXXXXXXXXXXX
