----------------------------------------------------------------------------------------------------------------------------------------------------------------------
----------------------------------------------------------------------------------------------------------------------------------------------------------------------
----------------------------------------------------------------------------------------------------------------------------------------------------------------------
----------------------------------------------------------------------------------------------------------------------------------------------------------------------
----------------------------------------------------------------------------------------------------------------------------------------------------------------------
----------------------------------------------------------------------------------------------------------------------------------------------------------------------
-----------------------------------------------------------------------------------------------------------------SSS-----------------------------------------------SSS
----------------------------------------------------------------------------------------------------------------------------------------------------------------------
------------------------------------------------------------------------------------------------------------------------------------------------------------------g---
SSS-------------------------------------------------------------------------------------------------------------------------------------------------------------------
------------------##--------SS------#--#-------------------C--U----!--------------S@S!S----S@S!S-----------U----!--------SS------#--#------S@S!--SS---#----------@S---
-----------------###---------------##--##---------------------------------------------------------------------------------------##--##----------------##--------------
----------------####--------------###--###-------------------------------------------------------------------------------------###--###---------------###-------------
-M-t-----------#####------g-g----####--####-----------------g-g--g-------g-g--------t----g--------------------------gg-g-g----####--####--t----g-g----####------------
XXXXXXXXXXXXXXXXXXXXXXXXXXXXXXXXXXXXXXXXXXXXXXXXXXXXXXXXXXXXXXXXXXXXXXXXXXXXXXXXXXXXXXXXXXXXXXXXXXXXXXXXXXXXXXXXXXXXXXXXXXXXXXXXXXXXXXXXXXXXXXXXXXXXXXXXXXXXXXXXXXXXXX
XXXXXXXXXXXXXXXXXXXXXXXXXXXXXXXXX------XXXXXXXXXXXXXXXXXXXXXXXXXXXXXXXXXXXXXXXXXXXXXXXXXXXXXXXXXXXXXXXXXXXXXXXXXXXXXXXXXXXXXXX------XXXXXXXXXXXXXXXXXXXXXXXXXXXXXXXXXX
