---------------------------------------------------------------------------------------------------------------------------------------------------------------------------------------------------
---------------------------------------------------------------------------------------------------------------------------------------------------------------------------------------------------
---------------------------------------------------------------------------------------------------------------------------------------------------------------------------------------------------
---------------------------------------------------------------------------------------------------------------------------------------------------------------------------------------------------
---------------------------------------------------------------------------------------------------------------------------------------------------------------------------------------------------
---------------------------------------------------------------------------------------------------------------------------------------------------------------------------------------------------
-------------------------------------------------------SS------------------------------------------------------------------------------------------------------------------------------------------
---------------------------------------------------------U----!---------###-------------------------------------###--------------------------------------------------------------------------------
------------------------------------------------------g----------------####------------------------------------####--------------------------------------------------------------------------------
----------------------------------------------------------------------#####-----------------------------------#####--------------------SSS---------------------------------------------------------
--------------------##---------------------tt------##@S--------------######------------##---C-------S@S!-----######--------------------------------------------------------------------------------
------------tt-----###---------------------tt-----###----------------######-----------###--------------------######--------------------------------------------------------------------------------
------------tt----####---------------------tt----####----------------######----------####--------------------######--------------------------------------tt----------------------------------------
-M----------tt---#####------g-------------------#####--------gg--g-g-######---------#####----g-g---------g-g-######-------------------k--t---------------tt----------k--g-------g-g----------------
XXXXXXXXXXXXXXXXXXXXXXXXXXXXXXXXXXXXXXXXXXXXXXXXXXXXXXXXXXXXXXXXXXXXXXXXXXXXXXXXXXXXXXXXXXXXXXXXXXXXXXXXXXXXXXXXXXXXXXXXXXXXXXXXXXXXXXXXXXXXXXXXXXXXXXXXXXXXXXXXXXXXXXXXXXXXXXXXXXXXXXXXXXXXXX---XX
XXXXXXXXXXXXXXXXXXXXXXXXXXXXXXXXXXXXXXXXXXXXXXXXXXXXXXXXXXXXXXXXXXXXXXXXXXXXXXXXXXXXXXXXXXXXXXXXXXXXXXXXXXXXXXXXXXXXXXXXXXXXXXXXXXXXXXXXXXXXXXXXXXXXXXXXXXXXXXXXXXXXXXXXXXXXXXXXXXXXXXXXXXXXXX---XX
