----------------------------------------------------------------------------------------------------------------------------------------------------------------------------------------------------------
----------------------------------------------------------------------------------------------------------------------------------------------------------------------------------------------------------
----------------------------------------------------------------------------------------------------------------------------------------------------------------------------------------------------------
----------------------------------------------------------------------------------------------------------------------------------------------------------------------------------------------------------
----------------------------------------------------------------------------------------------------------------------------------------------------------------------------------------------------------
----------------------------------------------------------------------------------------------------------------------------------------------------------------------------------------------------------
-----------------------------------------------------------------------------------------------------------------SSS------------------------------------------------SSS--------SSS------------------------
-------------------------------------------###------------------------------------------------------------------------------------------------------------------------------------------------------------
------------------------------------------####------------------------------------------------------------------g--------------------------------------------------g----------g---------------------------
-----------------------------------------#####--------------------------------------------SSS-------------SSS---------------------------------------------------------------------------------------------
---------------C------------------------######---------SS---#--------C----------##-----------------------------@S-----------!--!-------##------------##-----------@S---!--!--@S---------------------------
---------------------------------------#######--------------##-----------------###----------------------------------------------------###----tt-----###---------------------------------------------------
-----------------------------------tt-########--------------###---------------####tt-------------------------------------------------####----tt----####-----tt-------------------------------------------#
-M-------k------g-g--t----g----t---tt#########-------g-g----####------g-g----#####tt----t-----g-g-----------------------------------#####----tt---#####-----tt-----------------------------g-g----------##
XXXXXXXXXXXXXXXXXXXXXXXXXXXXXXXXXXXXXXXXXXXXXXXXXXXXXXXXXXXXXXXXXXXXXXXXXXXXXXXXXXXXXXXXXXXXXXXXXXXXXXXXXXXXXXXXXXXXXXX---XXXXXXXXXXXXXXXXXXXXXXXXXXXXXXXXXXXXXXXXXXXXXXXXXXXXXXXXXXX---XXXXXXXXXXXXXXXXXX
XXXXXXXXXXXXXXXXXXXXXXXXXXXXXXXXXXXXXXXXXXXXXXXXXXXXXXXXXXXXXXXXXXXXXXXXXXXXXXXXXXXXXXXXXXXXXXXXXXXXXXXXXXXXXXXXXXXXXXX---XXXXXXXXXXXXXXXXXXXXXXXXXXXXXXXXXXXXXXXXXXXXXXXXXXXXXXXXXXX---XXXXXXXXXXXXXXXXXX
