----------------------------------------------------------------------------------------------------------------------------------------------------------------------------------------------------------
----------------------------------------------------------------------------------------------------------------------------------------------------------------------------------------------------------
----------------------------------------------------------------------------------------------------------------------------------------------------------------------------------------------------------
----------------------------------------------------------------------------------------------------------------------------------------------------------------------------------------------------------
----------------------------------------------------------------------------------------------------------------------------------------------------------------------------------------------------------
----------------------------------------------------------------------------------------------------------------------------------------------------------------------------------------------------------
--------------------------------------------------------------------SSS-----------------------------------------------------------------------SSS---------------------------------------------------------
---------------------------------------------------------------------------------------------------###----------------------------------------------------------------------------------------------------
-------------------------------------------------------------------g------------------------------####---------------------------------------g------------------------------------------------------------
-------------------------------------------------------------------------------------------------#####----------------------------------------------------------------------------------------------------
--------------------##-------------S@S!S-----C------------------##@S---!--!----------S----------######---------tt-------------------##---S--@S------------------------------tt---------------------##---S-
-------------------###-------#---------------------------------###-----------------------------#######---------tt------------------###---------------tt---------------------tt-------tt-----------###-----
------------------####---tt-##--------------------------------####-------------------------tt-########---------tt-----------------####---------------tt---------------------tt-------tt----------####-----
-M--g-g----------#####---tt###-------t--------g-g------------#####-------------------------tt#########-------g------t------------#####---------------tt-------g----t---gg-g----------tt----gg---#####-----
XXXXXXXXXXXXXXXXXXXXXXXXXXXXXXXXXXXXXXXXXXXXXXXXXXXXXX---XXXXXXXXXXXXXXXXXXXXXXXXXXXXXXXXXXXXXXXXXXXXXXXXXXXXXXXXXXXXXXXXXXXXXXXXXXXXXXXXXXXXXXXXXXXXXXXXXXXXXXXXXXXXXXXXXXXXXXXXXXXXXXXXXXXXXXXXXXXXXXXXX
XXXXXXXXXXXXXXXXXXXXXXXXXXXXXXXXXXXXXXXXXXXXXXXXXXXXXX---XXXXXXXXXXXXXXXXXXXXXXXXXXXXXXXXXXXXXXXXXXXXXXXXXXXXXXXXXXXXXXXXXXXXXXXXXXXXXXXXXXXXXXXXXXXXXXXXXXXXXXXXXXXXXXXXXXXXXXXXXXXXXXXXXXXXXXXXXXXXXXXXX
