------------------------------------------------------------------------------------------------------------------------------------------------------------------------------
------------------------------------------------------------------------------------------------------------------------------------------------------------------------------
------------------------------------------------------------------------------------------------------------------------------------------------------------------------------
------------------------------------------------------------------------------------------------------------------------------------------------------------------------------
------------------------------------------------------------------------------------------------------------------------------------------------------------------------------
------------------------------------------------------------------------------------------------------------------------------------------------------------------------------
------------------------------------------------------------------------------------------------------------------------------------------------------------------------------
-----------------------------------------------tt---------------------------------###-------------------------------------------------------------SS!S------------------------
-----------------------------------------------tt--------------------------------####-----------------------------------------------------------------------------------------
-----------------------------------------------tt-------------------------------#####-----------------------------------------------------------------------------------------
----!-----tt---!--!--------------------------------------U----!--------S-------######------------tt---S@S!S-----------------------##-----------------S-----C-------SS---#-----
----------tt----------------#---------------XXXXXX-----------------------------######------------tt------------------#-----------###------------------------------------##----
----------tt------------tt-##-------tt------XXXXXX-----------------------------######------------tt--------------tt-##----------####------------------------------------###---
-M-t----g---------------tt###-------tt----------------k--------------------g-g-######-------------t----g---------tt###---------#####------------------------g-g--g-g----####--
XXXXXXXXXXXXXXXXXXXXXXXXXXXXXXXXXXXXXXXXXXXXXXXXXXXXXXXXXXXXXXXXXXXXXXXXXXXXXXXXXXXXXXXXXXXXXXXXXXXXXXXXXXXXXXXXXXXXXXXXXXXXXXXXXXXXXXXXXXXXX---XXXXXXXXXXXXXXXXXXXXXXXXXXXXXX
XXXXXXXXXXXXXXXXXXXXXXXXXXXXXXXXXXXXXXXXXXXXXXXXXXXXXXXXXXXXXXXXXXXXXXXXXXXXXXXXXXXXXXXXXXXXXXXXXXXXXXXXXXXXXXXXXXXXXXXXXXXXXXXXXXXXXXXXXXXXX---XXXXXXXXXXXXXXXXXXXXXXXXXXXXXX
