------------------------------------------------------------------------------------------------------------------------------------------------------------------------------------------------------
------------------------------------------------------------------------------------------------------------------------------------------------------------------------------------------------------
------------------------------------------------------------------------------------------------------------------------------------------------------------------------------------------------------
------------------------------------------------------------------------------------------------------------------------------------------------------------------------------------------------------
------------------------------------------------------------------------------------------------------------------------------------------------------------------------------------------------------
------------------------------------------------------------------------------------------------------------------------------------------------------------------------------------------------------
------------------------------------------------------------------------------------------------------------------------------------------------------------------------------------------------------
-------------------------------------------------------------------------------------------------------SS!S---------------------------------------------------------------------------###-------------
-------------------------------------------------------------------------------------------------------------------------------------------------------------------------------------####-------------
------------------------------------------------------------------------------------------------------------------------------------------------------------------------------------#####-------------
-------S@S!S-----C-------------SS------#--#-------------C------------!--!-----C-------------tt----------------!--!----SS---#-------------SS------#--#-U----!---!--!----------------######----------S--
--------------------------------------##--##----------------------tt------------------------tt-----------------------------##-------------------##--##----------------------------#######-------------
-----------------------tt------------###--###---------------------tt-------------------#----tt-----------------------------###---tt------------###--##------------------------tt-########-------------
-M-------t--------g-g--tt----g-g----####--####-----------g-g------tt-----------g-g----#####t---------------gg-------g-g----####--tt----g-g----####--####--t-------------------tt#########-------------
XXXXXXXXXXXXXXXXXXXXXXXXXXXXXXXXXXXXXXXXXXXXXXXXXXXXXXXXXXXXXXXXXXXXXXXXXXXXXXXXXXXXXXXXXXXXXXXXXXX---XXXXXXXXXXXXXXXXXXXXXXXXXXXXXXXXXXXXXXXXXXXXXXXXXXXXXXXXXXXXXXXXXXXXXXXXXXXXXXXXXXXXXXXXXXXXXXXX
XXXXXXXXXXXXXXXXXXXXXXXXXXXXXXXXXXXX------XXXXXXXXXXXXXXXXXXXXXXXXXXXXXXXXXXXXXXXXXXXXXXXXXXXXXXXXX---XXXXXXXXXXXXXXXXXXXXXXXXXXXXXXXXXXXXXXXX------XXXXXXXXXXXXXXXXXXXXXXXXXXXXXXXXXXXXXXXXXXXXXXXXXX
