-------------------------------------------------------------------------------------------------------------------------------------------------------------------------------------------
-------------------------------------------------------------------------------------------------------------------------------------------------------------------------------------------
-------------------------------------------------------------------------------------------------------------------------------------------------------------------------------------------
-------------------------------------------------------------------------------------------------------------------------------------------------------------------------------------------
-------------------------------------------------------------------------------------------------------------------------------------------------------------------------------------------
-------------------------------------------------------------------------------------------------------------------------------------------------------------------------------------------
----------------------------------------------------------------------------------------------------------------------------------------------------------------------------------------SSS
-----------------------------------------------S!S-----------------------------------------###------------------###---------------tt-------------------------------------------------------
------------------------------------------------------------------------------------------####-----------------####---------------tt---------------------------------------------------g---
------------------------------------------SSS--------------------------------------------#####----------------#####---------------tt-------------------------SSS---------------------------
--------##---S-------##-----------------------------SS---#------tt----------------------######---------------######---SS!S--------S--!--!---------------------------------C-----------@S---
-------###----------###----------------------------------##-----tt---------------------#######--------------#######-------------------------------#----------------------------------------
------####---------####----------------------------------###----tt---t-------------tt-########----------tt-########---------------------------tt-##-----------------------------tt---------
-M---#####--------#####-g-g--------------k-----gg-g-g----####--t----tt-------------tt#########----------tt#########-------t-------------------tt###-------g------g----t----g-g--tt---------
XXXXXXXXXXXXXXXXXXXXXXXXXXXXXXXXXXXXXXXXXXXXXXXXXXXXXXXXXXXXXXXXXXXXXXXXXXXXXXXXXXXXXXXXXXXXXXXXXXXXXXXXXXXXXXXXXXXXXXXXXXXXXXXXXXXXXXXXXXXXXXXXXXXXXXXXXXXXXXXXXXXXXXXXXXXXXXXXXXXXXXXXXXX
XXXXXXXXXXXXXXXXXXXXXXXXXXXXXXXXXXXXXXXXXXXXXXXXXXXXXXXXXXXXXXXXXXXXXXXXXXXXXXXXXXXXXXXXXXXXXXXXXXXXXXXXXXXXXXXXXXXXXXXXXXXXXXXXXXXXXXXXXXXXXXXXXXXXXXXXXXXXXXXXXXXXXXXXXXXXXXXXXXXXXXXXXXX
