------------------------------------------------------------------------------------------------------------------------------------------------------------------------------------
------------------------------------------------------------------------------------------------------------------------------------------------------------------------------------
------------------------------------------------------------------------------------------------------------------------------------------------------------------------------------
------------------------------------------------------------------------------------------------------------------------------------------------------------------------------------
------------------------------------------------------------------------------------------------------------------------------------------------------------------------------------
-------------------------------------------------------------------------------------------------------------------------------------------------------------------------------#----
--------------------------------------------------------------------------------------------------------------------------------------------C---------------C-----------------##----
-----------------------------------------------------------------------------------------------------------------------------------------------------------------------------###----
---------------------------------------------------------------------S!!S-----------------------------------------!----SS!S---------SS!---------------------------SSS!------####----
--------SSS---------------------------------------------------------------------------------SSS----SSS!--------------------------------------------------------------------#####----
-------------------SS!S-#------------#--------!-------------------------------------------------------------------------------------------------------------------------t-######----
------------------------##-----------##-------------------------------------------------------------------------------------gg-g-g-------gg-g-g----------gg-g-gtt#######g-g--------k
------------------------###----------###------------tt----------------S----------------------------XXXXXXXXXXXXXXXXXXXXXXXXXXXXXXXXXXXXXXXXXXXX---XXXXXXXXXXXXXXXXXXXXXXXXXXXXXXXXXX
-M-tt#######-M----------####---gg----####-----------tt---gg-------------gg-g-g------M---g-g--------XXXXXXXXXXXXXXXXXXXXXXXXXXXXXXXXXXXXXXXXXXXX---XXXXXXXXXXXXXXXXXXXXXXXXXXXXXXXXXX
XXXXXXXXXXXXXXXXXXXXXXX-XXXXXXXXXXXX-XXXXXXXXXXXXXXXXXXXXXXXXX---XXXXXXXXXXXXXXXXXXXXXXXXXXXXXXXXXXX--------------------------------------------------------------------------------
XXXXXXXXXXXXXXXXXXXXXXX-XXXXXXXXXXXX-XXXXXXXXXXXXXXXXXXXXXXXXX---XXXXXXXXXXXXXXXXXXXXXXXXXXXXXXXXXXX--------------------------------------------------------------------------------
