----------------------------------------------------------------------------------------------------------------------------------------------------------------------------------------
----------------------------------------------------------------------------------------------------------------------------------------------------------------------------------------
----------------------------------------------------------------------------------------------------------------------------------------------------------------------------------------
----------------------------------------------------------------------------------------------------------------------------------------------------------------------------------------
----------------------------------------------------------------------------------------------------------------------------------------------------------------------------------------
----------------------------------------------------------------------------------------------------------------------------------------------------------------------------------------
----------------------------------------------------------------------------------------------------------------------------------------------------------------------------------------
----------------------------------------------------------------------------------------------------------------------------------------------------------------------------------------
-------------------------------------##---------------------------------------------------------------------#--SSS----S!!S----------------------------------##--------------------------
---------------------------------SSS-##--------------------------------------------------------------------##-----------------------------------------------##--------------------------
-----SS!S----------------------------##------#-----------#-----!----SS!S-#--------!---S@S!S----SU---------###---------------------------------------SU------##----------------!---S@S!S-
-------------------------------------##------##---------##---------------##----------------------------t-####--------------------SSS----SSS!----------------##--------------------------
-------------------------------------##------###-------###---------------###----------------------tt#######g-g---------SS-----------------------------------##--------------------------
-M-------------gg-g-g--gg-------####-##------####-----####---------------####----------g----XXXXXXXXXXXXXXXXXXXXXXXXXXX-------#---------------tt#######-M---##------gg-g-g---------g----
XXXXXXXXXXXXXXXXXXXXXXXXXXXXXXXXXXXXXXXXXXXX-XXXXXXXXXXXXXXXXXXXXXXXXXXX-XXXXXXXXXXXXXXXXXXXXXXXXXXXXXXXXXXXXXXXXXXXXXX------##---------XXXXXXXXXXXXXXXXXXXXXXXXXXXXXXXXXXXXXXXXXXXXXXXX
XXXXXXXXXXXXXXXXXXXXXXXXXXXXXXXXXXXXXXXXXXXX-XXXXXXXXXXXXXXXXXXXXXXXXXXX-XXXXXXXXXXXX----------------------------------------g-g--------XXXXXXXXXXXXXXXXXXXXXXXXXXXXXXXXXXXXXXXXX-------
