---------------------------------------------------------------------------------------------------------------------------------------------------------------------
---------------------------------------------------------------------------------------------------------------------------------------------------------------------
---------------------------------------------------------------------------------------------------------------------------------------------------------------------
---------------------------------------------------------------------------------------------------------------------------------------------------------------------
---------------------------------------------------------------------------------------------------------------------------------------------------------------------
---------------------------------------------------------------------------------------------------------------------------------------------------------------------
--------------------------------------------------------------------------------------------------------------------------##-----------------------------------------
--------------------------------------------------------------------------------------------------------------------------##----------------SSS----S!!S--------------
--------##---------------------------------------------------------------------------------------SSS----SSS!----!---S@S!S-##----------SSS!---------------------------
--------##------------------------------------------------------------------------SSS----SSS!-----------------------------##----------------------------------##-----
--------##--------SSS!----SS!S-------------------------------------------------C------------------------------------------##----------------------------------##-----
--------##-------------------------------#---------C-----------------------------------------------------------------g----##------gg-g-gg-g---------SS------#-##-----
--------##------------------------------##---------------------------------------------------g-g------XXXXXXXXXXXXXXXXXXXXXXXXXXXXXXXXXXXXXXXXXXXXXX-------##-##-----
-M------##---------####---------gg-----###--gg---------------------gg---------g-g------XXXXXXXXXXXX---XXXXXXXXXXXXX-------XXXXXXXXXXXXXXXXXXXXXXXXXX------###-##-----
XXXXXXXXXXXXXXXXXXXXXXXXXXXXXXXXXXXXXXXXXXXXXXXXXXXXXXXX---XXXXXXXXXXXXXXXXXXXXXXXXX---XXXXXXXXXXXXXXXXXX-----------------------------------------------XXXXXX##-----
XXXXXXXXXXXXXXXXXXXXXXXXXXXXXXXXXXXXXXXXXXXXXXXXXXXXXXXX---XXXXXXXXXXXXXXXXXXXXXXXXXXXXXXX--------------------------------------------------------------XXXXXXXXXXXXX
