------------------------------------------------------------------------------------------------------------------------------------------------------------------------
------------------------------------------------------------------------------------------------------------------------------------------------------------------------
------------------------------------------------------------------------------------------------------------------------------------------------------------------------
------------------------------------------------------------------------------------------------------------------------------------------------------------------------
------------------------------------------------------------------------------------------------------------------------------------------------------------------------
-------------------------------------------------------------------------------------------------------------#----------------------------------------------------------
------------------------------------------------------------------------------------------------------------##----------------------------------------------------------
-----------------------------------------------------------------------------------------------------------###----------------------------------------------------------
----------------------------SS!S------C---#----------C---------#------SS!S---------!----SS!S---SSS!-------####----------------------------------------SSS----S!!S-------
----------#--SSS----SSS!------------------##---------------SU--##----------------------------------------#####----------------------------------------------------------
---------##-------------------------------###------------------###------------------------------------t-######-------------------------------------t--------------------
--------###-------------------------####--####-----####--------####--------M----------------tt#######----####--gg-g-g--gg-----------gg-------------t--------------------
-----t-####---------XXXXXXXXXXXXXXXXXXXXX-XXXXXXXXXXXXXXXXXXXX-XXXXXXXXXXXXXXXXXXXXXXXXXXXXXXXXXXXXXXXXXXXXXXXXXXXXXXXXXXXXXXXXXXXXXXXXXXXXXX-----g-g---------SS------#-
-M-------g-g--------XXXXXXXXXXXXXXXXXXXXX-XXXXXXXXXXXXXXXXXXXX-XXXXXXXXXXXXXXXXXXXXXXXXXXXXXXXXXXXXXXXXXXXXXXXXXXXXXXXXXXXXXXXXXXXXXXXXXXXXXXXXXXXXXXXXXXXXXXX-------##-
XXXXXXXXXXXXXXXXXXXXX------------------------------------------------------------------------------------------------------------------------XXXXXXXXXXXXXXXXX------###-
XXXXXXXXXXXXXXXXXXXXX---------------------------------------------------------------------------------------------------------------------------------------------------
