--------------------------------------------------------------------------------------------------------------------------------------------------------
--------------------------------------------------------------------------------------------------------------------------------------------------------
--------------------------------------------------------------------------------------------------------------------------------------------------------
--------------------------------------------------------------------------------------------------------------------------------------------------------
--------------------------------------------------------------------------------------------------------------------------------------------------------
--------------------------------------------------------------------------------------------------------------------------------------------------------
--------------------------------------------------------------------------------------------------------------------------------------------------------
-----------------------------------------------------------------------------------------------------------------------------------SSS----SSS!----------
----------------------------------------------------##------------------------------------SSS----SSS!---------------------------------------------------
-----------------------SSS----SSS!-----------!------##---------------------SSS----SSS!-------------------------SSS!-------------t-----------------------
---------#------------------------------------------##------#------SS!S---------------------------------------------------------t-----------g-g--------k
---------##----------------------------------------t##------##---------------------------------------------M----------M--------g-g--------k-XXXXXXXXXXXX
---------###-----------------------gg-g-g----------t##------###-----------------------g-g------XXXXXXXXXXXXXXXXXXXXXXXXXXXXXXXXXXXXXXXXXXXX-XXXXXXXXXXXX
-M-------####--M---g-g------XXXXXXXXXXXXXXX---------##------####-------g-g------XXXXXXXXXXXX---XXXXXXXXXXXXXXXXXXXXXXXXXXXXXXXXXXXXXXXXXXXX-------------
XXXXXXXX-XXXXXXXXXXXXXXXX---XXXXXXXXXXXXXXX---XXXXXXXXXXXXX-XXXXXXXXXXXXXXXXX---XXXXXXXXXXXXXXXXXX------------------------------------------------------
XXXXXXXX-XXXXXXXXXXXXXXXXXXXXXX---------------XXXXXXXXXXXXX-XXXXXXXXXXXXXXXXXXXXXXX---------------------------------------------------------------------
