------------------------------------------------------------------------------------------------------------------------------------------------------------------------------------------
------------------------------------------------------------------------------------------------------------------------------------------------------------------------------------------
------------------------------------------------------------------------------------------------------------------------------------------------------------------------------------------
------------------------------------------------------------------------------------------------------------------------------------------------------------------------------------------
------------------------------------------------------------------------------------------------------------------------------------------------------------------------------------------
------------------------------------------------------------------------------------------------------------------------------------------------------------------------------------------
---------------------------------------------------------------------------------------------------------------------------------------------------------C-----------------##-------------
--------------------------------------------------------------------------------------##--------------------------##-------------------------------------------------------##-------------
--------------------------------------------------------------------------------------##--------------------------##--------------------SSS----SSS!-----------SS!S---------##-------------
----------------SSS----SSS!----------SU--------------------------!----SS!S------------##------------------C-------##-------------------------------------------------------##--------SU---
------------------------------------------------------------t-------------------------##--------------------------##-------------------------------------------------------##-------------
------------------------------------------------------------t-------------------------##--------------------------##----------------------------####--gg-g-g----------####-##-------------
--------------------tt#######---------tt#######----------------------------------gg---##-------gg-------####------##----------------g-g-----XXXXXXXXXXXXXXXXXXXXXXXXXXXXXXXXXXXXXXXXXXXX--
-M-tt#######g-g-----XXXXXXXXX---XXXXXXXXXXXXXXXXXXXX---XXXXXXXXXXXXXXXXXXXXXXXXXXXXXXXXXXXXXXXXXXXXXXXXXXXXXXXXXXXXXXXXXXXXXXXXXXXXXXXXXXXXXXXXXXXXXXXXXXXXXXXXXXXXXXXXXXXXXXXXXXXXXXXXX--
XXXXXXXXXXXXXXXXXXXXXXXXXXXXX---XXXXXXXXXXXXXXXXXXXX---XXXXXXXXXXXXXXXXXXXXXXXXXXXXXXXXXXXXXXXXXXXXXXXXXXXXXXXXXXXXXXXXXXXXXXXXXXXXXXXXXXXXXXXXX------------------------------------------
XXXXXXXXXXXXXXXXXXXXXXXX------------------------------------------------------------------------------------------------------------------------------------------------------------------
