--------------------------------------------------------------------------------------------------------------------------------------------------------------------------------
--------------------------------------------------------------------------------------------------------------------------------------------------------------------------------
--------------------------------------------------------------------------------------------------------------------------------------------------------------------------------
--------------------------------------------------------------------------------------------------------------------------------------------------------------------------------
------------------------------------------------------------------------------------------------------#-------------------------------------------------------------------------
-----------------------------------------------------------------------------------------------------####-----------------------------------------------------------------------
----------------------------------------------------------------------------------------------------#####--------------------------SSS----SSS!--------------#-------------------
-------------------------------------------------------------------C-------------------------------######-----------#--------------------------------------##-------------------
-----------------------------------!---S@S!S----SU------------------------------------------------#######-----------##-------#----------------------------###-------------------
------------------SSS----SSS!------------------------------------------------------------------t-########-----------###-----##---------tt#######-----tt#######------g-g--------k
---------#-------------------------------------------gg----M-------####--------gg----M--------tt#########------M----####---###-g-g-----XXXXXXXXXXXXXXXXXXXXXXXXXXXXXXXXXXXXXXXXX
---------##-----------------------------g----XXXXXXXXXXXXXXXXXXXXXXXXXXXXXXXXXXXXXXXXXXXXXXXXXXXXXXXXXXXXXXXXXXXXXX-XXXXXXXXXXXXXXXXXXXXXXXXXXXXXXXXXXXXXXXXXXXXXXXXXXXXXXXXXXXX
---------###-------------XXXXXXXXXXXXXXXXXXXXXXXXXXXXXXXXXXXXXXXXXXXXXXXXXXXXXXXXXXXXXXXXXXXXXXXXXXXXXXXXXXXXXXXXXX-XXXXXXXXXXXXXXXXXXXXXXX-------------------------------------
-M--M----####-g-g--------XXXXXXXXXXXXX------------------------------------------------------------------------------------------------------------------------------------------
XXXXXXXX-XXXXXXXXXXXXXXXXX------------------------------------------------------------------------------------------------------------------------------------------------------
XXXXXXXX-XXXXXXXXXXXXXXXXX------------------------------------------------------------------------------------------------------------------------------------------------------
