----------------------------------------------------------------------------------------------------------------------------------------------------------------
----------------------------------------------------------------------------------------------------------------------------------------------------------------
----------------------------------------------------------------------------------------------------------------------------------------------------------------
----------------------------------------------------------------------------------------------------------------------------------------------------------------
----------------------------------------------------------------------------------------------------------------------------------------------------------------
----------------------------------------------------------------------------------------------------------------------------------------------------------------
------------------------------------------------S!!S------------------------------------------------------------------------------------------------------------
----------------------------------------------------------------------------------------------------------------------------------------------------------------
----------------------------------------------------------------SSS-------------------------------------------------SSS----S!!S---------------------------------
------------------------------------------------------------------------------------SS!S-------------SSS----SSS!------------------------------------------------
---------------------!---S@S!S----SU-------------SS------#-----------------------------------------------------------------------------------------SSS----SSS!--
--------------------------------------------------------##----------------------------------------t-----------------------------------SSS----SSS!---------------
--------------------------------------gg-g-g----####---###-----####-------------------------------t-------------g-g---------SS----------------------------------
-M---gg----gg-g-g---------g----XXXXXXXXXXXXXXXXXXXXXXXXXXXXXXXXXXXXXXXXXX---XXXXXXXXXXXXXXXX-----g-g------XXXXXXXXXXXXXXXXXX-------#----------------------------
XXXXXXXXXXXXXXXXXXXXXXXXXXXXXXXXXXXXXXXXXXXXXXXXXXXXXXXXXXXXXXXXXXXXXXXXX---XXXXXXXXXXXXXXXXXXXXXXXXXXX---XXXXXXXXXXXXXXXXXX------##-----------g-g------XXXXXX--
XXXXXXXXXXXXXXXXXXXXXXXX--------------------------------------------------------------------XXXXXXXXXXXXXXXXX---------------------g-g--------k-XXXXXX---XXXXXX--
