-------------------------------------------------------------------------------------------------------------------------------------------------------------------------------------------
-------------------------------------------------------------------------------------------------------------------------------------------------------------------------------------------
-------------------------------------------------------------------------------------------------------------------------------------------------------------------------------------------
-------------------------------------------------------------------------------------------------------------------------------------------------------------------------------------------
-------------------------------------------------------------------------------------------------------------------------------------------------------------------------------------------
-------------------------------------------------------------------------------------------------------------------------------------------------------------------------------------------
-------------------------------------------------------------------------------------------------------------------------------------------------------------------------------------------
-------------------------------------------------------------------------------------------------------------------------------------------------------------------------------------------
-----------------##------------------------------------------------------##---------C-------------------------------------##---------------------------------------------------------------
-----------------##------------------------------------------------------##-----------------------------------------------##-------------------SS------------------------------------------
-----------------##-------SS!S---------------------------!---------S@S!S-##------------------SU---SS!S----!---------S@S!S-##-----------------------------------#-----!---S@S!S----SU---SS!S
---------tt------##------------------------------------------------------##-----------------------------------------------##----------------------------------##---------------------------
---------tt------##--------------------------------------------tt--------##-------------------------------------tt--------##---------------------------------###---------------------------
-M-tt#######-----##----------------------gg----gg-g-g----------tt---g----##------gg-g-g----####-----------------tt---g----##-------gg--------------gg---tt#######---------g-----####-------
XXXXXXXXXXXXXXXXXXXXXXXXXXXXXX---XXXXXXXXXXXXXXXXXXXXXXXXXXXXXXXXXXXXXXXXXXXXXXXXXXXXXXXXXXXXXXXXXXXXXXXXXtt#######XXXXXXXXXXXXXXXXXXXXX---XXXXXXXXXXXXXXXXXXXXXXXXXXXXXXXXXXXXXXXXXXXXXXXX
XXXXXXXXXXXXXXXXXXXXXXXXXXXXXX---XXXXXXXXXXXXXXXXXXXXXXXXXXXXXXXXX-------XXXXXXXXXXXXXXXXXXXXXXXXXXXXXXXXXXXXXXXXXX-------XXXXXXXXXXXXXX---XXXXXXXXXXXXXXXXXXXXXXXXXXXXX----XXXXXXXXXXXXXXX
