-----------------------------------------------------------------------------------------------------------------------------------------------------------------------
-----------------------------------------------------------------------------------------------------------------------------------------------------------------------
-----------------------------------------------------------------------------------------------------------------------------------------------------------------------
-----------------------------------------------------------------------------------------------------------------------------------------------------------------------
-----------------------------------------------------------------------------------------------------------------------------------------------------------------------
-----------------------------------------------------------------------------------------------------------------------------------------------------------------------
-----------------------------------------------------------------------------------------------------------------------------------------------------------------------
-----------------------------------------g------------------------------------------##------------------------------------------##-------------------------------------
----------------------------------------SSSSSSS---S!--------------------------------##-----------------------------SSS----------##----------SSS----S!!SS---------------
------------------------------------------------------SSS----SSS!-------------------##-------------------------------------C----##---------------------------!---S@S!S-
---------SU----------!----SS!S------SU----------------------------------------------##------------------------------------------##-------------------------------------
------------------------------------------------------------------------------------##------------------------------------------##-------------------------------------
---------------------------------------------------S--------------M-----gg----gg-g-g##-------gg----gg-g-g-M---tt#######----####-##---------####-t---SS-##---------g----
-M-tt#######-M----------------tt#######-----------g-g------XXXXXXXXXXXXXXXXXXXXXXXXXXXXXXXXXXXXXXXXXXXXXXXXXXXXXXXXXXXXXXXXXXXXXXXXXXXXXXXXXXXXXXXXXXXXXXXXXXXXXXXXXXXX
XXXXXXXXXXXXXXXXXXXXXXXXXXXXXXXXXXXXXXXXXXXXXXXXXXXXXXXX---XXXXXXXXXXXXXXXXXXXXXXXXXXXXXXXXXXXXXXXXXXXXXXXXXXXXXXXXXXXXXXXXXXXXXXXXXXXXXXXXXXXXXXXXXXXXXXXXXXXXX-------
XXXXXXXXXXXXXXXXXXXXXXXXXXXXXXXXXXXXXXXXXXXXXXXXXXXXXXXXXXXXXX---------------------------------------------------------------------------------------------------------
