-------------------------------------------------------------------------------------------------------------------------------------------------------------------------------------
-------------------------------------------------------------------------------------------------------------------------------------------------------------------------------------
-------------------------------------------------------------------------------------------------------------------------------------------------------------------------------------
-------------------------------------------------------------------------------------------------------------------------------------------------------------------------------------
-------------------------------------------------------------------------------------------------------------------------------------------------------------------------------------
-------------------------------------------------------------------------------------------------------------------------------------------------------------------------------------
-------------------------------------------------------------------------------------------------------------------------------------------------------------------------------------
---------------------------------------------------------------------------------------------------------------------------------------##--------------------------------------------
-----------------------------##--------------------------------------------------------------------------------------------------------##---------------SSS----S!!S------------------
-----------------------------##------------------------------------SSS----SSS!----!---S@S!S----SU----------SS!S-------------#------SS!S##--------------------------------------------
-------------------------SS!S##---------!----SS!S-------------C-------------------------------------------------------------##---------##--------------------------------------------
------C----------------------##---------------------------------------------------------------------------------------------###--------##---------------------------------SSS----S!!S
-----------------------------##--------------------------------------------------------g-----####--gg-g-g-------M----gg-g-g-####-------##-----------g-g---------SS-------------------
-----------------------------##-------------------M------------g-g------XXXXXXXXXXXXXXXXXXXXXXXXXXXXXXXXXXXXXXXXXXXXXXXXXXX-XXXXXXXXXXXXXXXXXXXXXXXXXXXXXXXXXXXX-------#-------------
XXXXXXXXXXXXXX---XXXXXXXXXXXXXXXXXXXXXXXXXXXXXXXXXXXXX---XXXXXXXXXXXX---XXXXXXXXXXXXX----XXXXXXXXXXXXXXXXXXXXXXXXXXXXXXXXXX-XXXXXXXXXXXXXXXXXXXXXXXXXXXXXXXXXXXX------##-------------
XXXXXXXXXXXXXX---XXXXXXXXXXXXXXXXXXXXXXXXXXXXXXXXXXXXX---XXXXXXXXXXXXXXXXXX-------------------------------------------------------------------------------------------g-g---------SS-
