--------------------------------------------------------------------------------------------------------------------------------------------------------------
--------------------------------------------------------------------------------------------------------------------------------------------------------------
--------------------------------------------------------------------------------------------------------------------------------------------------------------
--------------------------------------------------------------------------------------------------------------------------------------------------------------
--------------------------------------------------------------------------------------------------------------------------------------------------------------
--------------------------------------------------------------------------------------------------------------------------------------------------------------
--------------------------------------------------------------------------------------------------------------------------------------------------------------
--------------------------------------------------------------------------------------------------------------------------------------------------------------
-------------------------------------------------------------------------C---------------------------------------------SSS----S!!S----------------------------
--------------------------------------------------------------------------------------SSS----SSS!-------------#-----------------------------------------------
-------------!---------S@S!S----SU----------!---S@S!S----S-------SS!------------SSS!--------------------------##----------------------------------------------
---SSS!-------------------------------------------------------------------------------------------------------###------------------------SSS----SSS!----------
-------------------tt------------------------------------------------------------------------------gg----M----####-g-g---------SS-----------------------------
-------------------tt-------------gg-g-g-------------------M----------gg-g-g------g-g------XXXXXXXXXXXXXXXXXX-XXXXXXXXXXXXXXXXX-------#-----------------------
XXXXXXXXXXX-----------XX---XXXXXXXXXXXXXXXXXXXXXX---XXXXXXXXXXXXXXXXXXXXXXXXXXXXXXXXXXXX---XXXXXXXXXXXXXXXXXX-XXXXXXXXXXXXXXXXX------##-----------g-g--------k
XXXXXXXXXXX---XXXXXX-------XXXXXXXXXXXXXXXXXXXX-----XXXXXXXXXXXXXXXXXXXXXXXXXXXXXXXXXXXXXXXXXX---------------------------------------g-g--------k-XXXXXXXXXXXX
