--------------------------------------------------------------------------------------------------------------------------------------------------------------------------------------------
--------------------------------------------------------------------------------------------------------------------------------------------------------------------------------------------
--------------------------------------------------------------------------------------------------------------------------------------------------------------------------------------------
--------------------------------------------------------------------------------------------------------------------------------------------------------------------------------------------
--------------------------------------------------------------------------------------------------------------------------------------------------------------------------------------------
--------------------------------------------------------------------------------------------------------------------------------------------------------------------------------------------
-------------------------------------------------------------------------------------------------------#------------------------------------------------------------------------------------
------------------------------------------------------------------------##--------------##------------##------------------------------------------------------------------------------------
------------------------------------------------------------------------##--------------##-----------###------------------------------------------------------------------------------------
-----------------------------------------------------------SSS----SSS!--##--------------##----------####----!-------------------------------------------------------------------------------
---------------#--------------------------------------------------------##--------------##---------#####--------------#------SS!S-------------------------------C----------SU------------!--
---------------##-------------------------------------------------------##--------------##------t-######----------tt--##----------------------------SSS!------------------------------------
---------------###-------------------------------------------------####-##-----tt#########---------####-----------tt--###-------------------------------------------------------------------
-M--------M----####------------gg----gg-g-g--gg----M---g-g-----XXXXXXXXXXXXXXXXXXXXXXXXXXXXXXXXXXXXXXXXXXXXXtt#######-####--------gg-g-g------gg-g--------tt#######-------------####--------
XXXXXXXXXXXXXX-XXXXX---XXXXXXXXXXXXXXXXXXXXXXXXXXXXXXXXXXXXXXXXXXXXXXXXXXXXXXXXXXXXXXXXXXXXXXXXXXXXXXXXXXXXXXXXXXXXXX-XXXXXXXXXXXXXXXXXXXXXXXXXXXXXXXXXXXXXXXXXXXXX---XXXXXXXXXXXXXXXXXXXXXX
XXXXXXXXXXXXXX-XXXXX---XXXXXXXXXXXXXXXXXXXXXXXXXXXXXXXXXXXXXXXXXXXX-----------------------------------------XXXXXXXXX-XXXXXXXXXXXXXXXXXXXXXXXXXXXXXXXXXXXXXXXXXXXXX---XXXXXXXXXXXXXXXXXXXXXX
