------------------------------------------------------------------------------------------------------------------------------------------------------------------
------------------------------------------------------------------------------------------------------------------------------------------------------------------
------------------------------------------------------------------------------------------------------------------------------------------------------------------
------------------------------------------------------------------------------------------------------------------------------------------------------------------
------------------------------------------------------------------------------------------------------------------------------------------------------------------
------------------------------------------------------------------------------------------------------------------------------------------------------------------
------------------------------------------------------------------------------------------------------------------------------------------------------------------
-------------------------------------------------------------------------------------------##---------------------------------------------------------------------
------------------------------------------------###----------------------------------------##---------------------------------SSS----SSS!-------------------------
-----------------------------------------------####------------------------SSS----SSS!-----##------------SS!S------------C----------------------------------------
-------C--------------!---S@S!S----SU---------#####-------------C--------------------------##---------------------------------------------------------------------
---------------C-----------------------------######----------------------------------------##--------------------------------------------tt#######-gg-g-g---------
--------------------------------------------#######-----------------tt---------------------##------M-----------------gg---g-g------XXXXXXXXXXXXXXXXXXXXXX---XXXXXX
-M-----###-----------------g-----####--M-t-########-----------------tt-g-g------XXXXXXXXXXXXXXXXXXXXXXXXXXXXXXXXXXXXXXXXXXXXXXXX---XXXXXXXXXXXXXXXXXXXXXX---XXXXXX
XXXXXXXXXXXXXXXXXXXXXXXXXXXXXXXXXXXXXXXXXXXXXXXXXXXXXXXX---XXXXXXXXXXXXXXXXXX---XXXXXXXXXXXXXXXXXXXXXXXXXXXXXXXXXXXXXXXXXXXXXXXXXXXXXX----------------------------
XXXXXXXXXXXXXXXXXXXXXXXXX----XXXXXXXXXXXXXXXXXXXXXXXXXXX---XXXXXXXXXXXXXXXXXXXXXXXX-------------------------------------------------------------------------------
