---------------------------------------------------------------------------------------------------------------------------------------------------------------------------
---------------------------------------------------------------------------------------------------------------------------------------------------------------------------
---------------------------------------------------------------------------------------------------------------------------------------------------------------------------
---------------------------------------------------------------------------------------------------------------------------------------------------------------------------
---------------------------------------------------------------------------------------------------------------------------------------------------------------------------
---------------------------------------------------------------------------------------------------------------------------------------------------------------------------
---------------------------------------------------------------------------------------------------------------------------------------------------------------------------
---------------------------------------------------------------------------------------------------------------------------------------------------------------------------
-------------------------##--------------------------------------------SSS----S!!S------------------------------------------------------------------S!---------------------
-------------------------##-------------------------------SSS----SSS!-----------------------------------------------------------------------------------SSS----SSS!---#----
-------!----SS!S---------##------#--------------------------------------------------------------------SSS----SSS!------!---S@S!S----SU---------#----------------------##---
-------------------------##------##------------------------------------------------------SSS----SSS!-------------------------------------------##---------------------###--
-------------------------##------###-----tt------------------------g-g---------SS--------------------------------------------------------------###---S----------####--####-
-M--------------tt#########------####-----####--gg-g-gg-g--------k-XXXXXXXXXXXX-------#-----------------------####----------g-tt#######-gg-g-g-####-g-g-----XXXXXXXXX-XXXXX
XXXXXXXXXXXXXXXXXXXXXXXXXXXXXXXX-XXXXXXXXXXXXXXXXXXXXXXXXXXXXXXXXX-XXXXXXXXXXXX------##-----------g-g-----XXXXXXXXXXXXXXXXXXXXXXXXXXXXXXXXXXXX-XXXXXXXXXXXXXXXXXXXXXX-XXXXX
XXXXXXXXXXXXXXXXXXXXXXXXXXXXXXXX-XXXXXXXXXXXXXXXXXXXXXXXXXXXXXXXXX-------------------g-g--------k-XXXXXXXXXXXXXXXXXXXXXXXX----XXXXXXXXXXXXXXXX-XXXXXXXXXXXXXXXXX-----------
