------------------------------------------------------------------------------------------------------------------------------------------------------------------------------------------
------------------------------------------------------------------------------------------------------------------------------------------------------------------------------------------
------------------------------------------------------------------------------------------------------------------------------------------------------------------------------------------
------------------------------------------------------------------------------------------------------------------------------------------------------------------------------------------
------------------------------------------------------------------------------------------------------------------------------------------------------------------------------------------
------------------------------------------------------------------------------------------------------------------------------------------------------------------------------------------
------------------------------------------------------------------------------------------------------------------------------------------------##----------------------------------------
------------------------------------------------------------------------------------------------------------------------------------------------##----------------------------------------
-----------------------------------------------------------------------------------------------------------------------------------SSS----SSS!--##--------------SS!S--------#-------------
----------------------------------------------------------------------------------------------------------------------SSS----SSS!---------------##--------------------------##------------
--------------#------SS!S----------------------------SS!S-#-----------------C------SS!--------------#---SS--------------------------------------##--------------------------###-----------
--------------##------------------------------------------##-------------------------------#-------##-------SSS!-----------------------tt#########-------gg----------gg-g-g-####-----####-
--------------###-----------------------------------------###-----------------------------##------###--------------------------g-g-----XXXXXXXXXXXXXXXXXXXXXXXXXXXXXXXXXXXX-XXXXXXXXXXXXXX
-M-------M----####---------gg----------gg----gg-g-g-------####-----####-tt#######--------###-----####-------------g-g--------k-XXXXXXXXXXXXXXXXXXXXXXXXXXXXXXXXXXXXXXXXXXXX-XXXXXXXXXXXXXX
XXXXXXXXXXXXX-XXXXXXXXXXXXXXXXXXXXXXXXXXXXXXXXXXXXXXXXXXX-XXXXXXXXXXXXXXXXXXXXXXXXXXXXXXXXXXXXXXXXXXXXXXXXXXXXXXXXXXXXXXXXXXXX-XXXXXXXXXXXX-----------------------------------------------
XXXXXXXXXXXXX-XXXXXXXXXXXXXXXXXXXXXXXXXXXXXXXXXXXXXXXXXXX-XXXXXXXXXXXXXXXXXXXXXXXXXXXXXXXXXXXXXXXXXXXXXXXXXXXXXXXXXXXXXXXXXXXX------------------------------------------------------------
