-----------------------------------------------------------------------------------------------------------------------------------------------------------------------------------
-----------------------------------------------------------------------------------------------------------------------------------------------------------------------------------
-----------------------------------------------------------------------------------------------------------------------------------------------------------------------------------
-----------------------------------------------------------------------------------------------------------------------------------------------------------------------------------
-----------------------------------------------------------------------------------------------------------------------------------------------------------------------------------
-----------------------------------------------------------------------------------------------------------------------------------------------------------------------------------
-----------------------------------------------------------------------------------------------------------------------------------------------------------------------------------
-----------------------------------------------------------------------------------------------------------------------------------------------------------------------------------
---------------------------------------------##----------##--------------------------------------------------------------------------------------------------------C---------------
---------------------------------------------##----------##-----------------------------SSS----SSS!------SU-----!------------------------------------------------------------------
----------------------------------S------SS!S##----------##--------------------#-----------------------------------------------#----------------------------------------SS!S-------
---------------------------------------------##----------##--------------------##----#--------------------------------t--------##------C-------------------------------------------
---------------------------------------------##----------##--------------------##---##-----------------####-----------t--------###-------------------------------------------------
-M--------------####--M----------------------##------M---##------M-------####--####-g-g------XXXXXXXXXXXXXXXXX-----------gg----###---------------gg-------------gg-g-g--------gg---
XXX---XXXXXXXXXXXXXXXXXXXXXXXXXXXXXXXXXXXXXXXXXXXXXXXXXXXXXXXXXXXXXXXXXXXXXXXX-XXXXXXXXXXX---XXXXXXXXXXXXXXXXX---XXXXXXXXXXXXX-XXXXXXXXXXXXXXXXXXXXXXX---XXXXXXXXXXXXXXXXXXXXXXXXXX
XXX---XXXXXXXXXXXXXXXXXXXXXXXXXXXXXXXXXXXXXXXXXXXXXXXXXXXXXXXXXXXXXXXXXXXXXXXX-XXXXXXXXXXXXXXXXX-----------------XXXXXXXXXXXXX-XXXXXXXXXXXXXXXXXXXXXXX---XXXXXXXXXXXXXXXXXXXXXXXXXX
