----------------------------------------------------------------------------------------------------------------------------------------------------------------------------
----------------------------------------------------------------------------------------------------------------------------------------------------------------------------
----------------------------------------------------------------------------------------------------------------------------------------------------------------------------
----------------------------------------------------------------------------------------------------------------------------------------------------------------------------
----------------------------------------------------------------------------------------------------------------------------------------------------------------------------
------------------------------------------------------------------------------------------------------------------------------------##--------------------------------------
-------------------------------------------------------------------------------------------------------------------S!!S-------------##--------------------------------------
------------------------------------------------------------------------------------------SS!S----!----------SS!S---------------SS!S##------------------C-------------------
------------------##----------------------------------------------------!---S@S!S----SU---------------------------------------------##-----------------------------------C--
------------------##-----------------------------------SSS----SSS!--------------------------------------tt--------------------------##--------------------------------------
-------------#----##---------!---S@S!S----SU--#-----C---------------------------------------------------tt----------SS--gg-g-g------##-------gg---tt#######-----------------
-------------##---##--------------------------#------------------------------g----XXXXXXXXXXXXXX----S------XXXXXXXXXXXXXXXXXXXXXXXXXXXXXXXXXXXXXXXXXXXXXXXXXXXXXXXXXXXXXXXXX
-------------###--##--------------------------#---------------XXXXXXXXXXXXXXXXXXXXXXXXXXXXXXXXXX-----------XXXXXXXXXXXXXXXXXXXXXXXXXXXXXXXXXXXXXXXXXXXXXXXXXXXXXXXXXXXXXXXXX
-M-----####--####-##--------------g-tt#######-####-g-g--------XXXXXXXXXXXXX-------------------------------------------------------------------------------------------------
XXXXXXXXXXXX-XXXXXXXXXXXXXXXXXXXXXXXXXXXXXXXX-XXXXXXXXXXXXXXXXX-------------------------------------------------------------------------------------------------------------
XXXXXXXXXXXX-XXXXXXXXXXXXXXXXXXX----XXXXXXXXX-XXXXXXXXXXXXXXXXX---------------------------------XXXXXXXXX-------------------------------------------------------------------
