-----------------------------------------------------------------------------------------------------------------------------------------------------------------------
-----------------------------------------------------------------------------------------------------------------------------------------------------------------------
-----------------------------------------------------------------------------------------------------------------------------------------------------------------------
-----------------------------------------------------------------------------------------------------------------------------------------------------------------------
-----------------------------------------------------------------------------------------------------------------------------------------------------------------------
-----------------------------------------------------------------------------------------------------------------------------------------------------------------------
-----------------------------------------------------------------------------------------------------------------------------------------------------------------------
-----------------------------------------------------------------------------------------------------------------------------------------------------------------------
---##----------------------------------------------##-----------------------------------------SSS----S!!S---------------------------------S!---------------------------
---##----------------------------------------------##-------------#--------------SSS----SSS!--------------------------------------------------SSS----SSS!--------------
---##-------SS!S---------------SSS!------!---S@S!S-##------------##--------SSS!----------------------------------------------SSS----SSS!-------------------------------
---##----------------------------------------------##-----------###---------------------------------------------SSS----SSS!--------------------------------------------
---##----------------------------------------------##--------t-####-----------------------g-g---------SS-----------------------------------S------tt#######g-g--------k
-M-##-------------gg----M---tt#######---------g----##---------------M--------g-g--------k-XXXXXXXXXXXX-------#-------------------tt#######g-g-----XXXXXXXXXXXXXXXXXXXXX
XXXXXXXXXXXXXXXXXXXXXXXXXXXXXXXXXXXXXXXXXXXXXXXXXXXXXXXXXX---XXXXXXXXXXXXXXXXXXXXXXXXXXXX-XXXXXXXXXXXX------##-----------g-g-----XXXXXXXXXXXXXXXXXXXXXXXXXXXXXXXXXXXXXX
XXXXXXXXXXXXXXXXXXXXXXXXXXXXXXXXXXXXXXXXXXXX-------XXXXXXX---XXXXXXXXXXXXXXXXXXXXXXXXXXXX-------------------g-g--------k-XXXXXXXXXXXXXXXXXXXXXXXXXXXXX-----------------
