---------------------------------------------------------------------------------------------------------------------------------------------------------------------------------------
---------------------------------------------------------------------------------------------------------------------------------------------------------------------------------------
---------------------------------------------------------------------------------------------------------------------------------------------------------------------------------------
---------------------------------------------------------------------------------------------------------------------------------------------------------------------------------------
---------------------------------------------------------------------------------------------------------------------------------------------------------------------------------------
---------------------------------------------------------------------------------------------------------------------------------------------------------------------------------------
---------------------------------------------------------------------------------------------------------------------------------------------------------------------------------------
--------------------------------------------------------------------------------------------------------------#------------------------------------##----------------------------------
-----------------------------S!!S##------------------------C-------------------------------------------------##------------------------------------##----------------------------------
---------------------------------##-------------------------------------------------------------------------###----SSS----SSS!---#--------!----SS!S##-----------------------------#----
---------------------------------##------#------------------------C----------#---------------C----SS!S-----####------------------##----------------##-----------------------------##---
----------------tt---------------##------##---------tt-----------------------##---------------------------#####------------------###---------------##-----------------------------###--
----------------tt------------SS-##------###--------tt-----------------------###-----------------------t-######--------tt#######-####--------------##---------------M-------------####-
-M---gg-------####--M---tt#########------####-----####--gg-g-gtt#######-M----####------tt#######----------####-g-g-----XXXXXXXXX-XXXXXXXXXXXXXXXXXXXXXXXXX---XXXXXXXXXXX---XXXXXX-XXXXX
XXXXXXXXXXXXXXXXXXXXXXXXXXXXXXXXXXXXXXXX-XXXXXXXXXXXXXXXXXXXXXXXXXXXXXXXXXXX-XXXXXXXXXXXXXXXXXXXXXXXXXXXXXXXXXXXXXXXXXXXXXXXXXXX-XXXXXXXXXXXXXXXXXXXXXXXXX---XXXXXXXXXXX---XXXXXX-XXXXX
XXXXXXXXXXXXXXXXXXXXXXXXXXXXXXXXXXXXXXXX-XXXXXXXXXXXXXXXXXXXXXXXXXXXXXXXXXXX-XXXXXXXXXXXXXXXXXXXXXXXXXXXXXXXXXXXXXXXXXXXXXX------------------------------------------------------------
