------------------------------------------------------------------------------------------------------------------------------------------------------------------------
------------------------------------------------------------------------------------------------------------------------------------------------------------------------
------------------------------------------------------------------------------------------------------------------------------------------------------------------------
------------------------------------------------------------------------------------------------------------------------------------------------------------------------
------------------------------------------------------------------------------------------------------------------------------------------------------------------------
------------------------------------------------------------------------------------------------------------------------------------------------------------------------
------------------------------------------------------------------------------------------------------------------------------------------------------------------------
-------------------------------------------------------------------------------------------------------------------------#----------------------------------------------
-----------------------------SSS----S!!S--------------------------------------------------------------------------------##---------------------------------------------#
----------------SSS----SSS!--------------------------------------------------------------------------------------------###--------------------------------------------##
-----------C-----------------------------------------------------------------------------------------------SS!S-------####----C------!--------SSS----SSS!------------###
-----------------------------------------------SSS----SSS!-----------------------------------------------------------#####------------------------------------------####
-------------------------g-g---------SS---------------------------------------------------------------------------t-######-----------------t-----------------------#####
-M----------g-g--------k-XXXXXXXXXXXX-------#--------------------------gg---------gg-g-g-------gg---------------------------####-----------t-----------------###t-######
XXX---XXXXXXXXXXXXXXXXXX-XXXXXXXXXXXX------##---------XXXXXX---XXXXXXXXXXXXXXXXXXXXXXXXXXXXXXXXXXXXXXXXXXXXXXXX---XXXXXXXXXXXXXXXXXXXXXX--g-g------XXXXXXXXXXXXXXXXXXXXX
XXX---XXXXXXXXXXXXXXXXXX-------------------g-g--------XXXXXX---XXXXXXXXXXXXXXXXXXXXXXXXXXXXXXXXXXXXXXXXXXXXXXXX---XXXXXXXXXXXXXXXXXXXXXX--XXXXXX---XXXXXXXXXXXXXXXXXXXXX
