------------------------------------------------------------------------------------------------------------------------------------------------------------------------------------------------------
------------------------------------------------------------------------------------------------------------------------------------------------------------------------------------------------------
------------------------------------------------------------------------------------------------------------------------------------------------------------------------------------------------------
------------------------------------------------------------------------------------------------------------------------------------------------------------------------------------------------------
------------------------------------------------------------------------------------------------------------------------------------------------------------------------------------------------------
------------------------------------------------------------------------------------------------------------------------------------------------------------------------------------------------------
------------------------------------------------------------------------------------------------------------------------------------------------------------------------------------------------------
------------------------------------------------------------------------------------------------------------------------------------------------------------------------------------------------------
-------------------------------------------------------##-----------------------------------##--------------------------------------------------------------------------------------------------------
-------------------------------------------------------##-----------------------------------##----------------SSS-----------------------------------------------------------------------------SSS-----
---------------------------------------------------SS!S##----------------SU-----------------##-------SS!S-----------SS!S--------------SS!S----------!----------SS!S---------------C-----SSS!----------
-------#-----------------------------------------------##-----------------------------------##--------------------------------------------------------------------------------------------------------
------##-----------------------------------------------##-----------------------------------##------------------------------------------------------------tt------------------------------------------
-M---###--gg-g-g----####-tt#######---------------------##--------------####---gg------------##-----------tt#######-------------gg-------------------------tt-----------####-----------M---g-g--------k
XXXXXXXXXXXXXXXXXXXXXXXXXXXXXXXXXXXXXXXX---XXXXXXXXXXXXXXXXXXXXXXXXXXXXXXXXXXXXXXXX---XXXXXXXXXXXXXXXXXXXXXXXXXXXXXXXXXXXXXXXXXXXXXXXXXXXXXXXXXXXXXXtt#######XXXXXXXXXXXXXXX---XXXXXXXXXXXXXXXXXXXXXXX
XXXXXXXXXXXXXXXXXXXXXXXXXXXXXXXXXXXXXXXX---XXXXXXXXXXXXXXXXXXXXXXXXXXXXXXXXXXXXXXXX---XXXXXXXXXXXXXXXXXXXXXXXXXXXXXXXXXXXXXXXXXXXXXXXXXXXXXXXXXXXXXXXXXXXXXXXXXXXXXXXXXXXXXX---XXXXXXXXXXXXXXXXXXXXXXX
