----------------------------------------------------------------------------------------------------------------------------------------------------------------------------------------------------------
----------------------------------------------------------------------------------------------------------------------------------------------------------------------------------------------------------
----------------------------------------------------------------------------------------------------------------------------------------------------------------------------------------------------------
----------------------------------------------------------------------------------------------------------------------------------------------------------------------------------------------------------
----------------------------------------------------------------------------------------------------------------------------------------------------------------------------------------------------------
----------------------------------------------------------------------------------------------------------------------------------------------------------------------------------------------------------
----------------------------------------------------------------------------------------------------------------------------------------------------------------------------------------------------------
----------------------------------------------------------------------------------------------------------------------------------------------------------------------------------------------------------
---------------------------------------------------------------------------------------------------------------##------------##--------------------------------##-------------------------------##--------
---------------------------------------------------------------------------------------------------------------##------------##--------------------------------##-------------------------------##--------
-------------------SS!S----------#-------SSS!-----SSS!--------------------------SS!S--SSS------------------SSS!##------------##-------SS!S-----------!---S@S!S-##-------SS!S----!---------S@S!S-##--------
---------------------------------##----------------------------------------------------------------------------##------------##--------------------------------##-------------------------------##--------
---------------------------------###---------------------------------------------------------------------------##------------##--------------------------------##---------------------tt--------##--------
-M-------------------------------####-----####-tt#######----------####--gg-g-g-------------M-----gg------------##------gg-g-g##-------------gg------------g----##---------------------tt---g----##--------
XXXXXXXX---XXXXXXXXXXXX---XXXXXX-XXXXXXXXXXXXXXXXXXXXXXXXXXXXXXXXXXXXXXXXXXXXXXXXXXXXXXXXXXXXXXXXXXXXX---XXXXXXXXXXXXXXXXXXXXXXXXXXXXXXXXXXXXXXXXXXXXXXXXXXXXXXXXXXXXXXXXXXXXX-----------XXXXXXXXXXXXXXXXX
XXXXXXXX---XXXXXXXXXXXX---XXXXXX-XXXXXXXXXXXXXXXXXXXXXXXXXXXXXXXXXXXXXXXXXXXXXXXXXXXXXXXXXXXXXXXXXXXXX---XXXXXXXXXXXXXXXXXXXXXXXXXXXXXXXXXXXXXXXXXXXXXXX-------XXXXXXXXXXXXXXX---XXXXXX---------XXXXXXXXXX
