--------------------------------------------------------------------------------------------------------------------------------------------------------------------------------------------------------
--------------------------------------------------------------------------------------------------------------------------------------------------------------------------------------------------------
--------------------------------------------------------------------------------------------------------------------------------------------------------------------------------------------------------
--------------------------------------------------------------------------------------------------------------------------------------------------------------------------------------------------------
--------------------------------------------------------------------------------------------------------------------------------------------------------------------------------------------------------
--------------------------------------------------------------------------------------------------------------------------------------------------------------------------------------------------------
--------------------------------------------------------------------------------------------------------------------------------------------------------------------------------------------------------
--------------------------------------------------------------------------------------------##----------------------------------------------------------------------------------------------------------
--------------------------------------------------------------------------------------------##----------------------------------------------------------------------------------------------------------
----------------------------------SU----------------------------!---S@S!S----SU-------------##-------------#-------------------------#------SS!S-#------------------------------------------------------
-------!---S@S!S----SU----------------------------------------------------------------------##-------------##-------------SU---------##----------##-----------------------------------------------------
--------------------------------------------------------------------------------------------##-------------###-----------------------###---------###----------------------------------------------------
--------------------------------####---------------------------------g-tt#######-------gg---##-------gg----####--gg-g-g-------gg-g-g-####--------####---gg---------gg-g-g-------gg----gg-g-g--gg--------
-M----------g----XXXXXXXXXXXXXXXXXXXX---XXXXXXXXXXX---XXXXXXXXXXXXXXXXXXXXXXXXXXXXXXXXXXXXXXXXXXXXXXXXXXXX-XXXXXXXXXXXXXXXXXXXXXXXXX-XXXXXXXXXXX-XXXXXXXXXXXXXXXXXXXXXXXXXXXXXXXXXXXXXXXXXXXXXXXXXXXXXXX
XXXXXXXXXXXXXXXXXXXXXXXXXXXXXXXXXXXXX---XXXXXXXXXXX---XXXXXXXXXXXXX----XXXXXXXXXXXXXXXXXXXXXXXXXXXXXXXXXXX-XXXXXXXXXXXXXXXXXXXXXXXXX-XXXXXXXXXXX-XXXXXXXXXXXXXXXXXXXXXXXXXXXXXXXXXXXXXXXXXXXXXXXXXXXXXXX
XXXXXXXXXX----------------------------------------------------------------------------------------------------------------------------------------------------------------------------------------------
