--------------------------------------------------------------------------------------------------------------------------------------------------------------------------------------
--------------------------------------------------------------------------------------------------------------------------------------------------------------------------------------
--------------------------------------------------------------------------------------------------------------------------------------------------------------------------------------
--------------------------------------------------------------------------------------------------------------------------------------------------------------------------------------
--------------------------------------------------------------------------------------------------------------------------------------------------------------------------------------
--------------------------------------------------------------------------------------------------------------------------------------------------------------------------------------
--------------------------------------------------------------------------------------------------------------------------------------------------------------------------------------
--------------------------------------------------------------------------------------------------------------------------------------------------------------------------------------
------------------------------------------##-----------------------------------------------------S!!S------------------------------------------------#----------#------SS-------------
------------------------------------------##-------------------------------------------------------------------------------SSS----SSS!---------------##---------##------------C-------
----#----------SU---------SU---------#----##-----------------------------#---------------------------------#-----------------------------------------###--------###-------------------
----##-------------------------------##---##-----------------------------##--------------------------------##-----------#----------------------gg----####-------####------------------
----###------------------------------###--##-----------------------------###----------------------SS-------###---------##---------XXXXXXXXXXXXXXXXXX-XXXXXXXXXX-XXXXXXXXXXXXXXXXXXXXXX
-M--####-----####--------------####--####-##-------gg----gg-g-gtt#######-####--gg-g-g--gg-------####-------####---gg---g-g--------XXXXXXXXXXXXXXXXXX-XXXXXXXXXX-XXXXXXXXXXXXXXXXXXXXXX
XXX-XXXXXXXXXXXXXX---XXXXXXXXXXXXXXX-XXXXXXXXXXXXXXXXXXXXXXXXXXXXXXXXXXX-XXXXXXXXXXXXXXXXXXXXXXXXXXXXXXXXX-XXXXXXXXXXXXXXXXXXXXXXXX---------------------------------------------------
XXX-XXXXXXXXXXXXXX---XXXXXXXXXXXXXXX-XXXXXXXXXXXXXXXXXXXXXXXXXXXXXXXXXXX-XXXXXXXXXXXXXXXXXXXXXXXXXXXXXXXXX-XXXXXXXXXXXXXXXXXXXXXXXX---------------------------------------------------
