----------------------------------------------------------------------------------------------------------------------------------------------------------------------------------------------------------
----------------------------------------------------------------------------------------------------------------------------------------------------------------------------------------------------------
----------------------------------------------------------------------------------------------------------------------------------------------------------------------------------------------------------
----------------------------------------------------------------------------------------------------------------------------------------------------------------------------------------------------------
----------------------------------------------------------------------------------------------------------------------------------------------------------------------------------------------------------
----------------------------------------------------------------------------------------------------------------------------------------------------------------------------------------------------------
----------------------------------------------------------------------------------------------------------------------------------------------------------------------------------------------------------
----------------------------------------------------------------------------------------------------------------------------------------------------------------------------------------------------------
----------------------------------------------------------------------------------------------------------------------------------------------------------------------------------------------------------
------------------------#---------------------------------------------------------------------------------------------------------------------------------------------------------------------------------
-------!----SS!S-------##-------------------------C----SS!S-------------------------------------------SS!S---------------#---------------C--------------------------------------------!----SS!S-#---------
----------------------###--------------------------------------------------------------------------t---------------------##------------------------------------C--------------------------------##--------
-------------------t-####--------------------------------------------------------------------------t---------------------###--------------------------------------------------------------------###-------
-M-----------------------------gg-g-g--gg-------####-----------####-------------gg-g-g-M----------------------------M----####--gg-g-gtt#######-----------g-----------M--------------------------####------
XXXXXXXXXXXXXXXX---XXXXXXXXXXXXXXXXXXXXXXXXXXXXXXXXXXXXXXXXXXXXXXXXXXXXXXXXXXXXXXXXXXXXXXXX---XXXXXXXXXXXX---XXXXXXXXXXX-XXXXXXXXXXXXXXXXXXXXX---XXXXXXXXXXXXXXXXXXXXXXXX---XXXXXXXXXXXXXXXXXXX-XXXXX---XX
XXXXXXXXXXXXXXXX---XXXXXXXXXXXXXXXXXXXXXXXXXXXXXXXXXXXXXXXXXXXXXXXXXXXXXXXXXXXXXXXXXXXXXXXX---XXXXXXXXXXXX---XXXXXXXXXXX-XXXXXXXXXXXXXXXXXXXXX---XXXXXXXXXXXXXXXXXXXXXXXX---XXXXXXXXXXXXXXXXXXX-XXXXX---XX
