--------------------------------------------------------------------------------------------------------------------------------------------------------------------------------------------
--------------------------------------------------------------------------------------------------------------------------------------------------------------------------------------------
--------------------------------------------------------------------------------------------------------------------------------------------------------------------------------------------
--------------------------------------------------------------------------------------------------------------------------------------------------------------------------------------------
--------------------------------------------------------------------------------------------------------------------------------------------------------------------------------------------
--------------------------------------------------------------------------------------------------------------------------------------------------------------------------------------------
--------------------------------------------------------------------------------------------------------------------------------------------------------------------------------------------
---------------------------------------------------------------------------#---------------#------------------------------------------------------------------------------------------------
--------------------------------------------------------------------------####------------####--------------------------------------------------------##------------------------------------
-------------------------------------------------------------------------#####-----------#####--------------------------------------------------------##----------------------------SSS-----
----------#-------------------------------SSS---------------------------######----------######---------!----------SS!S------C-----SSS!------!---S@S!S-##------------------------------------
----------##-------------------------------------------------t---------#######---------#######--------------------------------------------------------##-------------------------#----------
----------###------------------------------------------------t------t-########------t-########--------------------------------------------------------##------------------------##----------
-M--------####-tt#######----------gg-g-g-------gg-g-g----------M-------####-##---------####-##-------------gg----------------------####----------g----##-------gg----M-----gg---g-g--------k
XXXXXXXXX-XXXXXXXXXXXXXX---XXXXXXXXXXXXXXXXXXXXXXXXXX---XXXXXXXXXXXXXXXXXXXXXXXXXXXXXXXXXXXXXXXXXXXXXXXXXXXXXXXXXXXXXX---XXXXXXXXXXXXXXXXXXXXXXXXXXXXXXXXXXXXXXXXXXXXXXXXXXXXXXXXXXXXXXXXXXX
XXXXXXXXX-XXXXXXXXXXXXXX---XXXXXXXXXXXXXXXXXXXXXXXXXX---XXXXXXXXXXXXXXXXXXXXXXXXXXXXXXXXXXXXXXXXXXXXXXXXXXXXXXXXXXXXXX---XXXXXXXXXXXXXXXXXXXXXX-------XXXXXXXXXXXXXXXXXXXXXXXXXXXXXXXXXXXXXX
