------------------------------------------------------------------------------------------------------------------------------------------------------------------
------------------------------------------------------------------------------------------------------------------------------------------------------------------
------------------------------------------------------------------------------------------------------------------------------------------------------------------
------------------------------------------------------------------------------------------------------------------------------------------------------------------
------------------------------------------------------------------------------------------------------------------------------------------------------------------
------------------------------------------------------------------------------------------------------------------------------------------------------------------
------------------------------------------------------------------------------------------------------------------------------------------------------------------
-------------------------------------------------------------------------------------------SSS----S!!S------------------------------------------------------------
-------------------------------SS!S------------SU---------------------SS!S------------C---------------------------------------------------------------------------
----------------SSS----SSS!-------------------------#-----------------------------------------------------------------------SS-----------------SS!S---------------
------------#-------------------------tt------------##-------------------------------------------------------SSS----SSS!--------SSS!------------------------------
-----------##-------------------------tt-----####--####--------gg-----------gg---------g-g---------SS-------------------------------------------------------------
----------###----------XXXXXXXXXXXXXXXXXXXXXXXXXXX-XXXXXXXXXXXXXXXXXXXXXXXXXXXXXXXXXXXXXXXXXXXXXXXX-------#----------------------------gg-g-g---------------------
-M----------g-g--------XXXXXXXXXXXXXXXXXXXXXXXXXXX-XXXXXXXXXXXXXXXXXXXXXXXXXXXXXXXXXXXXXXXXXXXXXXXX------##---------XXXXXXXXXXXXXXXXXXXXXXXXXXXXXXX---XXXXXXXXXXXX
XXX---XXXXXXXXXXXXXXXXXX---------------------------------------------------------------------------------g-g--------XXXXXXXXXXXXXXXXXXXXXXXXXXXXXXX---XXXXXXXXXXXX
XXX---XXXXXXXXXXXXXXXXXX---------------------------------------------------------------------------------XXXXXXXXXXXX---------------------------------------------
