---------------------------------------------------------------------------------------------------------------------------------------------------------------------------------------------
---------------------------------------------------------------------------------------------------------------------------------------------------------------------------------------------
---------------------------------------------------------------------------------------------------------------------------------------------------------------------------------------------
---------------------------------------------------------------------------------------------------------------------------------------------------------------------------------------------
---------------------------------------------------------------------------------------------------------------------------------------------------------------------------------------------
---------------------------------------------------------------------------------------------------------------------------------------------------------------------------------------------
---------------------------------------------------------------------------------------------------------------------------------------------------------------------------------------------
---------------------------------------------------------------------------------------------------------------------------------------------------------------------------------------------
--------------------------------------------C--------##------------------------------------------------------------------##--------------------------------##-----------##-------------------
-----------------------------------------------------##------------------------------------------------------------------##--------------------------------##-----------##-------------------
----------------C--------SU----------------------SS!S##----------------------------SS!S------C-----------!---------S@S!S-##-------------SS!S---------------##------#----##---------!---S@S!S-
-----------------------------------------------------##------------------------------------------------------------------##--------C-----------------SSS!--##------##---##-------------------
-----------------------------------------------------##--------------------------------------------------------tt--------##--------------------------------##------###--##-------------------
-M--gg-g-g----####-tt#######-------gg----gg-g-g------##------M-------####---gg---------tt#######---------------tt---g----##-----------------tt#####--------##------####-##--------------g----
XXXXXXXXXXXXXXXXXXXXXXXXXXXXXXXXXXXXXXXXXXXXXXXXXXXXXXXXXXXXXXXXXXXXXXXXXXXXXXXXXXXXXXXXXXXXXXXXXXXXXXXXXtt#######XXXXXXXXXXXXXXXXXXXXXXXXXXXXXXXXXXXXXXXXXXXXXXXX-XXXXXXXXXXXXXXXXXXXXXXXXXX
XXXXXXXXXXXXXXXXXXXXXXXXXXXXXXXXXXXXXXXXXXXXXXXXXXXXXXXXXXXXXXXXXXXXXXXXXXXXXXXXXXXXXXXXXXXXXXXXXXXXXXXXXXXXXXXXXX-------XXXXXXXXXXXXXXXXXXXXXXXXXXXXXXXXXXXXXXXXX-XXXXXXXXXXXXXXXXXXX-------
