--------------------------------------------------------------------------------------------------------------------------------------------------------------------------------------------------------
--------------------------------------------------------------------------------------------------------------------------------------------------------------------------------------------------------
--------------------------------------------------------------------------------------------------------------------------------------------------------------------------------------------------------
--------------------------------------------------------------------------------------------------------------------------------------------------------------------------------------------------------
--------------------------------------------------------------------------------------------------------------------------------------------------------------------------------------------------------
--------------------------------------------------------------------------------------------------------------------------------------------------------------------------------------------------------
--------------------------------------------------------------------------------------------------------------------------------------------------------------------------------------------------------
--------------------------------------------------------------------------------------------------------------------------------------------------------------------------------------------------------
---##-----------------------------------------------------##----------------------------##-------------------------------------------------##-----------------------------------------------------------
---##-----------------------------------------------------##----------------------------##-------------------------------------------------##--------------------------#--------------------------------
---##---------!----SS!S-------------SU-----!----------SS!S##------#------SS!S--SS!S-----##-------------------------------------------------##-------------#-----------##---------C----------------------
---##-----------------------------------------------------##------##--------------------##-------------------------------------------------##-------------##---------###----------------------tt--------
---##--------------------------------------------tt-------##------###-------------------##-------------------------------------------------##-------------###-----t-####----------------------tt--------
-M-##--------------------gg---tt#######----------tt-------##------####------------------##------------gg-------####--gg-g-g----####---gg---##------gg-g-g-####-----------M-------####--------------####-
XXXXXXXXXXXXXXXXXXXXXXXXXXXXXXXXXXXXXXXXXXX----####-XXXXXXXXXXXXX-XXXXXXXXXXXXXXXXXXXXXXXXXXXXXXXXXXXXXXXXXXXXXXXXXXXXXXXXXXXXXXXXXXXXXXXXXXXXXXXXXXXXXXX-XXXXX---XXXXXXXXXXXXXXXXXXXX---XXXXXXXXXXXXXXX
XXXXXXXXXXXXXXXXXXXXXXXXXXXXXXXXXXXXXXXXXXXXXXXXXXXXXXXXXXXXXXXXX-XXXXXXXXXXXXXXXXXXXXXXXXXXXXXXXXXXXXXXXXXXXXXXXXXXXXXXXXXXXXXXXXXXXXXXXXXXXXXXXXXXXXXXX-XXXXX---XXXXXXXXXXXXXXXXXXXX---XXXXXXXXXXXXXXX
