------------------------------------------------------------------------------------------------------------------------------------------------------------
------------------------------------------------------------------------------------------------------------------------------------------------------------
------------------------------------------------------------------------------------------------------------------------------------------------------------
------------------------------------------------------------------------------------------------------------------------------------------------------------
------------------------------------------------------------------------------------------------------------------------------------------------------------
------------------------------------------------------------------------------------------------------------------------------------------------------------
------------------------------------------------------------------------------------------------------------------------------------------------------------
-------------------------------------------------------------------------------------------------------------------------------------------------------SSS--
--------------------------------------#--SSS----S!!S-------------------------------------------------------------------SS!S----------#------SSS-------------
------------------SSS----SSS!---#----##-----------------------------------------------------------------SSS----SSS!--------------tt--##---------------------
----------SSS-------------------#---###------------------------------------------------------------------------------------------tt--###--------------------
--------------------------------#t-####--------------------SSS----SSS!-----------------------------tt----------------------tt#######-####-------------------
--------------------------####--####-g-g---------SS------------------------------------------------tt----------XXXXXXXXXXXXXXXXXXXXX-XXXXXXXXXXX---XXXXXX---
-M--M-----------g-----XXXXXXXXX-XXXXXXXXXXXXXXXXX-------#----------------M----gg-g-g--gg------------g-g--------XXXXXXXXXXXXXXXXXXXXX-XXXXXXXXXXX---XXXXXX---
XXXXXXXXXXXXXXXXXXXXXXXXXXXXXXX-XXXXXXXXXXXXXXXXX------##---------XXXXXXXXXXXXXXXXXXXXXXXXX---XXXXXXXXXXXXXXXXXX--------------------------------------------
XXXXXXXXXXXXXXXXXXXXXXXXXX-----------------------------g-g--------XXXXXXXXXXXXXXXXXXXXXXXXX---XXXXXXXXXXXXXXXXXX--------------------------------------------
