-------------------------------------------------------------------------------------------------------------------------------------------------------------------------------------------
-------------------------------------------------------------------------------------------------------------------------------------------------------------------------------------------
-------------------------------------------------------------------------------------------------------------------------------------------------------------------------------------------
-------------------------------------------------------------------------------------------------------------------------------------------------------------------------------------------
-------------------------------------------------------------------------------------------------------------------------------------------------------------------------------------------
-------------------------------------------------------------------------------------------------------------------------------------------------------------------------------------------
-------------------------------------------------------------------------------------------------------------------------------------------------------------------------------------------
-------------------------------------------------------------------------------------------------------------------------------------------------------------------------------------------
-----------------------##------------------------------------------------------------------------------------------##-------------------------##-------------------##----------##----------
-----------------------##--------------------------------------SSS-------------------------------------------------##-------------------------##-------------------##----------##----------
-----SS!S-----------SU-##---------!----SS!S------C---#--------------------SSS--------#-------C-----------SS!S------##-------SS!S----!---S@S!S-##---------!---S@S!S-##----------##----------
-----------------------##----------------------------##-----------------------------##--------------------------SU-##-------------------------##-------------------##----------##----------
-----------------------##----------------------------###---------------------------###-----------------------------##-------------------------##-------------------##----------##----------
-M------------tt#########----------------------------####-tt#######---------------####-tt#######--gg---------------##--------------------g----##--------------g----##----------##------M---
XXXXXXXXXXXXXXXXXXXXXXXXXXXXXXXXXXXXXXXXXXX---XXXXXX-XXXXXXXXXXXXXXXXXXXXXXXXXXXXXXXXXXXXXXXXXXXXXXXXXXXXXXXXXXXXXXXXXXXXXXXXXXXXXXXXXXXXXXXXXXXXXXXXXXXXXXXXXXXXXXXXXXXXXXXXXXXXXXXXXXXXXX
XXXXXXXXXXXXXXXXXXXXXXXXXXXXXXXXXXXXXXXXXXX---XXXXXX-XXXXXXXXXXXXXXXXXXXXXXXXXXXXXXXXXXXXXXXXXXXXXXXXXXXXXXXXXXXXXXXXXXXXXXXXXXXXXXXXXX-------XXXXXXXXXXXXXX-------XXXXXXXXXXXXXXXXXXXXXXXX
