----------------------------------------------------------------------------------------------------------------------------------------------------------------------------
----------------------------------------------------------------------------------------------------------------------------------------------------------------------------
----------------------------------------------------------------------------------------------------------------------------------------------------------------------------
----------------------------------------------------------------------------------------------------------------------------------------------------------------------------
----------------------------------------------------------------------------------------------------------------------------------------------------------------------------
----------------------------------------------------------------------------------------------------------------------------------------------------------------------------
----------------------------------------------------------------------------------------------------------------------------------------------------------------------------
---------------------------------------------SSS----S!!S--------------------------------------------------------------------------------------------------------------------
--------------------------------SSS----SSS!------------------------------------------------------------------------------------------------------##-------------------------
-------------------SSS----SSS!-------------------------------------------------------------------------------------------------------------------##-------------------------
-----SS!S-#------------------------------------------------------------SS!S--------------------------C-----------!-------------------------------##-------SS!S--------------
----------##----t------------------------g-g---------SS------#----SU-----------------------------------------------------------------------------##-------------------------
----------###---t-----------g-g--------k-XXXXXXXXXXXX-------##---------------------------------------------------------tt------------------------##-------------------------
-M--------####-g-g--------k-XXXXXXXXXXXX-XXXXXXXXXXXX-----####--------------------M-------####-tt#######---------------tt------------gg----gg-g-g##--------------------####-
XXXXXXXXX-XXXXXXXXXXXXXXXXX-XXXXXXXXXXXX--------------XXXXXXXXXXXXXXXXXXXXXXXXXXXXXXXXXXXXXXXXXXXXXXXXXXXXXXXXXXXXXXXXXXXX---XXXXXXXXXXXXXXXXXXXXXXXXXXXXXXXXXXXXXXXXXXXXXXX
XXXXXXXXX-XXXXXXXXXXXXXXXXX---------------------------XXXXXXXXXXXXXXXXXXXXXXXXXXXXXXXXXXXXXXXXXXXXXXXXXXXXXXXXXXXXXXXXXXXX---XXXXXXXXXXXXXXXXXXXXXXXXXXXXXXXXXXXXXXXXXXXXXXX
