------------------------------------------------------------------------------------------------------------------------------------------------------------------------------------------------------
------------------------------------------------------------------------------------------------------------------------------------------------------------------------------------------------------
------------------------------------------------------------------------------------------------------------------------------------------------------------------------------------------------------
------------------------------------------------------------------------------------------------------------------------------------------------------------------------------------------------------
------------------------------------------------------------------------------------------------------------------------------------------------------------------------------------------------------
------------------------------------------------------------------------------------------------------------------------------------------------------------------------------------------------------
------------------------------------------------------------------------------------------------------------------------------------------------------------------------------------------------------
--------------------------------------SSS----S!!S-----------------------------------------------------------------------------------------------------------------------------------------------------
-------------------------SSS----SSS!--------------------------------------------------------------##-------------------------------------##-----------------------------------------------------------
------------SSS----SSS!---------------------------------------------------------------------------##-------------------------------------##---------------------------------SSS----S!!S---------------
-----------------------------------------------------------------------------------------!----SS!S##-------------------------------------##-----------C----SS!S------C--------------------------------
----------------------------------g-g---------SS------#-------------------------------------------##-------------------------------------##-----------------------------------------------------------
---------------------g-g--------k-XXXXXXXXXXXX-------##-------------------------------------------##-------------------------------------##-----------------------------------------------------------
-M------g-g--------k-XXXXXXXXXXXX-XXXXXXXXXXXX------###---gg----------gg-g-g----------------------##-------gg----gg-g-g----####----------##---------####-------tt#######g-g---------SS------#----SU---
XXXXXXXXXXXXXXXXXXXX-XXXXXXXXXXXX-----------------XXXXXXXXXXXXXXXXXXXXXXXXXX---XXXXXXXXXXXXXXXXXXXXXXXXXXXXXXXXXXXXXXXXXXXXXXXXX---XXXXXXXXXXXXXXXXXXXXXXXXXXXXXXXXXXXXXXXXXXXXXXXXX-------##---------
XXXXXXXXXXXXXXXXXXXX------------------------------XXXXXXXXXXXXXXXXXXXXXXXXXX---XXXXXXXXXXXXXXXXXXXXXXXXXXXXXXXXXXXXXXXXXXXXXXXXX---XXXXXXXXXXXXXXXXXXXXXXXXXXXXXXXXXXXXXXXXXXXXXXXXX------###---------
