---------------------------------------------------------------------------------------------------------------------------------------------------------------------------
---------------------------------------------------------------------------------------------------------------------------------------------------------------------------
---------------------------------------------------------------------------------------------------------------------------------------------------------------------------
---------------------------------------------------------------------------------------------------------------------------------------------------------------------------
---------------------------------------------------------------------------------------------------------------------------------------------------------------------------
---------------------------------------------------------------------------------------------------------------------------------------------------------------------------
---------------------------------------------------------------------------------------------------------------------------------------------------------------------------
-----------------------------------------------------------------------------------#---------------------------------------------------------------------------------------
----------------------------------------------------------------------------------##-------------------------------------------SSS----S!!S---------------------------------
---------------------------------------------------------------------------------###------------------------------SSS----SSS!----------------------------------------------
-----SS------------!----SS!S--------#------------#--------C-----#---------------####--SS!S----!---S@S!S----SU-------------------------------------------------SSS----SSS!--
---------SSS!-----------------------##-----------##-------------##------SU-----#####-------------------------------------------------------------SSS----SSS!---------------
------------------------------------###----------###------------###---------t-######---------------------------------------g-g---------SS----------------------------------
-M---------------------------gg-g-g-####---gg----####-tt#######-####-----------####----------------g-tt#######g-g--------k-XXXXXXXXXXXX-------#----------------------------
XXXXXXXXXXXXXXXXXXXXXXXXXXXXXXXXXXX-XXXXXXXXXXXX-XXXXXXXXXXXXXX-XXXXXXXXXXXXXXXXXXXXXXXXXXXXXXXXXXXXXXXXXXXXXXXXXXXXXXXXXX-XXXXXXXXXXXX------##-----------g-g--------k-----
XXXXXXXXXXXXXXXXXXXXXXXXXXXXXXXXXXX-XXXXXXXXXXXX-XXXXXXXXXXXXXX-XXXXXXXXXXXXXXXXXXXXXXXXXXXXXXXXX----XXXXXXXXXXXXXXXXXXXXX-------------------g-g--------k-XXXXXXXXXXXX-----
