-------------------------------------------------------------------------------------------------------------------------------------------------------------------------------
-------------------------------------------------------------------------------------------------------------------------------------------------------------------------------
-------------------------------------------------------------------------------------------------------------------------------------------------------------------------------
-------------------------------------------------------------------------------------------------------------------------------------------------------------------------------
-------------------------------------------------------------------------------------------------------------------------------------------------------------------------------
-------------------------------------------------------------------------------------------------------------------------------------------------------------------------------
------------------------------S!!S---------------------------------------------------------------------------------------------------------------------------------------------
-------------------#------------------------------------------------------------------------------C-----------##---------------------------------------------------------------
------------------####-------------------##------------------------------------------SSS----------------------##---------------------------------------------------------------
-----------------#####-------------------##---------------------------------SS!S------------------------------##---------!----SS!S---------------#--------------SSS!-----------
----------SS----######---------SS------#-##---------!---------S@S!S----SU----------------------------------tt-##---------------------------------##----------------------------
---------------#######----------------##-##----------------------------------------------------------------tt-##---------------------------------###---------------------------
------------t-########---------------###-##---------------tt------------------------####-------gg-g-g----####-##-----------------------tt#######-####--gg-g-g----####----------
-M--M---------------##------M-------####-##---------------tt---g----XXXXXXXXXXXXXXXXXXXXXXXXXXXXXXXXXXXXXXXXXXXXXXXXXXXXXXXXXXXXXXXXXXXXXXXXXXXX-XXXXXXXXXXXXXXXXXXXXX---XXXXXX
XXXXXXXXXXXXXXXXXXXXXXXXXXXXXXXXXXXXXXXXXXXXXXXXXXXXtt#######XXXXXXXXXXXXXXXXXXXXXXXXXXXXXXXXXXXXXXXXXXXXXXXXXXXXXXXXXXXXXXXXXXXXXXXXXXXXXXXXXXX-XXXXXXXXXXXXXXXXXXXXX---XXXXXX
XXXXXXXXXXXXXXXXXXXXXXXXXXXXXXXXXXXXXXXXXXXXXXXXXXXXXXXXXXXXX------------------------------------------------------------------------------------------------------------------
