-----------------------------------------------------------------------------------------------------------------------------------------------------------------------------------------
-----------------------------------------------------------------------------------------------------------------------------------------------------------------------------------------
-----------------------------------------------------------------------------------------------------------------------------------------------------------------------------------------
-----------------------------------------------------------------------------------------------------------------------------------------------------------------------------------------
-----------------------------------------------------------------------------------------------------------------------------------------------------------------------------------------
-----------------------------------------------------------------------------------------------------------------------------------------------------------------------S!!S--------------
-------------------------------------------------------------------------------------------------------------------------------#---------------------------------------------------------
------------------------------------------------------------------------------------------------------------------------------##---------------------------------------------------------
-----------------------------------------------------------------------------------------------------------------------------###---------------------------------------------------------
------------------------------------------------------------------------------------------------------------------#---------####-----------------!-----tt---SS!S--------SS------#-----!--
-----------------SS!S---------------------------!---------S@S!S----SU----------------------------!---S@S!S----SU--##-------#####--------C--------------tt----------------------##--------
------------------------------------------------------------------------------------------------------------------###---t-######-----------------------tt---------------------###--------
------------------------------------------------------tt----------------------------------------------------------####-tt#######-gg--------------------tt----------------tt#######-------
-M---gg--------------------------------####-----------tt---g-tt#######---------tt#######--------------g----XXXXXX-XXXXXXXXXXXXXXXXXXXXXXXXXXXXX----S--XXXXXXXXXX---XXXXXXXXXXXXXXXXXXXXXX
XXXXXXXXXXXXXXXXXXXXX---XXXXXXXXXXXXXXXXXXXXXXXXXXX------XXXXXXXXXXXXX---XXXXXXXXXXXXXXXXXXXXXXXXXXXXXXXXXXXXXXXX-XXXXXXXXXXXXXXXXXXXXXXXXXXXXX-------XXXXXXXXXX---XXXXXXXXXXXXXXXXXXXXXX
XXXXXXXXXXXXXXXXXXXXX---XXXXXXXXXXXXXXXXXXXXXXXXXXX----------XXXXXXXXX---XXXXXXXXXXXXXXXXXXXXXXXXXXX-------------------------------------------------------------------------------------
