----------------------------------------------------------------------------------------------------------------------------------------------------------------------------------------------
----------------------------------------------------------------------------------------------------------------------------------------------------------------------------------------------
----------------------------------------------------------------------------------------------------------------------------------------------------------------------------------------------
----------------------------------------------------------------------------------------------------------------------------------------------------------------------------------------------
----------------------------------------------------------------------------------------------------------------------------------------------------------------------------------------------
----------------------------------------------------------------------------------------------------------------------------------------------------------------------------------------------
----------------------------------------------------------------------------------------------------------------------------------------------------------------------------------------------
----------------------------------------------------------------------------------------------------------------------------------------------------------------------------------------------
--------------------------------------##--------------##------------------##------------------------------------------------------------------------------------------------------------------
--------------------------------------##--------------##------------------##----------------------------------------------------------------------------------------------------------SSS-----
--------------------------------------##---------C----##------#-----S@S!S-##---------!----SS!S----!---------S@S!S----SU---------------------------SU---SS!S-------------SS!-------------------
--------------------------------------##--------------##------##----------##-------------------------------------------------------------------------------------C--------------#-------------
--------------------------------------##--------------##------###---------##----------------------------tt---------------------------------------------------------------------##-------------
-M-tt#######-gg-g-g-M-----------------##-----tt#########------####---g----##----------------------------tt----------------------####---gg-------####--------------------------###-g-g--------k
XXXXXXXXXXXXXXXXXXXXXXXXXXXXX---XXXXXXXXXXXXXXXXXXXXXXXXXXXXX-XXXXXXXXXXXXXXXXXXXXXXXXXXXXXXXXXXXXtt#######XX---XXXXXXXXXXXXXXXXXXXXXXXXXXXXXXXXXXXXXXXXXXXXXXXXXXXXXXXXXXXXXXXXXXXXXXXXXXXXXX
XXXXXXXXXXXXXXXXXXXXXXXXXXXXX---XXXXXXXXXXXXXXXXXXXXXXXXXXXXX-XXXXX-------XXXXXXXXXXXXXXXXXXXXXXXXXXXXXXXXX-----XXXXXXXXXXXXXXXXXXXXXXXXXXXXXXXXXXXXXXXXXXXXXXXXXXXXXXXXXXXXXXXXXXXXXXXXXXXXXX
