-----------------------------------------------------------------------------------------------------------------------------------------------------------------------------------------------------
-----------------------------------------------------------------------------------------------------------------------------------------------------------------------------------------------------
-----------------------------------------------------------------------------------------------------------------------------------------------------------------------------------------------------
-----------------------------------------------------------------------------------------------------------------------------------------------------------------------------------------------------
-----------------------------------------------------------------------------------------------------------------------------------------------------------------------------------------------------
-----------------------------------------------------------------------------------------------------------------------------------------------------------------------------------------------------
-----------------------------------------------------------------------------------------------------------------------------------------------------------------------------------------------------
-------------------------------------------------------#---------------------------------------------------------------------------------------------------------------------------------------------
------------------------------------------------------##---------------------------------------------------------------------------------------------------------##----------------------------------
-----------------------------------------------------###---------------------------------------------------------------------------------------------------------##----------------------------------
-----SS!S----------------#--------------------------####----!---S@S!S----SU--#-----------------------------------------!----SS!S----!----SS!S------------SU------##--------------!----SS!S-#---------
------------------------##-------------------------#####---------------------##---------------tt-----------------------------------------------------------------##------------------------##--------
-----------------------###----------------------t-######---------------------###--------------tt-----------------------------------------------------------------##------------------------###-------
-M---------gg------------tt#######-gg-g-g----------####----------g-----####--####-----------####--gg-g-g-----------------------------------------------####------##------------------------####--M---
XXXXXXXXXXXXXXXX---XXXXXXXXXXXXXXXXXXXXXXXXXXXXXXXXXXXXXXXXXXXXXXXXXXXXXXXXX-XXXXXXXXXXXXXXXXXXXXXXXXXXXXXXXXXXXXXXXXXXXXXXXXXXXXXXXXXXXXXXXXXXXXXXXXXXXXXXXXXXXXXXXXXXXXXXXXXXXXXXXXXXXXX-XXXXXXXXXX
XXXXXXXXXXXXXXXX---XXXXXXXXXXXXXXXXXXXXXXXXXXXXXXXXXXXXXXXXXXXX----XXXXXXXXX-XXXXXXXXXXXXXXXXXXXXXXXXXXXXXXXXXXXXXXXXXXXXXXXXXXXXXXXXXXXXXXXXXXXXXXXXXXXXXXXXXXXXXXXXXXXXXXXXXXXXXXXXXXXXX-XXXXXXXXXX
