--------------------------------------------------------------------------------------------------------------------------------------------------------------
--------------------------------------------------------------------------------------------------------------------------------------------------------------
--------------------------------------------------------------------------------------------------------------------------------------------------------------
------------------------------------------------------------------------------------------------------g-------------------------------------------------------
-----------------------------------------------------------------------------------------------------SSSSSSS--------------------------------------------------
--------------------------------------------------------------------------------------------------------------------------------------------------------------
---------------------------------------------------------------------------------------------------------------------------------##---------------------------
---------------------------------------------------------------------------------------------------------------------------------##----------SSS--------------
-------------------------------------SSS------------------------------SSS----SSS!-----------#---------------------C---#------SS!S##---------------#-----S@S!S-
-------SSS----SSS!------------------------SSS!----------------SS!S--------------------------##---------C--------------##---------##---------------##----------
--------------------------------------------------------------------------------------------###-----------------------###--------##---------------###---------
----t----------------------------------------------------------------------------------M----####------------tt#######-####-------##---------####--####---g----
----t--------------M-----gg----------------####---gg----M---------g-g------XXXXXXXXXXXXXXXX-XXXXXXXXXXXXXXXXXXXXXXXXX-XXXXXXXXXXXXXXXXXXXXXXXXXXX-XXXXXXXXXXXX
-M-g-g------XXXXXXXXXXXXXXXXXX---XXXXXXXXXXXXXXXXXXXXXXXXXXXXXXXXXXXXXXX---XXXXXXXXXXXXXXXX-XXXXXXXXXXXXXXXXXXXXXXXXX-XXXXXXXXXXXXXXXXXXXXXXXXXXX-XXXXX-------
XXXXXXXXX---XXXXXXXXXXXXXXXXXX---XXXXXXXXXXXXXXXXXXXXXXXXXXXXXXXXXXXXXXXXXXXXX--------------------------------------------------------------------------------
XXXXXXXXXXXXXXX-----------------------------------------------------------------------------------------------------------------------------------------------
