-------------------------------------------------------------------------------------------------------------------------------------------------------------------------------------------
-------------------------------------------------------------------------------------------------------------------------------------------------------------------------------------------
-------------------------------------------------------------------------------------------------------------------------------------------------------------------------------------------
-------------------------------------------------------------------------------------------------------------------------------------------------------------------------------------------
-------------------------------------------------------------------------------------------------------------------##----------------------------------------------------------------------
---------------------------------------------------------------------------------------------------------------S!!S##----------------------------------------------------------------------
-------------------------------##----------------------------------------##----------------------------------------##------#-------------------SS!S----!----SS!S---------------------------
-------------------------------##----------------------------------------##----------------SSS----SSS!-------------##------##--------------------------------------------------------------
--------------------SSS----SSS!##------#-----------------SS!S------------##----------------------------------------##------###-------------------------------------------------------------
-------SSS----SSS!-------------##------##--------------------------------##------------------------------M------SS-##------####--------gg-g-g---------------------------gg---tt#######-----
-------------------------------##------###-------------------------------##-----------------------XXXXXXXXXXXXXXXXXXXXXXXX-XXXXXXXXXXXXXXXXXXXXXXXXXXXXXXXXXXXXXXXXXXXXXXXXXXXXXXXXXXXXXXXX
-------------------------------##------####--------M-----------gg--------##------gg-g-gg-g--------XXXXXXXXXXXXXXXXXXXXXXXX-XXXXXXXXXXXXXXXXXXXXXXXXXXXXXXXXXXXXXXXXXXXXXXXXXXXXXXXXXXXXXXXX
----------------g-g------XXXXXXXXXXXXX-XXXXXXXXXXXXXXXXXXXXXXXXXXXXXXXXXXXXXXXXXXXXXXXXXXXXXXXXXXXX----------------------------------------------------------------------------------------
-M-g-g--------k-XXXXXX---XXXXXXXXXXXXX-XXXXXXXXXXXXXXXXXXXXXXXXXXXXXXXXXXXXXXXXXXXXXXXXXXXXXXXXXXXX----------------------------------------------------------------------------------------
XXXXXXXXXXXXXXX-XXXXXXXXXXXX---------------------------------------------------------------------------------------------------------------------------------------------------------------
XXXXXXXXXXXXXXX----------------------------------------------------------------------------------------------------------------------------------------------------------------------------
