--------------------------------------------------------------------------------------------------------------------------------------------------------------------------------
--------------------------------------------------------------------------------------------------------------------------------------------------------------------------------
--------------------------------------------------------------------------------------------------------------------------------------------------------------------------------
--------------------------------------------------------------------------------------------------------------------------------------------------------------------------------
--------------------------------------------------------------------------------------------------------------------------------------------------------------------------------
--------------------------------------------------------------------------------------------------------------------------------------------------------------------------------
--------------------------------------------------------------------------------------------------------------------------------------------------------------------------------
----------------------------------------------------------------##------------------C-------------------------------------------------------------------------------------------
----------##----------------------------------------------------##------------------------------------------------SSS----S!!S---------------------------------------------------
----------##---------SSS----SSS!------!----SS!S------#----------##--------------------------------------------------------------------------------------------------------------
----------##---SSS!----------------------------------##---------##-----------------------------------------------------------------------------------!--------SSS----SSS!-------
----------##-----------------------------------------###--------##------------------------------------------------------------------SSS----SSS!---------------------------------
----------##-----------------####--------------------####-------##-----tt#######-gg-g-g--gg----gg-g-g---------g-g---------SS-------------------------------t--------------------
-M---gg---##-----g-g-----XXXXXXXXXXXXXXXXXXXXXXXXXXX-XXXXXXXXXXXXXXXXXXXXXXXXXXXXXXXXXXXXXXXXXXXXXXXX---XXXXXXXXXXXXXXXXXX-------#-------------------------t---------XXXXXXXXXXX
XXXXXXXXXXXXXXXXXXXXXXXXXXXXXXXXXXXXXXXXXXXXXXXXXXXX-XXXXXXXXXXXXXXXXXXXXXXXXXXXXXXXXXXXXXXXXXXXXXXXX---XXXXXXXXXXXXXXXXXX------##---------XXXXXXXXXXXXX--g-g--------XXXXXXXXXXX
XXXXXXXXXXXXXXXXXXXXXXXXXXXXX---------------------------------------------------------------------------------------------------g-g--------XXXXXXXXXXXXX--XXXXXXXXXXXX----------
