----------------------------------------------------------------------------------------------------------------------------------------------------------------------------------
----------------------------------------------------------------------------------------------------------------------------------------------------------------------------------
----------------------------------------------------------------------------------------------------------------------------------------------------------------------------------
----------------------------------------------------------------------------------------------------------------------------------------------------------------------------------
----------------------------------------------------------------------------------------------------------------------------------------------------------------------------------
----------------------------------------------------------------------------------------------------------------------------------------------------------------------------------
----------------------------------------------------------------------------------------------------------------------------------------------------------------------------------
----------------------------------------------------------------------------------------------------------------------------------------------------------------------------------
--------------------SSS----S!!S---------------------------------------------------S!!S##----------#-------------------##----------------------------------------------------------
-------SSS----SSS!--------------------------------------------------------------------##---------##-------------------##----------------------------------------------------------
---------------------------------------------------SSS----SSS!------!----SS!S---------##--------###---------!---S@S!S-##----------------------#-------------!--------SSS----SSS!--
--------------------------------------SSS----SSS!-------------------------------------##-------####-------------------##----------------------##----------------------------------
----------------g-g---------SS-----------------------------------------------------SS-##------#####-------------------##----------------------###-----------------t---------------
-M-g-g--------k-XXXXXXXXXXXX-------#-----------------------####--------------tt#########---t-######-M------------g----##-------gg-------------####--M-------------t---------------
XXXXXXXXXXXXXXX-XXXXXXXXXXXX------##-----------g-g-----XXXXXXXXXXXXXXXXXXXXXXXXXXXXXXXXXXXXXXXXXXXXXXXXXXXXXXXXXXXXXXXXXXXXXXXXXXXXX---XXXXXX-XXXXXXXXXXXXXXXXX--g-g--------k-----
XXXXXXXXXXXXXXX-------------------g-g--------k-XXXXXXXXXXXXXXXXXXXXXXXXXXXXXXXXXXXXXXXXXXXXXXXXXXXXXXXXXXXXXXXX-------XXXXXXXXXXXXXX---XXXXXX-XXXXXXXXXXXXXXXXX--XXXXXXXXXXXX-----
