-------------------------------------------------------------------------------------------------------------------------------------------------------------------------
-------------------------------------------------------------------------------------------------------------------------------------------------------------------------
-------------------------------------------------------------------------------------------------------------------------------------------------------------------------
-------------------------------------------------------------------------------------------------------------------------------------------------------------------------
-------------------------------------------------------------------------------------------------------------------------------------------------------------------------
----------------------------------------------------------------------------------------------------------------------------------------------------------------S!!S-----
------------------------------------------------------------------------------------------------S!-----------------------------------------------------------------------
----------------------------------------------------------------------------------------------------SSS----SSS!--------------------!----SS!S-----------------------------
----------##------------##-----S!--------------------SSS------S!----------------SS!S-------------------------------------------------------------------------------------
----------##------------##---------SSS----SSS!-------------------------------------------------------------------------------------------------------------------SS------
----------##------------##-----------------------------------------------------------------------S----------####-----------------------------M---------M---tt#######-----
----------##------------##-------------------------------tt#######--gg----M----------M----gg-g-gg-g-----XXXXXXXXXXXXXX---XXXXXXXXXXXXXXXXXXXXXXXXXXXXXXXXXXXXXXXXXXXXXXXX
----------##------------##------S----------####-tt#######XXXXXXXXXXXXXXXXXXXXXXXXXXXXXXXXXXXXXXXXXXXXXXXXXXXXXXXXXXXXX---XXXXXXXXXXXXXXXXXXXXXXXXXXXXXXXXXXXXXXXXXXXXXXXX
-M---gg---##-------gg---##-----g-g-----XXXXXXXXXXXXXXXXXXXXXXXXXXXXXXXXXXXXXXXXXXXXXXXXXXXXXXXXXXXXXXXXXXXXX-------------------------------------------------------------
XXXXXXXXXXXXXXXXXXXXXXXXXXXXXXXXXXXXXXXXXXXXXXXXXXXXXXXXXXXXXX-----------------------------------------------------------------------------------------------------------
XXXXXXXXXXXXXXXXXXXXXXXXXXXXXXXXXXXXXXXXXXX------------------------------------------------------------------------------------------------------------------------------
