---------------------------------------------------------------------------------------------------------------------------------------------------------------------------------------
---------------------------------------------------------------------------------------------------------------------------------------------------------------------------------------
---------------------------------------------------------------------------------------------------------------------------------------------------------------------------------------
---------------------------------------------------------------------------------------------------------------------------------------------------------------------------------------
---------------------------------------------------------------------------------------------------------------------------------------------------------------------------------------
-----------------------------------------------------------------------------------------------------------------------------------------------------------------------------#---------
----------------------------------S!!S---------------------------------------------------------------##--------------------------------------------------##-----------------##---------
-------------------------------------------------------------------------------S!!-------------------##--------------------------------------------------##----------------###---------
------------------------------------------SU--------SS!S-#------SS!S-------------------C-------------##---------------------SS!S-------------------------##---------------####------C--
--------------SSS----SSS!--------------------------------##-----------------t------------------------##-----------tt-------------------------------------##--------------#####---------
-----------------------------------SS--------------------###----------------t------------------------##-----------tt-------------------------------------##-----------t-######---------
------------------------------------tt#######------------####-------------------SS-----####-tt#########---------####----------------------gg-g-gtt#########------M-------####----------
---------------------XXXXXX---XXXXXXXXXXXXXXXXXXXXXXXXXX-XXXXXXXXXXX---XXXXXXXXXXXXXXXXXXXXXXXXXXXXXXXXXXXXXXXXXXXXXXXXXXXXXXXXX---XXXXXXXXXXXXXXXXXXXXXXXXXXXXXXXXXXXXXXXXXXX---XXXXXX
-M--gg-g-gg-g--------XXXXXX---XXXXXXXXXXXXXXXXXXXXXXXXXX-XXXXXXXXXXX---XXXXXXXXXXXXXXXXXXXXXXXXXXXXXXXXXXXXXXXXXXXXXXXXXXXXXXXXX---XXXXXXXXXXXXXXXXXXXXXXXXXXXXXXXXXXXXXXXXXXX---XXXXXX
XXXXXXXXXXXXXXXXXXXXXX-----------------------------------------------------------------------------------------------------------------------------------------------------------------
XXXXXXXXXXXXXXXXXXXXXX-----------------------------------------------------------------------------------------------------------------------------------------------------------------
