-----------------------------------------------------------------------------------------------------------------------------------------------------------------------------
-----------------------------------------------------------------------------------------------------------------------------------------------------------------------------
-----------------------------------------------------------------------------------------------------------------------------------------------------------------------------
-----------------------------------------------------------------------------------------------------------------------------------------------------------------------------
-----------------------------------------------------------------------------------------------------------------------------------------------------------------------------
-----------------------------------------------------------------------------------------------------------------------------------------------------------------------------
-------------------------------------------------------------------------------------------------------------------------##-------------------------------------SSS----SSS!--
-------------------------------------------------------------------------------------------------------------------------##---------------------#--SSS----SSS!---------------
------------------------------------------S!----------------------------#-----------------SS!S----------------------#----##---------------#----##----------------------------
----------------------------------------------SSS----SSS!---------------##---------C--------------------------------##---##---------------#---###----------------------XXXXXX
----#-----------SS!S----!-----------------------------------------------###-----------------------------------------###--##---------------#t-####-----------g-g--------XXXXXX
----##------------------------------------------------------gg-g-g-M----####----------------------####-------gg-g-g-####-##---------------####-g-g--------k-XXXXXXXXXXXX-----
----###-----------------------tt-----------S---------XXXXXXXXXXXXXXXXXX-XXXXXXXXXXXXXXXXXXXXXXXXXXXXXXXXXXXXXXXXXXX-XXXXXXXXXXXX---XXXXXX-XXXXXXXXXXXXXXXXX-XXXXXXXXXXXX-----
-M--####----------------------tt-tt#######g-g--------XXXXXXXXXXXXXXXXXX-XXXXXXXXXXXXXXXXXXXXXXXXXXXXXXXXXXXXXXXXXXX-XXXXXXXXXXXX---XXXXXX-XXXXXXXXXXXXXXXXX------------------
XXX-XXXXXXXXXXXXXXXXXXXXXXXXXXXXXXXXXXXXXXXXXXXXXXXXXX-----------------------------------------------------------------------------------------------------------------------
XXX-XXXXXXXXXXXXXXXXXXXXXXXXXXXXXXXXXXXXXXXXXXXXXXXXXX-----------------------------------------------------------------------------------------------------------------------
