-------------------------------------------------------------------------------------------------------------------------------------------
-------------------------------------------------------------------------------------------------------------------------------------------
-------------------------------------------------------------------------------------------------------------------------------------------
-------------------------------------------------------------------------------------------------------------------------------------------
-------------------------------------------------------------------------------------------------------------------------------------------
-------------------------------------------------------------------------------------------------------------------------------------------
---------------------------------------------------------------------------------------------------------S!!S------------------------------
-----------------------------------------------------------------------------------------------------------------SSS-----------------------
------------------------------##------------S!!S------------------------------------------SS!S-------------------##------------------------
------------------------------##-------------------------------------------SSS----SSS!---------------------------##------------------------
----#--------------#------SS!S##---------------------#-------------------------------------------------SS!S-#----##------------------------
----##-------------##---------##-----------------C---##-----------------t-----------------------------------##---##--------------#---------
----###------------###--------##---------------------###----------------t---------XXXXXXXXXXXX--------------###--##-------------##---------
-M--####-----####--####-------##---------------------####---gg---------g-g--------XXXXXXXXXXXX--gg----------####-##------------###---tt----
XXX-XXXXXXXXXXXXXX-XXXXXXXXXXXXXXXXXX---XXXXXXXXXXXX-XXXXXXXXXXXXXXXXXXXXXXXXXXXXXX-----XXXXXXXXXXXXXXXXXXX-XXXXXXXXXXXXXXXXXXXXXXX--tt----
XXX-XXXXXXXXXXXXXX-XXXXXXXXXXXXXXXXXX---XXXXXXXXXXXX-XXXXXXXXXXXXXXXXXXXXXXXXXXXXXX-----XXXXXXXXXXXXXXXXXXX-XXXXXXXXXXXXXXXXXXXXXXXXXXXXXXX
