--------------------------------------------------------------------------------------------------------------------------------------------
--------------------------------------------------------------------------------------------------------------------------------------------
--------------------------------------------------------------------------------------------------------------------------------------------
--------------------------------------------------------------------------------------------------------------------------------------------
--------------------------------------------------------------------------------------------------------------------------------------------
--------------------------------------------------------------------------------------------------------------------------------------------
------------------------------------------------------------------------##------------------------------------------------------------------
------------------------------------------------------------------------##----------------------------------------SSS-----------------------
---##-------------------------##----------------------------------------##---------!--------------------------------------------------------
---##-------------------------##---------------SSS----SSS!--------------##------------------------------------------------------------------
---##--------------SS!S-------##----------------------------#-----------##-----------------------------------------------#------------------
---##-------------------------##--------SU------------------##------M----------------------------####----#------g--------##-------#---------
---##-------------------------##----------------------XXXXX-###--XXXXXX-------XXXXXXXXX----------XXXXXXXXX-----XXXXXXXXX-###-----##---------
-M-##-------gg-----------gg---##-----------g-g--------XXXXX-####-XXXXXX-gg-g-g---------------M---------------------------####---###---tt----
XXXXXXXXXXXXXXXXXXXXXXXXXXXXXXXXXXXXXXXXXXXXXXXXXXXXXXX-----XXXXXXXXXXXXXXXXXX---XXXXXXXXXXXXXXXX---XXXXXXXXXXX---XXXXXX-XXXXXXXXXXX--tt----
XXXXXXXXXXXXXXXXXXXXXXXXXXXXXXXXXXXXXXXXXXXXXXXXXXXXXXX-----XXXXXXXXXXXXXXXXXX---XXXXXXXXXXXXXXXX---XXXXXXXXXXX---XXXXXX-XXXXXXXXXXXXXXXXXXX
