----------------------------------------------------------------------------------------------------------------------------------------------------------------------
----------------------------------------------------------------------------------------------------------------------------------------------------------------------
----------------------------------------------------------------------------------------------------------------------------------------------------------------------
----------------------------------------------------------------------------------------------------------------------------------------------------------------------
----------------------------------------------------------------------------------------------------------------------------------------------------------------------
----------------------------------------------------------------------------------------------------------------------------------------------------------------------
----------------------------------------------------------------------------------------------------------------------------------------------------------------------
---------------------------------------------------##-----------------------------------------------------------------------------------------------------------------
---##----------------------------------------------##------------------------------------------------------------------------------------------------------SSS----S!!S
---##----------------------------------------------##-------SS!S---------!---S@S!S----SU--#--------!---#------SS!S----!---S@S!S----S-----------------SSS!-------------
---##--------SSS!----SS!S----!--------SSS----SSS!--##-------------------------------------##-----------##-------------------------------------------------------------
---##----------------------------------------------##-------------------------------------###----------###------------------------------------------------------------
---##------------------------------t---------------##-------------------------g-----####--####---------####-------------------------------M---tt#######g-g---------SS-
-M-##---------####-----------------t---------XXXXXXXXXXXXXXXXXXXXXXXXXXXXXXXXXXXXXXXXXXXX-XXXXXXX------XXXXXXXXXXXXXXXXXXXX---XXXXXXXXXXXXXXXXXXXXXXXXXXXXXXXXXXXXX---
XXXXXXXXXXXXXXXXXXXXXXXXXXXXXXXX--g-g--------XXXXXXXXXXXXXXXXXXXXXXXXXXXXXXX----XXXXXXXXX-XXXXXXX---XX-XXXXXXXXXXXXXXXXXX-----XXXXXXXXXXXXXXXXXXXXXXXXXXXXXXXXXXXXX---
XXXXXXXXXXXXXXXXXXXXXXXXXXXXXXXX--XXXXXXXXXXXX------------------------------------------------------XXXXXX------------------------------------------------------------
