----------------------------------------------------------------------------------------------------------------------------------------------------------------------------------------------
----------------------------------------------------------------------------------------------------------------------------------------------------------------------------------------------
----------------------------------------------------------------------------------------------------------------------------------------------------------------------------------------------
----------------------------------------------------------------------------------------------------------------------------------------------------------------------------------------------
----------------------------------------------------------------------------------------------------------------------------------------------------------------------------------------------
----------------------------------------------------------------------------------------------------------------------------------------------------------------------------------------------
----------------------------------------------------------------------------------------------------------------------------------------------------------------------------------------------
----------------------------------------------------------------------------------------------------------------------------------------------------------------------------------------------
--------##-----------------##-----------------------------------------------------------------------------------------------------------------------------------------------##----------------
--------##-----------------##-----------------------------------------------------------------------------------------------------------------------------------------------##----------------
--------##-------SS!S----!-##-------SS!S----------------------SS!S--------------------!----SS!S--------#------SS!S----!----SS!S------C------------------------#----------C--##----------------
--------##-----------------##--------------------------------------------------------------------------##---------------------------------------t-------------##------------##-------------tt-
--------##-----------------##--------------tt----------------------------------------------------------###--------------------------------------t-------------###-----------##-------------tt-
-M------##-----------------##--------------tt--M-------####---------gg--------------------------gg-g-g-####--------------------tt#######---------------gg-g-g-####-----####-##----------------
XXXXXXXXXXXXXXXXXXXXXXX----XXXXXXXXXXXXXXXXXXXXXXXXXXXXXXXXXXXXXXXXXXXXXX---XXXXXXXXXXXXXXXXXXXXXXXXXX-XXXXXXXXXXXXXXXXXXXXXXXXXXXXXXXXX---XXXXXXXXXXXXXXXXXX-XXXXXXXXXXXXXXXXXXXXX---XXXXXX--
XXXXXXXXXXXXXXXXXXXXXXX----XXXXXXXXXXXXXXXXXXXXXXXXXXXXXXXXXXXXXXXXXXXXXX---XXXXXXXXXXXXXXXXXXXXXXXXXX-XXXXXXXXXXXXXXXXXXXXXXXXXXXXXXXXX---XXXXXXXXXXXXXXXXXX-XXXXXXXXXXXXXXXXXXXXX---XXXXXX--
