--------------------------------------------------------------------------------------------------------------------------------------------------------------------------------
--------------------------------------------------------------------------------------------------------------------------------------------------------------------------------
--------------------------------------------------------------------------------------------------------------------------------------------------------------------------------
--------------------------------------------------------------------------------------------------------------------------------------------------------------------------------
--------------------------------------------------------------------------------------------------------------------------------------------------------------------------------
--------------------------g-----------------------------------------------------------------------------------------------------------------------------------------------------
-------------------------SSSSSSS------------------------------------------------------------------------------------------------------------------------------------------------
----------------------------------------------------------------------------------#---------------------------------------------------------------------------------------------
---------------------------------------------------------------------------------##------------------------------------------SSS----S!!S----------------------------------------
--------------------------------------------------------------------------------###-----------------------------SSS----SSS!-----------------------------------------------------
-------------------------#------------C------!---S@S!S----SU-----!----SS!S-----####--------------------#--------------------------------------------------------!----SS!S-------
-------------------------##---------------------------------------------------#####--------------------##--------------------------------------SSS----SSS!----------------------
-------------------------###-----------------------------------------------t-######--------------------###---------------g-g---------SS-----------------------------------------
-M---gg------------------####---------------------g-----####------------------####---gg----M-----gg----####-g-g--------k-XXXXXXXXXXXX-------#------------------------------gg---
XXXXXXXXXX---XXXXXXXXXXX-XXXXX-----XXXXXXXXXXXXXXXXXXXXXXXXXXXXXXXXXXXXXXXXXXXXXXXXXXXXXXXXXXXXXXXXXXX-XXXXXXXXXXXXXXXXX-XXXXXXXXXXXX------##---------XXXXXXXXXXXXXXXXXXXXXXXXXX
XXXXXXXXXX---XXXXXXXXXXX-XXXXX-----XXXXXXXXXXXXX----XXXXXXXXXXXXXXXXXXXXXXXXXXXXXXXXXXXXXXXXXXXXXXXXXX-XXXXXXXXXXXXXXXXX-------------------g-g--------XXXXXXXXXXXXXXXXXXXXXXXXXX
