---------------------------------------------------------------------------------------------------------------------------------------------------------------------------------------------
---------------------------------------------------------------------------------------------------------------------------------------------------------------------------------------------
---------------------------------------------------------------------------------------------------------------------------------------------------------------------------------------------
---------------------------------------------------------------------------------------------------------------------------------------------------------------------------------------------
---------------------------------------------------------------------------------------------------------------------------------------------------------------------------------------------
---------------------------------------------------------------------------------------------------------------------------------------------------------------------------------------------
------------------------------------------------------------------------------------------------------------------------------------------------------------##-------------------------------
------------------------------------------------------------------------------------------------------------------------------------------------------------##-------------------------------
--------------S!!S--------------------------------------------------##---------------------------------------------------------SSS----SSS!---------------SU-##----------------SU-------------
--------------------------------------------------------------------##--------------------------------------------SSS----SSS!-------------------------------##-------------------------------
-----SS!S-------------------------------------------------!---S@S!S-##--------------------------!---S@S!S----SU---------------------------------------------##-------------------------------
--------------------------------------------------------------------##-----------------------------------------------------------------####--gg-g-gtt#########----------tt#######-gg-g-g-M---
---------------SS---------------------------------------------------##-----------------------------------------------------g-g-----XXXXXXXXXXXXXXXXXXXXXXXXXXXXXXXXXXXXXXXXXXXXXXXXXXXXXXXXXX
-M-------tt#######------tt#######----####--gg-g-g--------------g----##-------gg----M--------------------------g-g--------k-XXXXXXXXXXXXXXXXXXXXXXXXXXXXXXXXXXXXXXXXXXXXXXXXXXXXXXXXXXXXXXXXXX
XXXXXXXXXXXXXXXXXXXXXXXXXXXXXXXXXXXXXXXXXXXXXXXXXXXXXXXXXXXXXXXXXXXXXXXXXXXXXXXXXXXXXXXXXXXXXXXXXXXXX---XXXXXXXXXXXXXXXXXX-XXXXXXXXXXXX------------------------------------------------------
XXXXXXXXXXXXXXXXXXXXXXXXXXXXXXXXXXXXXXXXXXXXXXXXXXXXXXXXXXXXX-------XXXXXXXXXXXXXXXXXXXXXXXXXXXXXXX-----XXXXXXXXXXXXXXXXXX-------------------------------------------------------------------
