------------------------------------------------------------------------------------------------------------------------------------------------------------------------------------
------------------------------------------------------------------------------------------------------------------------------------------------------------------------------------
------------------------------------------------------------------------------------------------------------------------------------------------------------------------------------
------------------------------------------------------------------------------------------------------------------------------------------------------------------------------------
------------------------------------------------------------------------------------------------------------------------------------------------------------------------------------
------------------------------------------------------------------------------------------------------------------------------------------------------------------------------------
------------------------------------------------------------------------------------------------------------------------------------------------------------------------------------
------------------------------------------------------------------------------------------------------------------------------------------------------------------------------------
------------------------------------------------------##-------------------------##-------------------------------------------------------##----------------------------------------
------------------------------------------------------##-------------------------##-------------------------------------------------------##-----------------------------#--SSS-----
---------------C----------------------SSS!------------##---------!---------S@S!S-##--------------------!----------SS!S-#--------!---S@S!S-##------------------SS!S------##----------
----------------------------C-------------------------##-------------------------##------------------------------------##-----------------##----------SSS!-------------###----------
------------------------------------------------------##---------------tt--------##--------------------------tt--------###----------------##------------------------t-####----------
-M-----------####--------------------------M-----gg---##---------------tt---g----##------------------------####--------####----------g----##----------------------------g-g--------k
XXXXXXXXXXXXXXXXXX---XXXXXXXXXXXX---XXXXXXXXXXXXXXXXXXXXXXXXXXX----S------XXXXXXXXXXXXXXXXXXXXXXXXXXXXXXXXXXXXXXXXXXXX-XXXXXXXXXXXXXXXXXXXXXXXXXXXXXXXXXXXXXXXXXXXXXXXXXXXXXXXXXXXXX
XXXXXXXXXXXXXXXXXX---XXXXXXXXXXXX---XXXXXXXXXXXXXXXXXXXXXXXXXXX------------------XXXXXXXXXXXXXXXXXXXXXXXXXXXXXXXXXXXXX-XXXXXXXXXXXX-------XXXXXXXXXXXXXXXXXXXXXXXXXXXXXXXXXXXXXXXXXX
