-----------------------------------------------------------------------------------------------------------------------------------------------------------------------------------
-----------------------------------------------------------------------------------------------------------------------------------------------------------------------------------
-----------------------------------------------------------------------------------------------------------------------------------------------------------------------------------
-----------------------------------------------------------------------------------------------------------------------------------------------------------------------------------
-----------------------------------------------------------------------------------------------------------------------------------------------------------------------------------
-----------------------------------------------------------------------------------------------------------------------------------------------------------------------------------
-----------------------------------------------------------------------------------------------------------------------------------------------------------------------------------
------------------------------------------------------------------------------------------------------------------------##---------------------------------------------------------
--------------------------------------------SSS----S!!S-----------------------------------------------------------------##---------------------------------------------------------
-------------#--SSS----SSS!--SS!S---------------------------------------------------------SS!S-------SSS----------------##-------------------------SS!S--------------SSS!----------
------------##-------------------------------------------------------------SSS----SSS!----------------------------------##---------------------------------------------------------
-----------###------------------------------------------------SSS----SSS!-----------------------------------------------##---------------------------------------------------------
--------t-####--------------------gg-g-gg-g---------SS---------------------------------------------------tt#######------##-----tt#######---------------------------M---g-g--------k
-M-----####-g-g------XXXXXXXXXXXXXXXXXXXXXXXXXXXXXXX-------#----------------------XXXXXXXXXXXXXXXXXXXXXXXXXXXXXXXXXXXXXXXXXXXXXXXXXXXXXX---XXXXXXXXXXXXXXXXXXXXXXXXXXXXXXXXXXXXXXXX
XXXXXXXXXXXXXXXXXX---XXXXXXXXXXXXXXXXXXXXXXXXXXXXXXX------##-----------g-g--------XXXXXXXXXXXXXXXXXXXXXXXXXXXXXXXXXXXXXXXXXXXXXXXXXXXXXX---XXXXXXXXXXXXXXXXXXXXXXXXXXXXXXXXXXXXXXXX
XXXXXXXXXXXXXXXXXXXXXXXX----------------------------------g-g--------k-XXXXXXXXXXXX------------------------------------------------------------------------------------------------
