----------------------------------------------------------------------------------------------------------------------------------------------------------------------
----------------------------------------------------------------------------------------------------------------------------------------------------------------------
----------------------------------------------------------------------------------------------------------------------------------------------------------------------
----------------------------------------------------------------------------------------------------------------------------------------------------------------------
----------------------------------------------------------------------------------------------------------------------------------------------------------------------
---------------------------------------------g-----------------------------------------------------------------------g------------------------------------------------
--------------------------------------------SSSSSSS-----------------------------------------------------------------SSSSSSS-------------------------------------------
----------------------------------------------------------------------------------------------------------------------------------------------------------------------
---------------##------------------------------------------------------------SSS----S!!S------------------------------------------------------------------------------
---------------##---------------------------------------------SSS----SSS!---------------------------------------------------------------------------------------------
---------------##---------!----SS!S----------------------C------------------------------------------------------!----SS!S--------C--------------!----SS!S----!--------
---------------##------------------------------------------------------------------------------SSS----SSS!--------------------------------#---------------------------
---------------##--------------------------------------------------------g-g---------SS--------------------------------------------------##------------------------tt-
-M--M-----gg---##--------------------gg-------####--gg-g-gg-g------XXXXXXXXXXXXXXXXXX-------#--------------------------------tt######---###------------------------tt-
XXXXXXXXXXXXXXXXXXXXXXXXXXXXXXXXXXXXXXXXXXXXXXXXXXXXXXXXXXXXXXXX---XXXXXXXXXXXXXXXXXX------##---------XXXXXXXXXXXXXXXXXXX---XXXXXXXXXXXXXXXXXXXXXXXXXXXXXXXXXXXX------
XXXXXXXXXXXXXXXXXXXXXXXXXXXXXXXXXXXXXXXXXXXXXXXXXXXXXXXXXXXXXXXXXXXXXX---------------------g-g--------XXXXXXXXXXXXXXXXXXX---XXXXXXXXXXXXXXXXXXXXXXXXXXXXXXXXXXXX------
