-------------------------------------------------------------------------------------------------------------------------------------------------------------------------------
-------------------------------------------------------------------------------------------------------------------------------------------------------------------------------
-------------------------------------------------------------------------------------------------------------------------------------------------------------------------------
-------------------------------------------------------------------------------------------------------------------------------------------------------------------------------
-----------------------------------------------------------------------------------------------------------------------------g-------------------------------------------------
----------------------------------------------------------------------------------------------------------------------------SSSSSSS---S!!S-------------------------------------
-------------------------------------------------------------------------------------------------------------------------------------------------------------------------------
--------------------------------##------------------------------------------------------------------------C-----------------------------------------------------------!----SS!S
--------------------------------##-------------------------------------------------------------------------------------------------------------------SSS----SSS!---------------
--------------SSS----SSS!-------##-------------------------!----SS!S-#--------------#------SS!S---------------#------------------------SS------#-------------------------------
--------SSS!--------------------##-----------------------------------##-------------##------------------------##------------------------------##-------------------------------
--------------------------------##-----------------------------------###------------###-----------------------###----------------------------###------------XXXXXXXXXXXXXXXXXXX
--------------------------gg-g-g##---------------gg-g-g--------------####-----------####---------gg----gg-g-g-####-----####--M----gg-g-g----####-g-g--------XXXXXXXXXXXXXXXXXXX
-M--gg-g-gg-g------XXXXXXXXXXXXXXXXXXXX---XXXXXXXXXXXXXXXXXXXXXXXXXX-XXXXX---XXXXXX-XXXXXXXXXXXXXXXXXXXXXXXXX-XXXXXXXXXXXXXXXXXXXXXXXXXXXXXXXXXXXXXXXXXXXXXXX------------------
XXXXXXXXXXXXXXXX---XXXXXXXXXXXXXXXXXXXX---XXXXXXXXXXXXXXXXXXXXXXXXXX-XXXXX---XXXXXX-XXXXXXXXXXXXXXXXXXXXXXXXX-XXXXXXXXXXXXXXXXXXXXXXXXXXXXXXXXXXXXXXXXXXXXXXX------------------
XXXXXXXXXXXXXXXXXXXXXX---------------------------------------------------------------------------------------------------------------------------------------------------------
