-------------------------------------------------------------------------------------------------------------------------------------------------------------
-------------------------------------------------------------------------------------------------------------------------------------------------------------
-------------------------------------------------------------------------------------------------------------------------------------------------------------
-------------------------------------------------------------------------------------------------------------------------------------------------------------
-------------------------------------------------------------------------------------------------------------------------------------------------------------
-------------------------------------------------------------------------------------------------------------------------------------------------------------
------------------------------------------------------------g------------------------------------------------------------------------------------------------
-----------------------------------------------------------SSSSSSS---S!!S-------------------------------------------------------------------------SSS----S!!S
---##--------------------------------------------------S--------------------------------------------SSS----SSS!----------------------------------------------
---##------------------------------SSS----SSS!--------------------------------SSS!----------SSS!-----------------------------------------------#-------------
---##------------------SU---------------------------------------------------------------------------------------------------------------------##-------------
---##-----------------------------------------------------------------SS-----------------------------------------gg----gg-g-g------gg-g-g-M---g-g---------SS-
---##----------------------------------tt#######----------gg-g-g----####-----------M------------g-g------XXXXXXXXXXXXXXXXXXXXXXXXXXXXXXXXXXXXXXXXXXXXXXXXX---
-M-##------M-------------gg-g-gg-g-----XXXXXXXXX---XXXXXXXXXXXXXXXXXXXXXX---XXXXXXXXXXX---XXXXXXXXXXXX---XXXXXXXXXXXXXXXXXXXXXXXXXXXXXXXXXXXXXXXXXXXXXXXXX---
XXXXXXXXXXXXXXX---XXXXXXXXXXXXXXXXXXXXXXXXXXXXXX---XXXXXXXXXXXXXXXXXXXXXX---XXXXXXXXXXX---XXXXXXXXXXXXXXXXXX-------------------------------------------------
XXXXXXXXXXXXXXX---XXXXXXXXXXXXXXXXXXXXXXXXX------------------------------------------------------------------------------------------------------------------
