----------------------------------------------------------------------------------------------------------------------------------------------------------------------------
----------------------------------------------------------------------------------------------------------------------------------------------------------------------------
----------------------------------------------------------------------------------------------------------------------------------------------------------------------------
----------------------------------------------------------------------------------------------------------------------------------------------------------------------------
----------------------------------------------------------------------------------------------------------------------------------------------------------------------------
----------------------------------------------------------------------------------------------------------------------------------------------------------------------------
----------------------------------------------------------------------------------------------------------------------------------------------------------------------------
-----------------------------#----------------------------------------------------------------##----------------------------------------------S!---------------SSS----SSS!--
--------###-----------------##----------------------------------------------------------------##--------------------------------------------------SSS----SSS!---------------
-------####----------------###----------------------------------------------------------S@S!S-##------------#---SS!S-----------!-----##---SS--------------------------------
------#####---------------####--SS!S-----------------------SS!S-------------------------------##-----------##-----------------------###-------------------------------------
-----######--------------#####----------------------------------------SSS!----------tt--------##----------###----------------------####--------S-----------g-g--------k-----
----#######-----------t-######------------------------------------------------------tt---g----##---------####--------gg-g-g-------#####-------g-g--------k-XXXXXXXXXXXX-----
-t-########------M-------####--------gg-g-g--gg----gg-g-g-------gg-g-----------------g-g------XXXXXXXXXXXXXXXXXXXXXXXXXXXXXXXXXXXXXXXXX-XXXXXXXXXXXXXXXXXX-XXXXXXXXXXXX-----
XXXXXXXXXXXXXXXXXXXXXXXXXXXXXXXXXXXXXXXXXXXXXXXXXXXXXXXXXXXXXXXXXXXXXXXXXXXX---XXXXXXXXXXXXXXXXXXXXXXXXXXXXXXXXXXXXXXXXXXXXXXXXXXXXXXXX-XXXXXXXXXXXXXXXXXX------------------
XXXXXXXXXXXXXXXXXXXXXXXXXXXXXXXXXXXXXXXXXXXXXXXXXXXXXXXXXXXXXXXXXXXXXXXXXXXX---XXXXXXXXXXXXXXXXXX---------------------------------------------------------------------------
