------------------------------------------------------------------------------------------------------------------------------------------------------------------------------------
------------------------------------------------------------------------------------------------------------------------------------------------------------------------------------
------------------------------------------------------------------------------------------------------------------------------------------------------------------------------------
------------------------------------------------------------------------------------------------------------------------------------------------------------------------------------
------------------------------------------------------------------------------------------------------------------------------------------------------------------------------------
------------------------------------------------------------------------------------------------------------------------------------------------------------------------------------
------------------------------------------------------------------------------------------------------------------------------------------------------------------------------------
------------------------------------------------------------------------------------------------------------------------------------------------------------------------------------
-----------------------------------------S!!S-------------------------------------------------S!!S----------------------------------------------------------------SSS----S!!S-------
----------------------------------------------------------------------------------------------------------------------SSS----SSS!------------------------C--------------------------
-------!----SS!S--------------SS!S----------------#---------SU----------------------#----------------------------------------------SSS!------------------------#--------------------
-------------------------------------------------##---------------------------------##------------------------------------------------------------------------##--------------------
------------------------------------------SS----###---------------------------------###--------SS-----------------------------###----------gg--------tt#######g-g---------SS------#-
-M---------------gg-g-g--------------------tt#######---------------tt#######-gg-g-g-####-tt#######----####--gg-g-gg-g-----XXXXXXXXXXXXXXXXXXXXXXXXXXXXXXXXXXXXXXXXXXXXXXXX-------##-
XXXXXXXXXXXXXXXXXXXXXXXXXXXXXXXXXX---XXXXXXXXXXXXXXX---XXXXXXXXXXXXXXXXXXXXXXXXXXXX-XXXXXXXXXXXXXXXXXXXXXXXXXXXXXXXXXXXXXXXXXXXXXXXXXXXXXXXXXXXXXXXXXXXXXXXXXXXXXXXXXXXXXX------###-
XXXXXXXXXXXXXXXXXXXXXXXXXXXXXXXXXX---XXXXXXXXXXXXXXX---XXXXXXXXXXXXXXXXXXXXXXXXXXXX-XXXXXXXXXXXXXXXXXXXXXXXXXXXXXXXXXXXXXXXXXX------------------------------------------------------
