-----------------------------------------------------------------------------------------------------------------------------------------------------------------------------------
-----------------------------------------------------------------------------------------------------------------------------------------------------------------------------------
-----------------------------------------------------------------------------------------------------------------------------------------------------------------------------------
-----------------------------------------------------------------------------------------------------------------------------------------------------------------------------------
-----------------------------------------------------------------------------------------------------------------------------------------------------------------------------------
-----------------------------------------------------------------------------------------------------------------------------------------------------------------------------------
-----------------------------------------------------------------------------------------------------------------------------------------------------------------------------------
----------------------------------------------------------------------##-----------------##----------------------------------------------------------------------C-----------------
----------------------------------------------------------------------##-----------------##-----------------------SSS-------------SSS----------------------------------------------
-------------SSS----SSS!--SSS-----------------C-----------------------##-----------------##--------------SS!S--------------------------------#----------#--------------------------
----#-----------------------------------------------C-----------------##-----------------##--------------------------------------------------##---------##-------------------------
----##----------------------------------------------------------------##-----------------##--------------------------------------------------###--------###------------------------
----###------------------------M----gg-g-gtt###-----------gg-g-g------##------M-----gg---##-------gg-------------####--gg-g-gtt#######-------####-------####--gg-g-g------tt#######
-M--####-g-g------XXXXXXXXXXXXXXXXXXXXXXXXXXXXXXXXXXXXXXXXXXXXXXXXXXXXXXXXXXXXXXXXXXXXXXXXXXXXXXXXXXXXXXXXXXXXXXXXXXXXXXXXXXXXXXXXXXXXXXXXXX-XXXXXXXXXX-XXXXXXXXXXXXXXXXXXXXXXXXXXX
XXX-XXXXXXXXXXX---XXXXXXXXXXXXXXXXXXXXXXXXXXXXXXXXXXXXXXXXXXXXXXXXXXXXXXXXXXXXXXXXXXXXXXXXXXXXXXXXXXXXXXXXXXXXXXXXXXXXXXXXXXXXXXXXXXXXXXXXXX-XXXXXXXXXX-XXXXXXXXXXXXXXXXXXXXXXXXXXX
XXX-XXXXXXXXXXXXXXXXX--------------------------------------------------------------------------------------------------------------------------------------------------------------
