--------------------------------------------------------------------------------------------------------------------------------------------------------------------------------------
--------------------------------------------------------------------------------------------------------------------------------------------------------------------------------------
--------------------------------------------------------------------------------------------------------------------------------------------------------------------------------------
--------------------------------------------------------------------------------------------------------------------------------------------------------------------------------------
--------------------------------------------------------------------------------------------------------------------------------------------------------------------------------------
--------------------------------------------------------------------------------------------------------------------------------------------------------------------------------------
-----------------------------------------------------------------------------------------------------------------------------------#--------------------------------------------------
----------------------------------------------------------------------------------------------------------------------------------##--------------------------------------------------
-------------------------------------------------------SSS-----------------------------------------------------------------------###--------------------------------------------------
-----------------------------------------------SU--------------!----SS!S---------!----SS!S----!----SS!S--SSS--------------------####-----------!---------------------------------SSS--
------------!--------SSS----SSS!-----------------------------------------------------------------------------------------------#####------------------------------------SS!S----------
----------------------------------------------------------------------------------------------------------------------------t-######-----------------tt-------------------------------
------------------t-----------------gg---tt#######----####---------------M-----------------------------------------------------####---gg-------------tt-------------------------------
-M--M-------------t---------XXXXXXXXXXXXXXXXXXXXXXXXXXXXXXXXXXXXXXXXXXXXXXXXXXXXXXXXXXXXXXXXXXXXXXXXXXXXXXXXXXXXXX---XXXXXXXXXXXXXXXXXXXXXXXXXX----####--gg-g-g--gg-------------####--
XXXXXXXXXXXXXXX--g-g--------XXXXXXXXXXXXXXXXXXXXXXXXXXXXXXXXXXXXXXXXXXXXXXXXXXXXXXXXXXXXXXXXXXXXXXXXXXXXXXXXXXXXXX---XXXXXXXXXXXXXXXXXXXXXXXXXXXXXXXXXXXXXXXXXXXXXXXXXXXXXXXXXXXXXXXX-
XXXXXXXXXXXXXXX--XXXXXXXXXXXX------------------------------------------------------------------------------------------------------------------XXXXXXXXXXXXXXXXXXXXXXXXXXXXXXXXXXXXXX-
