------------------------------------------------------------------------------------------------------------------------------------------------------------------------------
------------------------------------------------------------------------------------------------------------------------------------------------------------------------------
------------------------------------------------------------------------------------------------------------------------------------------------------------------------------
------------------------------------------------------------------------------------------------------------------------------------------------------------------------------
------------------------------------------------------------------------------------------------------------------------------------------------------------------------------
---------------------------------------------------------------------------------------------------------------------------------------------------------#--------------------
---------------------------------------------------------------------------------------------------------------##-------------------------------------------------------------
---------------------------------------------------------------------------------------------------------------##--------------------------------------#----------------------
--------------------------------------------------##----------------------------------------------SSS----SSS!--##---------------------!----SS!S-------##----!---S@S!S----SU---
--------------------------------------------------##---------SSS----SSS!--------------------SSS!---------------##------------------------------------###----------------------
---------SU----------SSS-------SU-----------------##-------------------------C---------------------------------##---------------------------------t-####----------------------
--------------------------------------------------##--------------------------------------------------tt#########------M-----gg----------------------------------g----XXXXXX--
--------------------------------------------------##-----------------###---------M---tt#######g-g-----XXXXXXXXXXXXXXXXXXXXXXXXXXXXXXXXXXXXXXXXX---XXXXXXXXXXXXXXXXXXXXXXXXXX--
-M-----####---gg-------------####-tt#######-gg-g-g##-----g-g-----XXXXXXXXXXXXXXXXXXXXXXXXXXXXXXXXXXXXXXXXXXXXXXXXXXXXXXXXXXXXXXXXXXXXXXXXXXXXXX---XXXXXXXXXXXXX---------------
XXXXXXXXXXXXXXXXXXXXXXXXXXXXXXXXXXXXXXXXXXXXXXXXXXXXXXXXXXXXXXXXXXXXXXXXXXXXXXXXXXXXXXXXXXXXXXXXXXXXXXXXXX--------------------------------------------------------------------
XXXXXXXXXXXXXXXXXXXXXXXXXXXXXXXXXXXXXXXXXXXXXXXXXXXXXXXXXXXXXXXXXXXXX---------------------------------------------------------------------------------------------------------
