-----------------------------------------------------------------------------------------------------------------------------------------------------------------------------
-----------------------------------------------------------------------------------------------------------------------------------------------------------------------------
-----------------------------------------------------------------------------------------------------------------------------------------------------------------------------
-----------------------------------------------------------------------------------------------------------------------------------------------------------------------------
-----------------------------------------------------------------------------------------------------------------------------------------------------------------------------
-----------------------------------------------------------------------------------------------------------------------------------------------------------------------------
-----------------------------------------------------------------------------------------------------------------------------------------------------------------------------
-----------------------------------------------------------------------------------------------------------------------------------------------------------------------------
---------------------##------------##----------------#-----------S!!S--------------------------------------------------S!!S--------------------------------------------------
---------------------##------------##---------------##---------------------------------------------------------------------------------------SSS----SSS!------!----------SS!S
-------C-------------##------------##-------SS-----###--------------------SSS!-------------------SS!S--SSS------------------------------C------------------------------------
---------------------##------------##-------------####---SU---------------------------------------------------------------------------------------------------------tt-------
---------------------##------------##------------#####------------SS----------------------------------------------------SS-----------------------tt#######----------tt-------
-M-----####-tt#########-------gg---##---------t-######------tt#######----------------gg---------------------M------------tt#######-gg-g-gg-g-----XXXXXXXXXXXXXXXX------XXXXXX
XXXXXXXXXXXXXXXXXXXXXXXXXXXXXXXXXXXXXXXXXXXXXXXXXXXXXXXXXXXXXXXXXXXXX---XXXXXXXXXXXXXXXXXXXXXXXXXXXXXXXXXXXXXXXX---XXXXXXXXXXXXXXXXXXXXXXXXXXXXXXXXXXXXXXXXXXXXXX------XXXXXX
XXXXXXXXXXXXXXXXXXXXXXXXXXXXXXXXXXXXXXXXXXXXXXXXXXXXXXXXXXXXXXXXXXXXX---XXXXXXXXXXXXXXXXXXXXXXXXXXXXXXXXXXXXXXXX---XXXXXXXXXXXXXXXXXXXXXXXXXXXXXXXXXX------------------------
