----------------------------------------------------------------------------------------------------------------------------------------------------------------------------------------------------
----------------------------------------------------------------------------------------------------------------------------------------------------------------------------------------------------
----------------------------------------------------------------------------------------------------------------------------------------------------------------------------------------------------
----------------------------------------------------------------------------------------------------------------------------------------------------------------------------------------------------
----------------------------------------------------------------------------------------------------------------------------------------------------------------------------------------------------
-------------------------------------------------------------------------------------------------------------------------------------------------@--------------------------------------------------
---!----------------------------------!!S-------------------------------------------------------------------------!!S-------------------------------------------------------------------------------
----------------------------------------------------------------------------------------------------------------------------------------------------------------------------------------------------
------------------------------#---------------------------------------------------------------------------------------------------------------------------------------------------------------------
-----------------------------##--------------------------------------------------------------------1----------------------------------------------g---------------1--------------------1------------
---S!S----------------------####--#---SS------S--------------------------S---------------------------------#--#---SS---!---S@-------------g---------------------------------------------------!---S@
---------------------------#####--##-----------------------------------------------------------------------#--##------------------------SSSSS---S@S-------------------------------------------------
----------------------tt--######--###-------------------------------------------tt-------------------------#--###------------------###--------------------------------------------------------------
-M-----------gg-g-----tt--######--####g-----------------------------k-----------tt--------------------gg-g-#--####g---------g-gg-g-###--------------k---------------------------------------k------g
XXXXXXXXXX--XXXXXXXXXXXXXXXXXXXX--XXXXXXXXXXXXXXXXXXXXXXXXXXXXXXXXXXXXXXXXXXXXXXXXXXXX--XXXXXXXXXXXXXXXXXXXX--XXXXXXXXXXXXXXXXXXXXXXXXXXXXXXXXXXXXXXXXXXXXXXXXXXXXXXXXXXXXXXXXXXXXXXXXXXXXXXXXXXXXXX
XXXXXXXXXX--XXXXXXXXXXXXXXXXXXXX--XXXXXXXXXXXXXXXXXXXXXXXXXXXXXXXXXXXXXXXXXXXXXXXXXXXX--XXXXXXXXXXXXXXXXXXXX--XXXXXXXXXXXXXXXXXXXXXXXXXXXXXXXXXXXXXXXXXXXXXXXXXXXXXXXXXXXXXXXXXXXXXXXXXXXXXXXXXXXXXX
