----------------------------------------------------------------------------------------------------------------------------------------------------------------------------------------------------------
----------------------------------------------------------------------------------------------------------------------------------------------------------------------------------------------------------
----------------------------------------------------------------------------------------------------------------------------------------------------------------------------------------------------------
----------------------------------------------------------------------------------------------------------------------------------------------------------------------------------------------------------
----------------------------------------------------------------------------------------------------------------------------------------------------------------------------------------------------------
----------------------------------------------------------------------------------------------------------------------------------------------------------------------------------------------------------
-------------------------------------------------------------------------------------------!-------------------------!-----------------------------------------------------------##-----------------------
--------------------------------------------------------------------------------------------------------------------------------------------------------------------------------###-----------------------
-------------------------------------------------------------------------------------------------------------------------------------------------------------------------------####-------------------1---
-----------------------------------------------------------------------------------------1---------1--------------------------------------------------------------------------#####-----------------------
------S---------------------S-----------!---S@-----------------------S----!---S@-----------S!S-----------------!---S@S!S---------S-------------------------------------------######-----------------------
----------------------------------------------------------------------------------------------------------------------------------------------------------------------------#######-----------------------
-------------------------------------------------------------------------------------------------------tt------------------tt-----------------------------tt-----------tt--####---------------------------
-M-------------------------------------------g---------------------------------g---k-------------------tt----k------g------tt-------------------------k---tt--gg-g-----tt--####XXXXXXXXXXXXXXXXX--XXXXXXXX
XXXXXXXXXXXXXXXXXXXXXXXXXXXXXXXXXXXXXXXXXXXXXXXXX--XXXXXXXXXXXXXXXXXXXXXXXXXXXXXXXXXXXXXXXXXXXXXXXXXXXXXXXXXXXXXXXXXXXXXXXXXXXXXXXXXXXXXXXXXXXXXX--XXXXXXXXXXXXXXXXXXXXXXXXXXXXXXXXXXXXXXXXXXXXX--XXXXXXXX
XXXXXXXXXXXXXXXXXXXXXXXXXXXXXXXXXXXXXXXXXXXXXXXXX--XXXXXXXXXXXXXXXXXXXXXXXXXXXXXXXXXXXXXXXXXXXXXXXXXXXXXXXXXXXXXXXXXXXXXXXXXXXXXXXXXXXXXXXXXXXXXX--XXXXXXXXXXXXXXXXXXXXXXXXXXXXX--------------------------
