---------------------------------------------------------------------------------------------------------------------------------------------------------------------------
---------------------------------------------------------------------------------------------------------------------------------------------------------------------------
---------------------------------------------------------------------------------------------------------------------------------------------------------------------------
---------------------------------------------------------------------------------------------------------------------------------------------------------------------------
---------------------------------------------------------------------------------------------------------------------------------------------------------------------------
---------------------------------------------------------------------------------------------------------------------------------------------------------------------------
-----------------------------------------------------------------------------------!--------!-------------------------------------------------!----------------------------
---------------------------------------------------------------------------------------------------------------------------------------------------------------------------
--------------------------------------------------------------------g------------------------------------------------------------------------------------------------------
---------------------------------------------------------------------------------------------------------------------------------------------------------------------------
-------------S---------------------!-------------------#--#-------S@S--------------S!----@--S!S-!---S@----!--------!---S@------#--#----------gS!S-------!---S@-------------
-------------------------------------------------------#--##-------------------------------------------------------------------#--##-------SSS-----------------------------
---------------------------tt--------------------------#--###-###-----------------S--------------------------------------------#--###-###----------------------------------
-M-------------------------tt------------------k--gg-g-#--#######-------------------------k----------g------------------g-gg-g-#--#######--------------------g-------------
XXXXXXXXXXXXXXXXXXXXXXXXXXXXXXXXXXXXXXXXXXXXXXXXXXXXXXXX--XXXXXXXXXXXXXXXXXXXXXXXXXXXXXXXXXXXXXXXXXXXXXXXXXXXXXXXXXXXXXXXXXXXXXX--XXXXXXXXXXXXXXXXXXXXXXXXXXXXXXXXXXXXXXXXX
XXXXXXXXXXXXXXXXXXXXXXXXXXXXXXXXXXXXXXXXXXXXXXXXXXXXXXXX--XXXXXXXXXXXXXXXXXXXXXXXXXXXXXXXXXXXXXXXXXXXXXXXXXXXXXXXXXXXXXXXXXXXXXX--XXXXXXXXXXXXXXXXXXXXXXXXXXXXXXXXXXXXXXXXX
