----------------------------------------------------------------------------------------------------------------------------------------------------------------------------------
----------------------------------------------------------------------------------------------------------------------------------------------------------------------------------
----------------------------------------------------------------------------------------------------------------------------------------------------------------------------------
----------------------------------------------------------------------------------------------------------------------------------------------------------------------------------
--------------------------------------------------------------------------------------@-------------------------------------------------------------------------------------------
----------------------------------------------------------------------------------------------------------------------------------------------------------------------------------
---------------------------------------------------!-----------!---------!!S-------------------------------------------------------------------------------------!----------------
----------------------------------------------------------------------------------------------------------------------------------------------------------------------------------
---------------------------------------------------------------------------------------g------------------------------------------------------------------------------------------
-------------------------------------------------1-------------------------------------------------------!---------------------------------------------1--------------------------
--------------------------------g------------------S!S---------S!S-------SS----------S@S------!-----------------------------------------------S-------------S----S!S--------------
------------------------------SSSSSSS---------------------------------------------------------------------------------------------------------------------------------------------
-------------------------###-------tt-------------------------------------------tt--------------------###-------------------------------------------------------------------------
-M---------------k--gg-g-###-------tt-------------------------------gg-g-g------tt------------k--gg-g-###-------------k-----------------------------------------------------------
XXXXXXXXXXXX--XXXXXXXXXXXXXXXXXXXXXXXXXXXXXXXXXXXXXXXXXXXXXXXXXXXXXXXXXXXXXXXXXXXXXXXXXXXXXXXXXXXXXXXXXXXXXXXXXXX--XXXXXXXXXXXXXXXXXXXXXX--XXXXXXXXXXXXXXXXXXXXXXXXXXXXXXXXXXXXXXX
XXXXXXXXXXXX--XXXXXXXXXXXXXXXXXXXXXXXXXXXXXXXXXXXXXXXXXXXXXXXXXXXXXXXXXXXXXXXXXXXXXXXXXXXXXXXXXXXXXXXXXXXXXXXXXXX--XXXXXXXXXXXXXXXXXXXXXX--XXXXXXXXXXXXXXXXXXXXXXXXXXXXXXXXXXXXXXX
