-----------------------------------------------------------------------------------------------------------------------------------------------------------------------------------------------
-----------------------------------------------------------------------------------------------------------------------------------------------------------------------------------------------
-----------------------------------------------------------------------------------------------------------------------------------------------------------------------------------------------
-----------------------------------------------------------------------------------------------------------------------------------------------------------------------------------------------
-----------------------------------------------------------------------------------------------------------------------------------------------------------------------------------------------
-----------------------------------------------------------------------------------------------------------------------------------------------!---------------------------!!S-----------------
---!---------!------------------!-------------------------------------##-----------------------------------------------------------------------------------------------------------------------
---------------------------------------------------------------------###-----------------------------------------------------------------------------------------------------------------------
--------------------------------------------------------------------####--------------1------g--------------------1----------------------------------------------------------------------------
-------------------------------------------------------------------#####-----------------------------------------------S------------------S----S!S--------!---S@-----------SS------S-----------
---S!S-!---S@S!S-----------S----S!S-------------------------------######-------------------S@S-------------------------------------------------------------------------------------------------
-----------------------------------------------------------------#######-----------------------------------------------------------------------------------------------------------------------
------------------------------------------------------------tt-----g-g---------------------k---k-------------------------------k-------------------------------g------gg-g-g-------------------
-M----------g--------------------------------------gg-g-----tt-XXXXXXXXXXXXXXXXXXXXXXXXXXXXXXXXXXXXXXXXXXXXXXXXXXXXXXXXXXXXXXXXXXXXXXXXXXXXXXXXXXXXXXXXXXXXXXXXXXXX--XXXXXXXXXXXXXXXXXXXXXXXXXX
XXXXXXXXXXXXXXXXXXXXXXXXXXXXXXXXXXXXXXXXXXXXXXXXXXXXXXXXXXXXXXXXXXXXXXXXXXXXXXXXXXXXXXXXXXXXXXXXXXXXXXXXXXXXXXXXXXXXXXXXXXXXXXXXXXXXXXXXXXXXXXXXXXXXXXXXXXXXXXXXXXX--XXXXXXXXXXXXXXXXXXXXXXXXXX
XXXXXXXXXXXXXXXXXXXXXXXXXXXXXXXXXXXXXXXXXXXXXXXXXXXXXXXXXXXXXXXXXXXXX--------------------------------------------------------------------------------------------------------------------------
