-----------------------------------------------------------------------------------------------------------------------------------------------------------------------------------------------------
-----------------------------------------------------------------------------------------------------------------------------------------------------------------------------------------------------
-----------------------------------------------------------------------------------------------------------------------------------------------------------------------------------------------------
-----------------------------------------------------------------------------------------------------------------------------------------------------------------------------------------------------
-----------------------------------------------------------------------------------------------------------------------------------------------------------------------------------------------------
-----------------------------------------------------------------------------------------------------------------------------------------------------------------------------------------------------
-------------------------------------------------------------------------------------------------------------------------------------------------------!!S-------------------------------------------
-----------------------------------------------------------------------------------------------------------------------------------------------------------------------------------------------------
-----------------------------------------------------------------------------------------------------------------------------------------------------------------------------------------------------
---------------------------------------------------------------------------1-----------1------------------1-------------------1--------------------------------------------------------------------1-
------S--------------------------!---S@--------!---S@------------------------!---S@----------------------------S--------------------------------#--#---SS------------------------@--!---S@-----------
------------------------------------------------------------------------------------------------------------------------------------------------#--##------------------------------------------------
-------------------------tt-----------------------------------tt-----------------------------------tt-----------------------------tt------------#--###----------S------------------------------------
-M-----------------------tt-----------g-------------g---------tt------------------g----------------tt-----------------------------tt----k--gg-g-#--####g-------k------------------k------g-----------
XXXXXXXXXXXXXX--XXXXXXXXXXXXXXX--XXXXXXXXXXXXXXXXXXXXXXXXXXXXXXXXXXXXXXXXXXXXXXXXXXXXXXXXXXXXXXXXXXXXXXXXXXXXXXXXXXXXXXXXXXXXXXXXXXXXXXXXXXXXXXXX--XXXXXXXXXXXXXXXXXXXXXXXXXXXXXXXXXXXXXXXXXX--XXXXXX
XXXXXXXXXXXXXX--XXXXXXXXXXXXXXX--XXXXXXXXXXXXXXXXXXXXXXXXXXXXXXXXXXXXXXXXXXXXXXXXXXXXXXXXXXXXXXXXXXXXXXXXXXXXXXXXXXXXXXXXXXXXXXXXXXXXXXXXXXXXXXXX--XXXXXXXXXXXXXXXXXXXXXXXXXXXXXXXXXXXXXXXXXX--XXXXXX
