----------------------------------------------------------------------------------------------------------------------------------------------------------------------------------------------------------
----------------------------------------------------------------------------------------------------------------------------------------------------------------------------------------------------------
----------------------------------------------------------------------------------------------------------------------------------------------------------------------------------------------------------
----------------------------------------------------------------------------------------------------------------------------------------------------------------------------------------------------------
----------------------------------------------------------------------------------------------------------------------------------------------------------------------------------------------------------
----------------------------------------------------------------------------------------------------------------------------------------------------------------------------------------------------------
--------------------------------------------------------------------------------------------!!S-------------------------------------##--------------------------------------------------------------------
-----------------------------------------------------------------------------------------------------------------------------------###--------------------------------------------------------------------
-----------------------g-----------------------------------------------------------------------------------------------------------###------------------------------------------------g-------------------
-------1---------------------------------------------------------------------------------------------------------------------------###---------------------------1----------------------------------------
---------------------S@S--------S-------------------------S---------------S----------#--#---SS------S-----------------------#--#---###--------------------SU------------------------S@S-------------------
-------------------------------------------------------------------------------------#--##----------------------------------#--##--###----------------------------------------------------------g---------
---------------------###-------------------------------------------------------------#--###----------------tt---------------#--###-###--------------------------------------------------------S-----------
-M--------------gg-g-###-----------------------------k--------------------------gg-g-#--####g--------------tt----------gg-g-#--#######---------------------k---------------------------------k------------
XXXXXXXXXXXXXXXXXXXXXXXXXXXXXXXXXXXXXXXXXXXXXXXX--XXXXXXXXXXXXXXXXXXXXXXXXXXXXXXXXXXXX--XXXXXXXXXXXXXXXXXXXXXXXXXXXXXXXXXXXXX--XXXXXXXXXXXXXXXXXXXXXXXXXXXXXXXXXXXXXXXXXXXXXXXXXXXXXXXXXXXXXXXXXXXXXXX---X
XXXXXXXXXXXXXXXXXXXXXXXXXXXXXXXXXXXXXXXXXXXXXXXX--XXXXXXXXXXXXXXXXXXXXXXXXXXXXXXXXXXXX--XXXXXXXXXXXXXXXXXXXXXXXXXXXXXXXXXXXXX--XXXXXXXXXXXXXXXXXXXXXXXXXXXXXXXXXXXXXXXXXXXXXXXXXXXXXXXXXXXXXXXXXXXXXXX---X
