----------------------------------------------------------------------------------------------------------------------------------------------------------------------------------------------------------
----------------------------------------------------------------------------------------------------------------------------------------------------------------------------------------------------------
----------------------------------------------------------------------------------------------------------------------------------------------------------------------------------------------------------
----------------------------------------------------------------------------------------------------------------------------------------------------------------------------------------------------------
----------------------------------------------------------------------------------------------------------------------------------------------------------------------------------------------------------
----------------------------------------------------------------------------------------------------------------------------------------------------------------------------------------------------------
--------------------------------!!S-------------------------------------------!!S-------------------------------------------------------------------------------------------------------------------------
----------------------------------------------------------------------------------------------------------------------------------------------------------------------------------------------------------
----------------------------------------------------------------------#-----------------------------------------------------------------------------------------------------------------------------------
---------------------------------------------------------------------##-----------------------------------------------1----------1-----------------------------------------------------------1------------
----!--!-------------S----------SS-----------------#--#-------------####--#---SS--------------#--#-------------------------------------------!-------------------------------------!---S@-----------------
---------------------------------------------------#--##-----------#####--##------------------#--##-------------------------------------------------------------------------------------------------------
---------------------------------------------------#--###-----tt--######--###-----------------#--###-###------------------tt-----------------------------tt-----------------------------------------------
-M-------------------------gg-g-g-------------gg-g-#--####----tt--######--####g----------gg-g-#--#######------------------tt-----------------k-----------tt-----------------------------g-----------------
XXXXXXXXXXXXXXXXXXXXXXXXXXXXXXXXXXXXXXXXXXXXXXXXXXXX--XXXXXXXXXXXXXXXXXX--XXXXXXXXXXXX--XXXXXXX--XXXXXXXXXXXXXXX--XXXXXXXXXXXXXXXXXXXXXXXXXXXXXXXXXXXXXXXXXXXXXXXXXXXXXXXXXXXXXXXXXXXXXXXXXXXXXXXX--XXXXXX
XXXXXXXXXXXXXXXXXXXXXXXXXXXXXXXXXXXXXXXXXXXXXXXXXXXX--XXXXXXXXXXXXXXXXXX--XXXXXXXXXXXX--XXXXXXX--XXXXXXXXXXXXXXX--XXXXXXXXXXXXXXXXXXXXXXXXXXXXXXXXXXXXXXXXXXXXXXXXXXXXXXXXXXXXXXXXXXXXXXXXXXXXXXXX--XXXXXX
