----------------------------------------------------------------------------------------------------------------------------------------------------------------------------------------------------------
----------------------------------------------------------------------------------------------------------------------------------------------------------------------------------------------------------
----------------------------------------------------------------------------------------------------------------------------------------------------------------------------------------------------------
----------------------------------------------------------------------------------------------------------------------------------------------------------------------------------------------------------
----------------------------------------------------------------------------------------------------------------------------------------------------------------------------------------------------------
----------------------------------------------------------------------------------------------------------------------------------------------------------------------------------------------------------
----------------------!-------------------------------------------------------------------------!--------------------------------------------------------------------------!!S----------------------------
----------------------------------------------------------------------------------------------------------------------------------------------------------------------------------------------------------
------------------------------------------------------------------------------g-------------------------------------------------------------------------------------------#-------------------------------
--------------------------------------------------------------g-----------------------------------------------------1----------------------------------------------------##--------------------------!--!-
----------------------S!S-!---S@------#--#-----------!---------------S------S@S-----------------S!S-------!---S@--------------S--------------S--------------------------###SS-----------------#--#--------
--------------------------------------#--##-----------------S@S--------------------------------------------------------------------------------------------------------####-------------------#--##-------
--------------------------------------#--###-###------------------------------------------------------------------------tt----------------------------------------tt--#####-------------------#--###-###--
-M-----------------------------g-gg-g-#--#######----------g----------------------------------------------------g--------tt-------------------------------gg-g-----tt--#####g-------------gg-g-#--#######--
XXXXXX--XXXXXXXXXXXXXXXXXXXXXXXXXXXXXXX--XXXXXXXXXXXXXXXXXXXXXXXXXXXXXXXXXXXXXXXXXXXXXXXXXXXXXXXXXXXXXXXXXXXXXXXXXXXXXXXXXXXXXXXXXXXXXXXXXXXXXXXXXXXXXXXXXXXXXXXXXXXXXXXXXXXXXXXXXXXXXXXXXXXXXX--XXXXXXXXX
XXXXXX--XXXXXXXXXXXXXXXXXXXXXXXXXXXXXXX--XXXXXXXXXXXXXXXXXXXXXXXXXXXXXXXXXXXXXXXXXXXXXXXXXXXXXXXXXXXXXXXXXXXXXXXXXXXXXXXXXXXXXXXXXXXXXXXXXXXXXXXXXXXXXXXXXXXXXXXXXXXXXXXXXXXXXXXXXXXXXXXXXXXXXX--XXXXXXXXX
