----------------------------------------------------------------------------------------------------------------------------------------------------------------------------------------------------------
----------------------------------------------------------------------------------------------------------------------------------------------------------------------------------------------------------
----------------------------------------------------------------------------------------------------------------------------------------------------------------------------------------------------------
----------------------------------------------------------------------------------------------------------------------------------------------------------------------------------------------------------
----------------------------------------------------------------------------------------------------------------------------------------------------------------------------------------------------------
----------------------------------------------------------------------------------------------------------------------------------------------------------------------------------------------------------
---!----------------!!S--!---------------------!--------------------------------------------------------------------------------------------------------------------------------------!-------------------
----------------------------------------------------------------------------------------------------------------------------------------------------------------------------------------------------------
---------------------------------------------------------------g-----------------------------------------------------------------------------#------------------------------------------------------------
-----------------------------------------------------------------------------1--------------------------------------------------------------##-------------------1----------------------------------------
---S!S-------#--#---SS---S!S-------------------S!S-----------S@S---------------!---S@---------------------------!---S@---------------------###-----------------------------S----!---S@S!S--------!---S@---
-------------#--##------------------------------------------------------------------------------------------------------------------------####------------------------------------------------------------
-------------#--###------------------tt------------------###-------------------------------###-------tt-----------------tt-----------tt--########--------------------tt-----------------------------------
-M------gg-g-#--####g----------------tt-------------gg-g-###------------------------g-gg-g-###-------tt--------------g--tt--gg-g-----tt--########--------------------tt--------------g----------------g---
XXXXXXXXXXXXXX--XXXXXXXXXXXXXXXXXXXXXXXXXXXXXXXXXXXXXXXXXXXXXXXXXXXXXXXXXXXXXXXXXXXXXXXXXXXXXXXXXXXXXXXXXXXXXXXXXXXXXXXXXXXXXXXXXXXXXXXXXXXXXXXXXXXXXXXXXXXXXXXXXXXXXXXXXXXXXXXXXXXXXXXXXXXXXXXXXXXXXXXXXX
XXXXXXXXXXXXXX--XXXXXXXXXXXXXXXXXXXXXXXXXXXXXXXXXXXXXXXXXXXXXXXXXXXXXXXXXXXXXXXXXXXXXXXXXXXXXXXXXXXXXXXXXXXXXXXXXXXXXXXXXXXXXXXXXXXXXXXXXXXXXXXXXXXXXXXXXXXXXXXXXXXXXXXXXXXXXXXXXXXXXXXXXXXXXXXXXXXXXXXXXX
