---------------------------------------------------------------------------------------------------------------------------------------------------------------------------------------------------
---------------------------------------------------------------------------------------------------------------------------------------------------------------------------------------------------
---------------------------------------------------------------------------------------------------------------------------------------------------------------------------------------------------
---------------------------------------------------------------------------------------------------------------------------------------------------------------------------------------------------
---------------------------------------------------------------------------------------------------------------------------------------------------------------------------------------------------
---------------------------------------------------------------------------------------------------------------------------------------------------------------------------------------------------
-------------------------------------------------------------!------------------------------------------------------------------!---------!!S------------------------------------------------------
--------------------------------------------------##-----------------------------------------------------------------------------------------------------------------------------------------------
-------------------------------------------------###---------------------------------------------------------------------------------------------------------------------------------------#-------
--------------------!----------------------------###-------1-----------------------------------------------------------1---------------------------1--------------------------------------##-------
---------#--#------------------------------------###---------S!S-------------------!---S@-----!---S@--------------------------!-S!S-------SS------------S---------------#--#-------------####--#---
---------#--##-----------------------------------###--------------------------------------------------------------------------------------------------------------------#--##-----------#####--##--
---------#--###-###------------------------------###--------------------------------------------------------------------------------------------------------------------#--###-----tt--######--###-
-M--gg-g-#--#######---------------------------------------------------------------------g---k------g---------------------------------gg-g-g------------------------gg-g-#--####----tt--######--####
XXXXXXXXXX--XXXXXXXXXXXXXXXXXXXXXXXXXXXXXXXXXX--XXXXXXXXXXXXXXXXXXXX--XXXXXXXXXXXXXXXXXXXXXXXXXXXXXXXXXXXXXXXXXXXXXXXXXXXXXXXXXXXXXXXXXXXXXXXXXXXXXXXXXXXXXXXXXX--XXXXXXX--XXXXXXXXXXXXXXXXXX--XXXX
XXXXXXXXXX--XXXXXXXXXXXXXXXXXXXXXXXXXXXXXXXXXX--XXXXXXXXXXXXXXXXXXXX--XXXXXXXXXXXXXXXXXXXXXXXXXXXXXXXXXXXXXXXXXXXXXXXXXXXXXXXXXXXXXXXXXXXXXXXXXXXXXXXXXXXXXXXXXX--XXXXXXX--XXXXXXXXXXXXXXXXXX--XXXX
