----------------------------------------------------------------------------------------------------------------------------------------------------------------------------------------------------
----------------------------------------------------------------------------------------------------------------------------------------------------------------------------------------------------
----------------------------------------------------------------------------------------------------------------------------------------------------------------------------------------------------
----------------------------------------------------------------------------------------------------------------------------------------------------------------------------------------------------
----------------------------------------------------------------------------------------------------------------------------------------------------------------------------------------------------
-------------------------------------------------------------------------------------------!--------------------------------------------------------------------------------------------------------
------------------------------------------------##--------------------------------------------------------------------------------------------------------------------------------------------------
-----------------------------------------------###--------------------------------------------------------------------------------------------------------------------------------------------------
----------------------------------------------####----------------------------------------------------------------------------------------1-------------------------------------1-------------------
--------------1------------------------------#####-----------------------------------------S!S------------------------S---------!---S@----------------------------S---------------!---S@------------
--------------------------------------------######--------------------------------------------------------------------------------------------------------------------------------------------------
-------------------------------------------#######----------tt--------tt-----------------------------------------------------------------------------tt------------------tt---------------tt--------
--------------------------------------tt--####----------k---tt--------tt-------------------------------------------------------------g---------------tt------------------tt------------g--tt--------
-M---------------------------gg-g-----tt--####XXXXXXXXXXXXXXXXXXXX--XXXXXXXXXXXXXXX--XXXXXXXXXXXXXXXXXXXXXXXXXXXXXXXXXXXXXXXXX--XXXXXXXXXXXXXXXXXXXXXXXXXXXXXXXXXXXXXXXXXXXXXXXXXXXXXXXXXXXXXXXXXXXX
XXXXXXXXXXXXXXXXXXX--XXXXXXXXXXXXXXXXXXXXXXXXXXXXXXXXXXXXXXXXXXXXX--XXXXXXXXXXXXXXX--XXXXXXXXXXXXXXXXXXXXXXXXXXXXXXXXXXXXXXXXX--XXXXXXXXXXXXXXXXXXXXXXXXXXXXXXXXXXXXXXXXXXXXXXXXXXXXXXXXXXXXXXXXXXXX
XXXXXXXXXXXXXXXXXXX--XXXXXXXXXXXXXXXXXXXXXXXXXX-----------------------------------------------------------------------------------------------------------------------------------------------------
