--------------------------------------------------------------------------------------------------------------------------------------------------------------------------------------------
--------------------------------------------------------------------------------------------------------------------------------------------------------------------------------------------
--------------------------------------------------------------------------------------------------------------------------------------------------------------------------------------------
--------------------------------------------------------------------------------------------------------------------------------------------------------------------------------------------
--------------------------------------------------------------------------------------------------------------------------------------------------------------------------------------------
--------------------------------------------------------------------------------------------------------------------------------------------------------------------------------------------
----------------------------!!S--------------------------------------!---------!!S-------------!------------------------!!S-----------------------------------------------------!!S---------
--------------------------------------------------------------------------------------------------------------------------------------------------------------------------------------------
--------------------------------------------------------------------------------------------------------------------------------------------------------------------------------------------
------------------------------------------------------g-------------------------------------------------------------------------------------------------------------------------------------
---!---S@---S---------------SS---!---S@-------------------!---S@-----S!S-------SS--------------S!S--!--!----------------SS--!--!------------------------S------------S----------SS----------
----------------------------------------------------S@S-------------------------------------------------------------------------------------------------------------------------------------
--------------------------------------------------------------------------------------tt----------------------------------------------------------tt-----------tt---------------------------
-M------g--------------gg-g-g---------g------------------------g----------gg-g-g------tt---------------------------gg-g-g-------k-----------------tt-----------tt----------gg-g-g-----------
XXXXXXXXXXXXXXXXXXXX--XXXXXXXXXXXXXXXXXXXXXXXXXXXXXXXXXXXXXXXXXXXXX--XXXXXXXXXXXXXXXXXXXXXXXXXXXXXXXXXXXXXXXXXXXXXXXXXXXXXXXXXXXXXXXXXXXXXXXXXXXXXXXXXXXXXXXXXXXXXXXXXXXXXXXXXXXXXXXXXXXXXXX
XXXXXXXXXXXXXXXXXXXX--XXXXXXXXXXXXXXXXXXXXXXXXXXXXXXXXXXXXXXXXXXXXX--XXXXXXXXXXXXXXXXXXXXXXXXXXXXXXXXXXXXXXXXXXXXXXXXXXXXXXXXXXXXXXXXXXXXXXXXXXXXXXXXXXXXXXXXXXXXXXXXXXXXXXXXXXXXXXXXXXXXXXX
