------------------------------------------------------------------------------------------------------------------------------------------------------------------------------------------------------
------------------------------------------------------------------------------------------------------------------------------------------------------------------------------------------------------
------------------------------------------------------------------------------------------------------------------------------------------------------------------------------------------------------
------------------------------------------------------------------------------------------------------------------------------------------------------------------------------------------------------
------------------------------------------------------------------------------------------------------------------------------------------------------------------------------------------------------
------------------------------------------------------------------------------------------------------------------------------------------------------------------------------------------------------
-------------------------------------------------------------------------------!!S----------------------------------------!-------------------------------------------##------------------------------
---------------------------------------------------------------------------------------------------------------------------------------------------------------------###------------------------------
---------------------#----------------------------------------------------------------------------------------------------------------------------------------------####---------#-------------------#
--------------------##-----------------1------------------------1--------------------------------------1-----------------------------------------------------------##-----------##------------------##
-------------------###----------!--------!---S@---S---------------------#--#---SS-----------------------------------------S!S---------S----------#--#-------------###----------####--#-------------###
------------------####--------------------------------------------------#--##--------------------------------------------------------------------#--##-----------####---------#####--##-----------####
-------------tt--########-----------------------------------------------#--###--------------------------------------S----------------------------#--###-----tt--#####----tt--######--###-----tt--#####
-M--gg-g-----tt--########--------k------------g--------------------gg-g-#--####g-----------------------------------k------------------------gg-g-#--####----tt--#####----tt--######--####----tt--#####
XXXXXXXXXXXXXXXXXXXXXXXXXXXXXXXXXXXXXXXXXXXXXXXXXXXXXXXXXX--XXXXXXXXXXXXX--XXXXXXXXXXXXXXXXXXXXXXXXXXXXXXXXXXXXXXXXXXXXX--XXXXXXX--XXXXXXXXXXXXXXX--XXXXXXXXXXXXXXXXXXXXXXXXXXXXXXX--XXXXXXXXXXXXXXXXX
XXXXXXXXXXXXXXXXXXXXXXXXXXXXXXXXXXXXXXXXXXXXXXXXXXXXXXXXXX--XXXXXXXXXXXXX--XXXXXXXXXXXXXXXXXXXXXXXXXXXXXXXXXXXXXXXXXXXXX--XXXXXXX--XXXXXXXXXXXXXXX--XXXXXXXXXXXXXXXXXXXXXXXXXXXXXXX--XXXXXXXXXXXXXXXXX
