-----------------------------------------------------------------------------------------------------------------------------------------------------------------------------------------
-----------------------------------------------------------------------------------------------------------------------------------------------------------------------------------------
-----------------------------------------------------------------------------------------------------------------------------------------------------------------------------------------
-----------------------------------------------------------------------------------------------------------------------------------------------------------------------------------------
-----------------------------------------------------------------------------------------------------------------------------------------------------------------------------------------
-----------------------------------------------------------------------------------------------------------------------------------------------------------------------------------------
--------------------------------------------------------------------!-----------------------------!----------------------!!S-------------------------------------------------------------
---------------------------------------------------------------------------------------------------------------------------------------------------##------------------------------------
----------------------------------------g-------------------------------------------------------------------------------#-------------------------###------------------------------------
----------------------------------------------------------------------------------------SU-----------------------------##-------------------------###------------------------------------
---!---S@-----------------------------S@S---------------------------S!S-----@------------------SU-S!S-----------------###SS-----------------@-----###---------------!---S@----------S----
---------------------------------------------------------------------------------------------------------------------####-------------------------###------------------------------------
--------------------------------------###--------------------------------------------###------------------------tt--#####-------------------------###------------------------------------
-M------g------------------------gg-g-###---------------------------------------gg-g-###--------k------gg-g-----tt--#####g---------------------k-----------k-------------g---------------
XXXXXXXXXXXXXXXXXXXXXXXXXXXXXXXXXXXXXXXXXXXXXXXXXXXXXXXXXXXXXXXXXXXXXXXXXXXXXXXXXXXXXXXXXXXXXXXXXXXXXXXXXXXXXXXXXXXXXXXXXXXXXXXXXXXXXXXXXXXXXXXXXXXXXXXXXXXXXXXXXXXXXXXXXXXXXXXXXXXXXXXXX
XXXXXXXXXXXXXXXXXXXXXXXXXXXXXXXXXXXXXXXXXXXXXXXXXXXXXXXXXXXXXXXXXXXXXXXXXXXXXXXXXXXXXXXXXXXXXXXXXXXXXXXXXXXXXXXXXXXXXXXXXXXXXXXXXXXXXXXXXXXXXXXXXXXXXXXXXXXXXXXXXXXXXXXXXXXXXXXXXXXXXXXXX
