-------------------------------------------------------------------------------------------------------------------------------------------------------------------------------------------------------
-------------------------------------------------------------------------------------------------------------------------------------------------------------------------------------------------------
-------------------------------------------------------------------------------------------------------------------------------------------------------------------------------------------------------
-------------------------------------------------------------------------------------------------------------------------------------------------------------------------------------------------------
-------------------------------------------------------------------------------------------------------------------------------------------------------------------------------------------------------
-------------------------------------------------------------------------------------------------!---------------------------------------------------!--------------------------------------------!!S--
------------------------------------!------------------------------------------##-----------##---------------------------------------------------------------------------------------------------------
------------------------------------------------------------------------------###----------###---------------------------------------------------------------------------------------------------#-----
----------------------------------------------------------------#------------####---------####-------------------------------------------------------------------------------1------------------##-----
--------------------------------------------1------------------##-----------##-----------#####---S!S-------------------------------------------------S!S----S----------------------------------###SS---
-------------------------------S----S!S-----------------------###----------###----------######------------------------------------------------------------------------------------------------####-----
-------------------------------------------------------------####---------####---------#######-------------------------------------------------------------------------------------------tt--#####-----
-----tt-------------------------------------------------tt--#####----tt--#####----tt--#####----k--------------------------------------------------------------------------------gg-g-----tt--#####g----
-M---tt----------------------------------------gg-g-----tt--#####----tt--#####----tt--#####-XXXXXXXXXXXX--XXXXXXXXX--XXXXXXXXXXXXXXXXXXXXXXX--XXXXXXXXXXXXXXXXXXXXXXXXXXXXXXXXXXXXXXXXXXXXXXXXXXXXXXXXX
XXXXXXXXXXXXXXXXXXX--XXXXXXXXXXXXXXXXXXXXXXXXXXXXXXXXXXXXXXXXXXXXXXXXXXXXXXXXXXXXXXXXXXXXXX-XXXXXXXXXXXX--XXXXXXXXX--XXXXXXXXXXXXXXXXXXXXXXX--XXXXXXXXXXXXXXXXXXXXXXXXXXXXXXXXXXXXXXXXXXXXXXXXXXXXXXXXX
XXXXXXXXXXXXXXXXXXX--XXXXXXXXXXXXXXXXXXXXXXXXXXXXXXXXXXXXXXXXXXXXXXXXXXXXXXXXXXXXXXXXXXXXXX------------------------------------------------------------------------------------------------------------
