-----------------------------------------------------------------------------------------------------------------------------------------------------------------------------------------
-----------------------------------------------------------------------------------------------------------------------------------------------------------------------------------------
-----------------------------------------------------------------------------------------------------------------------------------------------------------------------------------------
-----------------------------------------------------------------------------------------------------------------------------------------------------------------------------------------
-----------------------------------------------------------------------------------------------------------------------------------------------------------------------------------------
-----------------------------------------------------------------------------------------------------------------------------------------------------------------------------------------
------------------------------------------------------##-----------------!!S--------!!S-----------------------------------------------------------------------------------!--------------
-----------------------------------------------------###---------------------------------------------------------------------------------------------------------------------------------
----------------------------------------------------####---------#----------------------------------------------------------------------------------------------------------------g------
---------------------------------------------------##-----------##----------------------------------------------------------------------------------1------------1-----------------------
------------------------SU-------#--#-------------###----------####--#---SS---------SS-------------------S---------------------------!---S@-------------------------------S!S---S@S------
----------------g----------------#--##-----------####---------#####--##------------------------------------------------------------------------------------------------------------------
--------------SSSSS--------------#--###-----tt--#####----tt--######--###-------------------------------------------------------------------------------------------------S---------------
-M----------------k---------gg-g-#--####----tt--#####----tt--######--####g-----gg-g-g---------------k-------------------------------------g---k------------------------------------------
XXXXXX--XXXXXXXXXXXXXXXXXXXXXXXXXX--XXXXXXXXXXXXXXXXXXXXXXXXXXXXXXX--XXXXXXXXXXXXXXXXXXXXXXXXXXXXXXXXXXXXXXXXXXXX--XXXXXXXXXXXXXXXX--XXXXXXXXXXXXXXXXXXXXXXXXXXXXXXXXXXXXXXXXXXXXXXXX---X
XXXXXX--XXXXXXXXXXXXXXXXXXXXXXXXXX--XXXXXXXXXXXXXXXXXXXXXXXXXXXXXXX--XXXXXXXXXXXXXXXXXXXXXXXXXXXXXXXXXXXXXXXXXXXX--XXXXXXXXXXXXXXXX--XXXXXXXXXXXXXXXXXXXXXXXXXXXXXXXXXXXXXXXXXXXXXXXX---X
