-----------------------------------------------------------------------------------------------------------------------------------------------------------------------
-----------------------------------------------------------------------------------------------------------------------------------------------------------------------
-----------------------------------------------------------------------------------------------------------------------------------------------------------------------
-----------------------------------------------------------------------------------------------------------------------------------------------------------------------
-----------------------------------------------------------------------------------------------------------------------------------------------------------------------
-----------------------------------------------------------------------------------------------------------------------------------------------------------------------
---------------------------------------------------------------------!------------------------!-----------!--------!---------------------------------------------------
-----------------------------------------------------------------------------------------------------------------------------------------------------------------------
----------------------------------------------#------------g-----------------------------------------------------------------------------------------------------------
--------------------------@------------------##!--!----------------1------------------------------------------------------------1--------------------------------------
--------------------------------------------###----------S@S---------S!S-!---S@---------!--!--S!S----S----S-----SU-S-----SU------------!---S@------#--#----------------
-------------------------------------------####----------------------------------------------------------------------------------------------------#--##---------------
--------------------###---------------tt--########----------------------------------------------------------------------------------tt-------------#--###-###----------
-M-------------gg-g-###------gg-g-----tt--########----------------------------g---k---------k--------------------k--------k---------tt------g-gg-g-#--#######--------k-
XXXXXXXXXXXX--XXXXXXXXXXXXXXXXXXXXXXXXXXXXXXXXXXXXXXXXXXXXXXXXXXXXXXXXXXXXXXXXXXXXXXXXX--XXXXXXXXXXXXXXXXXXXXXXXXXXXXXXXXXXXXXXXXXXXXXXXXXXXXXXXXXXX--XXXXXXXXXXXXXXXXX
XXXXXXXXXXXX--XXXXXXXXXXXXXXXXXXXXXXXXXXXXXXXXXXXXXXXXXXXXXXXXXXXXXXXXXXXXXXXXXXXXXXXXX--XXXXXXXXXXXXXXXXXXXXXXXXXXXXXXXXXXXXXXXXXXXXXXXXXXXXXXXXXXX--XXXXXXXXXXXXXXXXX
