---------------------------------------------------------------------------------------------------------------------------------------------------------------------------------------------
---------------------------------------------------------------------------------------------------------------------------------------------------------------------------------------------
---------------------------------------------------------------------------------------------------------------------------------------------------------------------------------------------
---------------------------------------------------------------------------------------------------------------------------------------------------------------------------------------------
---------------------------------------------------------------------------------------------------------------------------------------------------------------------------------------------
---------------------------------------------------------------------------------------------------------------------------------------------------------------------------------------------
-------------------------------------------------------------------------------##-----------------!!S-----------------------------!----------------------------------------------------------
------------------------------------------------------------------------------###------------------------------------------------------------------##----------------------------------------
----------------------------------------------------------------#------------####---------#-------------------------------------------------------###----------------------------------------
--------------------1------------------1-----------------------##-----------##-----------##-------------------------------------------------------###----------------------------------------
--------------------------------------------------------------###----------###----------####--#---SS------S--------------------!--S!S-------------###---------------------!--!---------------
-------------------------------------------------------------####---------####---------#####--##--------------------------------------------------###----------------------------------------
-------------------------------------------tt-----------tt--#####----tt--#####----tt--######--###-------------------------------------------------###----------------------------------------
-M-------------------------------k---------tt--gg-g-----tt--#####----tt--#####----tt--######--####g---------------------------------------------------k-----------------------k--------------
XXXXXX--XXXXXXXXXXXXXXXXXXXXXXXXXXXXXXXXXXXXXXXXXXXXXXXXXXXXXXXXXXXXXXXXXXXXXXXXXXXXXXXXXXXX--XXXXXXXXXXXXXXXXXXXXXXXXXXX--XXXXXXXXXXXXXX--XXXXXXXXXXXXXXXX--XXXXXXXXXXXXXXXXXXXXXX--XXXXXXXX
XXXXXX--XXXXXXXXXXXXXXXXXXXXXXXXXXXXXXXXXXXXXXXXXXXXXXXXXXXXXXXXXXXXXXXXXXXXXXXXXXXXXXXXXXXX--XXXXXXXXXXXXXXXXXXXXXXXXXXX--XXXXXXXXXXXXXX--XXXXXXXXXXXXXXXX--XXXXXXXXXXXXXXXXXXXXXX--XXXXXXXX
