--------------------------------------------------------------------------------------------------------------------------------------------------------------------------------------------------
--------------------------------------------------------------------------------------------------------------------------------------------------------------------------------------------------
--------------------------------------------------------------------------------------------------------------------------------------------------------------------------------------------------
--------------------------------------------------------------------------------------------------------------------------------------------------------------------------------------------------
--------------------------------------------------------------------------------------------------------------------------------------------------------------------------------------------------
--------------------------------------------------------------------------------------------------------------------------------------------------------------------------------------------------
------------------------------------!---------!!S--------!!S--!-----------------------------------------------!---------!!S-----------------!-----------------------------------------------------
--------------------------------------------------------------------------------------------------------------------------------------------------------------------------------------------------
-----------------------------------------------------------------------------------------------------------------------------------------------------------------------------------g--------------
----------------------------------1--------------------------------------------------------------------1------------------------------------------------------------------------------------------
------------------------------------S!S-------SS---------SS---S!S-!---S@---S----------------------------------S!S-------SS------------------S!S-----SU---!-----------------------S@S--------------
--------------------------------------------------------------------------------------------------------------------------------------------------------------------------------------------------
--------------###---------------------------------------------------------------------------------------------------------------------------------------------------------------------------------
-M-------gg-g-###------------------------gg-g-g-----gg-g-g-------------g------------------------------------k------gg-g-g---------------------------------k---------------------------------------
XXXXXX--XXXXXXXXXXXXXXXXXXXXXXXXXXXXXXXXXXXXXXXXXXXXXXXXXXXXXXXXXXXXXXXXXXXXXXXXXXXXXXXXXX--XXXXXXXXXXXXXXXXXXXXXXXXXXXXXXXXXXXXXXXXXXXXXXXXXXXXXXXXXXXXXXXXXXXXXXXXXX--XXXXXXXXXXXXXXXXXXXXXX---X
XXXXXX--XXXXXXXXXXXXXXXXXXXXXXXXXXXXXXXXXXXXXXXXXXXXXXXXXXXXXXXXXXXXXXXXXXXXXXXXXXXXXXXXXX--XXXXXXXXXXXXXXXXXXXXXXXXXXXXXXXXXXXXXXXXXXXXXXXXXXXXXXXXXXXXXXXXXXXXXXXXXX--XXXXXXXXXXXXXXXXXXXXXX---X
