-----------------------------------------------------------------------------------------------------------------------------------------------------------------------------------------
-----------------------------------------------------------------------------------------------------------------------------------------------------------------------------------------
-----------------------------------------------------------------------------------------------------------------------------------------------------------------------------------------
-----------------------------------------------------------------------------------------------------------------------------------------------------------------------------------------
-----------------------------------------------------------------------------------------------------------------------------------------------------------------------------------------
-----------------------------------------------------------------------------------------------------------------------------------------------------------------------------------------
---------------------------------------------------------------------!-----------------------------!-----------------------------------------------------------------------!-------------
-----------------------------------------------------------------------------------------------------------------------------------------------------------------------------------------
-------------------------------------------------------------------------------------------------------------------------#------------#--------------------------------------------------
------------------------1----------------------------------------------------------1------------------------------------##-----------##-------!--!---------------------------------------
-----------------!----------------------------------------------S----S!S-------------!---S@--------S!S-----------------###----------####--#-------------------S------------S!S-----!--!--
-------------------------------------------S@-------------------------------------------------------------------------####---------#####--##---------------------------------------------
----------tt----------------------------------------tt-----------------------------------------------------------tt--#####----tt--######--###-###--------------------------------tt------
-M--------tt-------------------------------k--------tt------------------------------------g-------------gg-g-----tt--#####----tt--######--#######--------k-----------------------tt----k-
XXXXXX--XXXXXXXXXXXXXXXXXXXXXXXXXXXXXXXXXXXXXXXX--XXXXXXXXXXXXXXXXXXXXXXXXXXXXXXXXXXXXXXXXXXXXXXXXXXXXXXXXXXXXXXXXXXXXXXXXXXXXXXXXXXXXXX--XXXXXXXXXXXXXXXXXXXXXXXXXXXXXXXXXXXXXXXXXXXXXXX
XXXXXX--XXXXXXXXXXXXXXXXXXXXXXXXXXXXXXXXXXXXXXXX--XXXXXXXXXXXXXXXXXXXXXXXXXXXXXXXXXXXXXXXXXXXXXXXXXXXXXXXXXXXXXXXXXXXXXXXXXXXXXXXXXXXXXX--XXXXXXXXXXXXXXXXXXXXXXXXXXXXXXXXXXXXXXXXXXXXXXX
