------------------------------------------------------------------------------------------------------------------------------------------------------------------------------------
------------------------------------------------------------------------------------------------------------------------------------------------------------------------------------
------------------------------------------------------------------------------------------------------------------------------------------------------------------------------------
------------------------------------------------------------------------------------------------------------------------------------------------------------------------------------
------------------------------------------------------------------------------------------------------------------------------------------------------------------------------------
------------------------------------------------------------------------------------------------------------------------------------------------------------------------------------
-------------------------------------------------------------------!-----------------------------------------------------------------------------##----------!----------------------
------------------------------------------------------------------------------------------------------------------------------------------------###---------------------------------
-------g---------------------------------------------------------------------------------------------------------------------------------------####---------------------------------
-----------------------------------------------------------------1-----------------------------------------1----------------------------------#####---------------------------------
-----S@S--------------------!---S@----------------------S----------S!S---------S--------------------SU-----------------!---S@----------------######----------S!S-!---S@-------------
--------------------------------------------------------------------------------------------------------------------------------------------#######---------------------------------
---------------S--tt-----------------------------------------------------tt-----------------------------------------tt-----------------tt--########-------tt------------------------
-M------------k---tt-------------g---------------------------------------tt-------------------k-----------------k---tt------g-gg-g-----tt--########-------tt----------g---k---------
XXXXXXXXXXXXXXXXXXXXXXXXXXXXXXXXXXXXXXXXXXXXXXXXXXX--XXXXXXXXXXXXXXXXXXXXXXXXXXXXXXXXXXXXXXXXXXXXXXXXXXXXXXXXXXXXXXXXXXXXXXXXXXXXXXXXXXXXXXXXXXXXXXXXXXXXXXXXXXXXXXXXXXXXXXXXXXXXXXX
XXXXXXXXXXXXXXXXXXXXXXXXXXXXXXXXXXXXXXXXXXXXXXXXXXX--XXXXXXXXXXXXXXXXXXXXXXXXXXXXXXXXXXXXXXXXXXXXXXXXXXXXXXXXXXXXXXXXXXXXXXXXXXXXXXXXXXXXXXXXXXXXXXXXXXXXXXXXXXXXXXXXXXXXXXXXXXXXXXX
