----------------------------------------------------------------------------------------------------------------------------------------------------------------------------------
----------------------------------------------------------------------------------------------------------------------------------------------------------------------------------
----------------------------------------------------------------------------------------------------------------------------------------------------------------------------------
----------------------------------------------------------------------------------------------------------------------------------------------------------------------------------
----------------------------------------------------------------------------------------------------------------------------------------------------------------------------------
-------------------------------------------------------------------------------------------------------------------------------------@--------------------------------------------
---------------------------------------------------!!S------------------!--------!----------------------!!S------------------------------------------------------------------!!S--
----------------------------------------------------------------------------------------------------------------------------------------------------------------------------------
----------------------------------------------------------------------------------------------------------------------------------------------------------------------------#-----
-------------------------1--------------------------------------------1--------------------------------------------------------------------------1-------------------------##-----
---------------------------------------------------SS-------------------S!S------S!S---------S----------SS--!--!-----S------SU---------------------------#--#-------------###SS---
------------------------------------------------------------------------------------------------------------------------------------S@-------------------#--##-----------####-----
---------------------------------------------------------------tt-------------tt-------tt----------------------------------------------------------------#--###-----tt--#####-----
-M------------k-------------------------------gg-g-g-------k---tt-------------tt-------tt----------gg-g-g-------k------------k----------------------gg-g-#--####----tt--#####g----
XXXXXXXXXXXXXXXXXXX--XXXXXXXXXXXXXXXX--XXXXXXXXXXXXXXXXXXXXXXXXXXXXXXXXXXXXXXXXXXXXXXXXXXXXXXXXXXXXXXXXXXXXXXXXXXXXXXXXXXXXXXXXXXXXXXXXXXXXXXXXXXXXXXXXXXX--XXXXXXXXXXXXXXXXXXXXXX
XXXXXXXXXXXXXXXXXXX--XXXXXXXXXXXXXXXX--XXXXXXXXXXXXXXXXXXXXXXXXXXXXXXXXXXXXXXXXXXXXXXXXXXXXXXXXXXXXXXXXXXXXXXXXXXXXXXXXXXXXXXXXXXXXXXXXXXXXXXXXXXXXXXXXXXX--XXXXXXXXXXXXXXXXXXXXXX
