-------------------------------------------------------------------------------------------------------------------------------------------------------------------------------------------------
-------------------------------------------------------------------------------------------------------------------------------------------------------------------------------------------------
-------------------------------------------------------------------------------------------------------------------------------------------------------------------------------------------------
-------------------------------------------------------------------------------------------------------------------------------------------------------------------------------------------------
-------------------------------------------------------------------------------------------------------------------------------------------------------------------------------------------------
-------------------------------------------------------------------------------------------------------------------------------------------------------------------------------------------------
----------------------------------!---------------##-------------------------------------------------------!------------------------------------------!-----------------------!------------------
-------------------------------------------------###---------------------------------------------------------------------------------------------------------------------------------------------
-------------------------------------------------###---------------------------------------------------------------------------------------------------------------------------------------------
---------------1---------------------------------###--------------1-----------------------SU-------------1---------------------------------------------------------------------------------------
----------------------------!---S@S!S------------###------------------------S------------------!---S@------S!S-------!---S@----------!----------------S!S-!---S@--------!---S@S!S-----------S----
-------------------------------------------------###---------------------------------------------------------------------------------------------------------------------------------------------
-------------------------------------------------###-----------------------------------###-------------------------------------------------------------------------------------------------------
-M-------------------------------g----------gg-g-###------------------------------gg-g-###----------g---------------------g----------k-------------------------g-------------g-------------------
XXXXXXXXXXXXXXXXXXXX--XXXXXXXXXXXXXXXXXXX--XXXXXXXXXXXXXXXXX--XXXXXXXXX--XXXXXXXXXXXXXXXXXXXXXXXXXXXXXXXXXXXXXXXXXXXXXXXXXXXXXXXXXXXXXXXXXXXXXXXXXXXXXXXXXXXXXXXXXXXXXXXXXXXXXXXXXXXXXXXXXXXXXXXX
XXXXXXXXXXXXXXXXXXXX--XXXXXXXXXXXXXXXXXXX--XXXXXXXXXXXXXXXXX--XXXXXXXXX--XXXXXXXXXXXXXXXXXXXXXXXXXXXXXXXXXXXXXXXXXXXXXXXXXXXXXXXXXXXXXXXXXXXXXXXXXXXXXXXXXXXXXXXXXXXXXXXXXXXXXXXXXXXXXXXXXXXXXXXX
