-------------------------------------------------------------------------------------------------------------------------------------------------------------------------------------
-------------------------------------------------------------------------------------------------------------------------------------------------------------------------------------
-------------------------------------------------------------------------------------------------------------------------------------------------------------------------------------
-------------------------------------------------------------------------------------------------------------------------------------------------------------------------------------
-------------------------------------------------------------------------------------------------------------------------------------------------------------------------------------
-------------------------------------------------------------------------------------------------------------------------------------------------------------------------------------
----------------------------------!--------------------------!--------!------------------------!----------!------------------------------##------------------------------------------
----------------------------------------------------------------------------------------------------------------------------------------###------------------------------------------
---------------------------------------------------------------------------------------------------------------------------------------####------------------------------------------
--------------------------------------------------------------------------------------------------------------------------------------#####--------------SU--------------------------
------S---------!---S@-----!------S!S---------------!--------S!S------S!S------------S---------S!S--------S!S-------#--#-------------######-------------------------------------g----
--------------------------------------------------------------------------------------------------------------------#--##-----------#######-----------------------------------SSSSSSS
-------------------------------tt-------------tt--------------------------------------------tt----------------------#--###-----tt--########-----------###----------------###---------
-M-------------------g---------tt-------------tt----k---------------------------------------tt-----------------gg-g-#--####----tt--########------gg-g-###-----------gg-g-###---------
XXXXXXXXXXXXXX--XXXXXXXXXXXXXXXXXXXXXXXXXXXXXXXXXXXXXXXXXXXXXXXXXXXX--XXXXXXXXXXXXXXXXXXXXXXXXXXXXXXXXXXXXXXXXXXXXXXX--XXXXXXXXXXXXXXXXXXXXXXXXXXXXXXXXXXXXXXXXXX--XXXXXXXXXXXXXX----
XXXXXXXXXXXXXX--XXXXXXXXXXXXXXXXXXXXXXXXXXXXXXXXXXXXXXXXXXXXXXXXXXXX--XXXXXXXXXXXXXXXXXXXXXXXXXXXXXXXXXXXXXXXXXXXXXXX--XXXXXXXXXXXXXXXXXXXXXXXXXXXXXXXXXXXXXXXXXX--XXXXXXXXXXXXXX----
