----------------------------------------------------------------------------------------------------------------------------------------------------------------------------------------------------------
----------------------------------------------------------------------------------------------------------------------------------------------------------------------------------------------------------
----------------------------------------------------------------------------------------------------------------------------------------------------------------------------------------------------------
----------------------------------------------------------------------------------------------------------------------------------------------------------------------------------------------------------
----------------------------------------------------------------------------------------------------------------------------------------------------------------------------------------------------------
----------------------------------------------------------------------------------------------------------------------------------------------------------------------------------------------------------
-----------------------------------------------##-------------------------------------------------------------!-----------------------!-------------------------------------------------------------------
----------------------------------------------###---------------------------------------------------------------------------------------------------------------------------------------------------------
---------------------------------------------####---------------------------------------------------------------------------------------------------------------------------------------------------------
------------1-------------------------------#####---------------------------------------------------1-------------------------------------------------1-----------------------g---------------------------
---------------------!---S@----------------######-----!---S@------!---S@------------------!---S@--------------S!S----S----------------S!S----S----------------#--#--------------------------S-------------
------------------------------------------#######-------------------------------------------------------------------------------------------------------------#--##---------S@S---------------------------
-------------------------------------tt--########--------------------------------tt---------------------------------------------------------------------------#--###-###----------------------------------
-M------------------------g-gg-g-----tt--########----------g-----------g---------tt------------g---------------------------------------------------------gg-g-#--#######--------k-------------------------
XXXXXX--XXXXXXXXXXXXXXXXXXXXXXXXXXXXXXXXXXXXXXXXXXXXXXXXXXXXXXXXXXXXXXXXXXXXXXXXXXXXXXXXXXXXXXXXXXXXXXXXXXXXXXXXXXXXXXXXXXXXX--XXXXXXXXXXXXXXXXXXXXXXXXXXXXXXXX--XXXXXXXXXXXXXXXXXXXXXXXXXXXXXXXXXXXXXXXXX
XXXXXX--XXXXXXXXXXXXXXXXXXXXXXXXXXXXXXXXXXXXXXXXXXXXXXXXXXXXXXXXXXXXXXXXXXXXXXXXXXXXXXXXXXXXXXXXXXXXXXXXXXXXXXXXXXXXXXXXXXXXX--XXXXXXXXXXXXXXXXXXXXXXXXXXXXXXXX--XXXXXXXXXXXXXXXXXXXXXXXXXXXXXXXXXXXXXXXXX
