-----------------------------------------------------------------------------------------------------------------------------------------------------------------------------------------------------
-----------------------------------------------------------------------------------------------------------------------------------------------------------------------------------------------------
-----------------------------------------------------------------------------------------------------------------------------------------------------------------------------------------------------
-----------------------------------------------------------------------------------------------------------------------------------------------------------------------------------------------------
------------SU---------------------------------------------------------------------------------------------------------------------------------------------------------------------------------------
-----------------------------------------------------------------------------------------------------------------------------------------------------------------------------------------------------
------------------------------!------------------------------------------------------------------------------------------------------------------------------------------------------!!S-------------
-----------------------------------------------------------------------------------------------------------------------------------------------------------------------------------------------------
-------------g---------------------------------------------------------------------------------------------------------------------------------------------------------------------------------------
--------------------------------------------------------------------------------1-----------------1--------------------------------------------------------------------------@-----------------------
---!---S---S@S----------------S!S-----------------------------------------------------------------------------------------------------------------#--#----------g--------------------SS--------------
--------------------------------------------------------------------------------------------------------------------------------------------------#--##-------SSS------------------------------------
----------------------------------------------------------------------------------------------------------------------------tt--------------------#--###-###-----------###---------------------------
-M------g----------------------------------------------------------------------------k--------------------------------------tt---------------gg-g-#--#######------gg-g-###------gg-g-g---------------
XXXXXXXXXXXXXXXXXXXXXXXXXXXXXXXXXXXXXXXXXXXXXXXXXX--XXXXXXXXX--XXXXXXXXXXXXXXXXXXXXXXXXXXXXXXXXXXXXXXXXXXXXXXXXXXXXXXXXXXXXXXXXXXXXXXXXXXXXXXXXXXXX--XXXXXXXXXXXXXXXXXXXXXXXXXXXXXXXXXXXXXXXXXXXX---X
XXXXXXXXXXXXXXXXXXXXXXXXXXXXXXXXXXXXXXXXXXXXXXXXXX--XXXXXXXXX--XXXXXXXXXXXXXXXXXXXXXXXXXXXXXXXXXXXXXXXXXXXXXXXXXXXXXXXXXXXXXXXXXXXXXXXXXXXXXXXXXXXX--XXXXXXXXXXXXXXXXXXXXXXXXXXXXXXXXXXXXXXXXXXXX---X
