------------------------------------------------------------------------------------------------------------------------------------------------------------------------------------------------
------------------------------------------------------------------------------------------------------------------------------------------------------------------------------------------------
------------------------------------------------------------------------------------------------------------------------------------------------------------------------------------------------
------------------------------------------------------------------------------------------------------------------------------------------------------------------------------------------------
------------------------------------------------------------------------------------------------------------------------------------------------------------------------------------------------
------------------------------------------------------------------------------------------------------------------------------------------------------------------------------------------------
-----------------------------------------!!S--------!!S-------------!!S-----------------------------------------!!S-------------------------------------------------------------------------!---
-----------------------------------------------------------------------------------------------##-----------------------------------------------------------------------------------------------
----------------------------------------#-----------------------------------------------------###-----------------------------------------------------------------------------------------------
-------------1-------------------------##-----------------------------------------------------###---------------------------------------------------------------1-------------------------------
---------------------#--#-------------###SS---------SS--------------SS---------!---S@---S-----###---------------SS-------@----------------------------------------!---S@-----------------@--S!S-
---------------------#--##-----------####-----------------------------------------------------###-----------------------------------------------------------------------------------------------
---------------------#--###-----tt--#####------------------tt---------------------------------###-----------------------------------------------------------------------------------------------
-M--------------gg-g-#--####----tt--#####g-----gg-g-g------tt--gg-g-g---------------g----------------------gg-g-g------------------------------------------------------g------------------k-----
XXXXXXXXXXXXXXXXXXXXXX--XXXXXXXXXXXXXXXXXXXXXXXXXXXXXXXXXXXXXXXXXXXXXXXXXXXXXXXXXXXXXXXXXXXXXXXXXXXXXXXXXXXXXXXXXXXXXXXXXXXXXXXXXXXXX--XXXXXXXXXXXXXXXXXXXXXXXXXXXXXXXXXXXXXXXXXXXXXXXXXXXXXXXXX
XXXXXXXXXXXXXXXXXXXXXX--XXXXXXXXXXXXXXXXXXXXXXXXXXXXXXXXXXXXXXXXXXXXXXXXXXXXXXXXXXXXXXXXXXXXXXXXXXXXXXXXXXXXXXXXXXXXXXXXXXXXXXXXXXXXX--XXXXXXXXXXXXXXXXXXXXXXXXXXXXXXXXXXXXXXXXXXXXXXXXXXXXXXXXX
