----------------------------------------------------------------------------------------------------------------------------------------------------------------------------------------------------------
----------------------------------------------------------------------------------------------------------------------------------------------------------------------------------------------------------
----------------------------------------------------------------------------------------------------------------------------------------------------------------------------------------------------------
----------------------------------------------------------------------------------------------------------------------------------------------------------------------------------------------------------
----------------------------------------------------------------------------------------------------------------------------------------------------------------------------------------------------------
----------------------------------------------------------------------------------------------------------------------------------------------------------------------------------------------------------
-----------------------------------------------------------------------------------------------------------------------------------!-------------------------!-------------------------------------------#
--------------------------------------------------------------------------------------------------------------------------------------------------------------------------------------------------------##
------------------------------------#-------------------#------------#-------------------#---------g-------------------------------------------------------------------------------#-------------------###
-----------------------------------##------------------##-----------##------------------##----------------------------------------------------------------------------------------##------------------####
-----------------#--#-------------####--#-------------###----------####--#-------------####--#---S@S--------S----------------------S!S-!---S@----------------S!S-----------------####--#-------------#####
-----------------#--##-----------#####--##-----------####---------#####--##-----------#####--#----------------------------------------------------------------------------------#####--##-----------######
-----------------#--###-----tt--######--###-----tt--#####----tt--######--###-----tt--######--###-###-----------------------------------------------------------------------tt--######--###-----tt--#####--
-M----------gg-g-#--####----tt--######--####----tt--#####----tt--######--####----tt--######--#######----------------k-----------------------g--------k------------gg-g-----tt--######--####----tt--#####--
XXXXXXXXXXXXXXXXXX--XXXXXXXXXXXXXXXXXX--XXXXXXXXXXXXXXXXXXXXXXXXXXXXXXX--XXXXXXXXXXXXXXXXXX--XXXXXXXXXXXXXXXXXXXXXXXXXXXXXXXXXXXXXXXXXXXXXXXXXXX--XXXXXXXXXXXXXXXXXXXXXXXXXXXXXXXXXXX--XXXXXXXXXXXXXXXXX--
XXXXXXXXXXXXXXXXXX--XXXXXXXXXXXXXXXXXX--XXXXXXXXXXXXXXXXXXXXXXXXXXXXXXX--XXXXXXXXXXXXXXXXXX--XXXXXXXXXXXXXXXXXXXXXXXXXXXXXXXXXXXXXXXXXXXXXXXXXXX--XXXXXXXXXXXXXXXXXXXXXXXXXXXXXXXXXXX--XXXXXXXXXXXXXXXXX--
