----------------------------------------------------------------------------------------------------------------------------------------------------------------------------------------------------------
----------------------------------------------------------------------------------------------------------------------------------------------------------------------------------------------------------
----------------------------------------------------------------------------------------------------------------------------------------------------------------------------------------------------------
----------------------------------------------------------------------------------------------------------------------------------------------------------------------------------------------------------
----------------------------------------------------------------------------------------------------------------------------------------------------------------------------------------------------------
----------------------------------------------------------------------------------------------------------------------------------------------------------------------------------------------------------
-----------------------------------------------------##-------------------------------------------------------------------------!----------------------------------------------!!S--------------------!!S-
----------------------------------------------------###---------------------------------------------------------------------------------------------------------------------------------------------------
---------------------------------------------------#------------------------------------------------------------------------------------------------------------------------------------------------------
------g-------------------------------------------##--------------------------------------------------------------------------------------------1---------------------------------------------------------
----------------------!---S@---------------------####--#-----------------!---S@---S--------------------------------S------------S!S----S--------------------------------#--#---SS--------------#--#---SS--
----S@S-----------------------------------------#####--##---------------------------------------------------------------------------------------------------------------#--##------------------#--##------
------------tt----------------tt-----------tt--######--###-###-----------------------------------------tt------------------------------------------------------tt-------#--###--------tt-------#--###-----
-M----------tt-------------g--tt--gg-g-----tt--######--#######----------------g------------------------tt------------------------------------------------------tt--gg-g-#--####g------tt--gg-g-#--####g---
XXXXXXXXXXXXXXXXXXXXXXXXXXXXXXXXXXXXXXXXXXXXXXXXXXXXX--XXXXXXXXXXXXXXXXXXXXXXXXXXXXXXXXXXXXXXXXXXXXXXXXXXXXXXXXXXXXXXXXXXXXXXXXXXXXXXXXXXXXXXXXXXXXXXXXXXXX--XXXXXXXXXXXX--XXXXXXXXXXXXXXXXXXXXX--XXXXXXXX
XXXXXXXXXXXXXXXXXXXXXXXXXXXXXXXXXXXXXXXXXXXXXXXXXXXXX--XXXXXXXXXXXXXXXXXXXXXXXXXXXXXXXXXXXXXXXXXXXXXXXXXXXXXXXXXXXXXXXXXXXXXXXXXXXXXXXXXXXXXXXXXXXXXXXXXXXX--XXXXXXXXXXXX--XXXXXXXXXXXXXXXXXXXXX--XXXXXXXX
