---------------------------------------------------------------------------------------------------------------------------------------------------------------------------------------------------
---------------------------------------------------------------------------------------------------------------------------------------------------------------------------------------------------
---------------------------------------------------------------------------------------------------------------------------------------------------------------------------------------------------
---------------------------------------------------------------------------------------------------------------------------------------------------------------------------------------------------
---------------------------------------------------------------------------------------------------------------------------------------------------------------------------------------------------
---------------------------------------------------------------------------------------------------------------------------------------------------------------------------------------------------
--------------------------------------!---------!-----------------!----------------------!!S----------------------------------!!S------------------------!!S---------------------------------------
---------------------------------------------------------------------------------------------------------------------------------------------------------------------------------------------------
----------------------------g----------------------------------------------------------------------------------------------------------------------------------------------------------------------
----------------------------------------------1-----------!--!------------------------------------1--------------------------------------------------------------------------------------@---------
------S-------------------S@S---!---S@S!S-------S!S---------------S!S----S---------------SS-----------------------------------SS--------------S----------SS-----------------#--#--------------S----
------------------------------------------------------------------------------------------------------------g---------------------------------------------------------------#--##------------------
----------------------------------------------------------###---------------------------------------------SSSSSSS-----------------------------------------------------------#--###-###-------------
-M-----------------------------------g---------------gg-g-###-----------------------gg-g-g--------------------k----------gg-g-g---------------------gg-g-g-------------gg-g-#--#######-------------
XXXXXXXXXXXXXXXXXXXXXXXXXXXXXXXXXXXXXXXXXXXXXXXXXXXXXXXXXXXXXXXXXXXXXXXXXXXXXXXXX--XXXXXXXXXXXXXXXXXXXXXXXXXXXXXXXXXXXXXXXXXXXXXXXXXXXXXXXXXXXXXXXXXXXXXXXXXXXXXXXXXXXXXXXXXX--XXXXXXXXXXXXXXXXXXXX
XXXXXXXXXXXXXXXXXXXXXXXXXXXXXXXXXXXXXXXXXXXXXXXXXXXXXXXXXXXXXXXXXXXXXXXXXXXXXXXXX--XXXXXXXXXXXXXXXXXXXXXXXXXXXXXXXXXXXXXXXXXXXXXXXXXXXXXXXXXXXXXXXXXXXXXXXXXXXXXXXXXXXXXXXXXX--XXXXXXXXXXXXXXXXXXXX
