----------------------------------------------------------------------------------------------------------------------------------------------------------------------------------------
----------------------------------------------------------------------------------------------------------------------------------------------------------------------------------------
----------------------------------------------------------------------------------------------------------------------------------------------------------------------------------------
----------------------------------------------------------------------------------------------------------------------------------------------------------------------------------------
----------------------------------------------------------------------------------------------------------------------------------------------------------------------------------------
----------------------------------------------------------------------------------------------------------------------------------------------------------------------------------------
----------------!-----------------------------------------------------------------------------------------!!S---------------------------------------------------------------------------
---------------------------------##-----------------------------------------------------------------------------------------------------------------------------------------------------
--------------------------------###-----------------------------------------------------------------------------------------------------------------------------------------------------
--------------------------------###-----------------------------------------------------------------------------------------------------1-----------------------------------------------
----------------S!S----S--------###-----------------------------------SU----------------------------------SS------------------------------------!---S@----------------------------------
--------------------------------###-----------------------------------------------------------------------------------------------------------------------------------------------------
---------S----------------------###-----------tt---------------------------tt-------------tt--------------------------------------------------------------------------------------------
-M----------------------------------k---------tt-----------------------k---tt----k--------tt---------gg-g-g------------------------------------------g----------------------------------
XXXXXXXXXXXXXXXXXXXXXXXXXXXXXXX--XXXXXXXXXXXXXXXXXXXXXXXXXXXXXXXXXXXXXXXXXXXXXXXXXXXXX--XXXXXXXXXXXXXXXXXXXXXXXXXXXXXXXXXXXXXXXXXXXXXXXXXXXXXXXXXXXXXXXXXXXXXXXXXXXXXXXXXXXXXXXXXXXXXXXX
XXXXXXXXXXXXXXXXXXXXXXXXXXXXXXX--XXXXXXXXXXXXXXXXXXXXXXXXXXXXXXXXXXXXXXXXXXXXXXXXXXXXX--XXXXXXXXXXXXXXXXXXXXXXXXXXXXXXXXXXXXXXXXXXXXXXXXXXXXXXXXXXXXXXXXXXXXXXXXXXXXXXXXXXXXXXXXXXXXXXXX
