----------------------------------------------------------------------------------------------------------------------------------------------------------------------------------------------
----------------------------------------------------------------------------------------------------------------------------------------------------------------------------------------------
----------------------------------------------------------------------------------------------------------------------------------------------------------------------------------------------
----------------------------------------------------------------------------------------------------------------------------------------------------------------------------------------------
----------------------------------------------------------------------------------------------------------------------------------------------------------------------------------------------
----------------------------------------------------------------------------------------------------------------------------------------------------------------------------------------------
-------------------------------------------------------------------!---------!!S------------------------------------------------------------!-------------------------------------------------
--------------------------------------------------##------------------------------------------------------------------------------------------------------------------------------------------
-------------------------------------------------###------------------------------------------------------------------------------------------------------------------------------------------
--------------------1----------------------------###---------------------------------------g----------------------------------------------------------------1-------------------------------1-
------S-----------------------------!---S@---S---###---------------S!S-------SS-------------------------------S---------------!--!-----S----S!S------------------------------------S----------
-------------------------------------------------###-------------------------------------S@S--------------------------------------------------------------------------------------------------
-------------------------------------------------###------------------------------------------------------S----------tt-----------------------------------------tt----------------------------
-M------------k--------------------------g-----------k------------------gg-g-g---------------------------------------tt-----------k-----------------------------tt----------------------------
XXXXXXXXXXXXXXXXXXXXXXXXXXXXXXXXXXXXXXXXXXXXXXXXXXXXXXXXXXXXXXXXX--XXXXXXXXXXXXXXXXXXXXXXXXXXXXXXX--XXXXXXXXXXXXXXXXXXXXXXXXXXXXXXXXXXXXXXXXXXXXXXXXXXXXXXXXXXXXXXXXXXXXXXXXXXXXXXXXXXXXXXXXXX
XXXXXXXXXXXXXXXXXXXXXXXXXXXXXXXXXXXXXXXXXXXXXXXXXXXXXXXXXXXXXXXXX--XXXXXXXXXXXXXXXXXXXXXXXXXXXXXXX--XXXXXXXXXXXXXXXXXXXXXXXXXXXXXXXXXXXXXXXXXXXXXXXXXXXXXXXXXXXXXXXXXXXXXXXXXXXXXXXXXXXXXXXXXX
