----------------------------------------------------------------------------------------------------------------------------------------------------------------------------------------------
----------------------------------------------------------------------------------------------------------------------------------------------------------------------------------------------
----------------------------------------------------------------------------------------------------------------------------------------------------------------------------------------------
----------------------------------------------------------------------------------------------------------------------------------------------------------------------------------------------
----------------------------------------------------------------------------------------------------------------------------------------------------------------------------------------------
-------------------------------------------------------------------------------------------------------!!S---------!--------------------------------------------------------------------------
------------------------------------------!---------------------------------------------------------------------------------------------------------------------------------------------------
-----------------------------------------------------------------------------------------------------------------------------------------------------------------#----------------------------
-----------------------------------------------------------------------------------------#------------#--------------------1-----------1------------------------##----------@-----------------
----------------------------------------------------------------------------------------##-----------##SS----------S!S-------!---S@----------------------------####--#------------------------
------------------------------------!---S@S!S------------------------------------------###----------###----------S@-------------------------------------------#####--##-----------------------
--------------------------------------------------------------------------------------####---------####--------------------------------------------------tt--######--###-###------------------
----------tt--------tt----------------------------------------------tt-----------tt--#####----tt--#####g--------------------------g-------------gg-g-----tt--######--#######------------------
-M--------tt--------tt-------------------g--------------------------tt--gg-g-----tt--#####----tt--#####XXXXXXXXXXXXXXXXXXXXXXXXXXXXXXXXXXXXXXXXXXXXXXXXXXXXXXXXXXXX--XXXXXXXXXXXXXXXXXXXXXXXXX
XXXXXX--XXXXXXXX--XXXXXXXXXXXXXXXXXXXXXXXXXXXXXXXXXXXXXXXXXXXXXXXXXXXXXXXXXXXXXXXXXXXXXXXXXXXXXXXXXXXXXXXXXXXXXXXXXXXXXXXXXXXXXXXXXXXXXXXXXXXXXXXXXXXXXXXXXXXXXXXXX--XXXXXXXXXXXXXXXXXXXXXXXXX
XXXXXX--XXXXXXXX--XXXXXXXXXXXXXXXXXXXXXXXXXXXXXXXXXXXXXXXXXXXXXXXXXXXXXXXXXXXXXXXXXXXXXXXXXXXXXXXXXXXXX---------------------------------------------------------------------------------------
