------------------------------------------------------------------------------------------------------------------------------------------------------------------------------------------
------------------------------------------------------------------------------------------------------------------------------------------------------------------------------------------
------------------------------------------------------------------------------------------------------------------------------------------------------------------------------------------
------------------------------------------------------------------------------------------------------------------------------------------------------------------------------------------
------------------------------------------------------------------------------------------------------------------------------------------------------------------------------------------
------------------------------------------------------------------------------------------------------------------------------------------------------------------------------------------
------------------------------------------------------------------------------------------------------------------------------------------------------!--------!--------------------------
----------------------------------------------------------------------------------------------------------##------------------------------------------------------------------------------
---------------------------------------------------------------------------------------------------------###---------------------------------#--------------------------------------------
--------------------------------------------g-------------1----------------------------------------------###--------------------------------##----------------------------------!---------
----------!---S@--------@-----S-----------------!---S@--------------!---S@-------!---S@--------!---S@----###--------------#--#-------------###--------S!S------S!S---!--------------------
------------------------------------------S@S------------------------------------------------------------###--------------#--##-----------####--------------------------------------------
---------------------------------------------------------------------------------------------------------###-----tt-------#--###-----tt--########-----------tt----------------------------
-M-------------g---------k---------------------------g-------------------g------------g-------------g--------k---tt--gg-g-#--####----tt--########-----------tt--------k-------------------
XXXXXXXXXXXXXXXXXXXXXXXXXXXXXXXXXXXXXXXXXXXXXXXXXXXXXXXXXXXXXXXXXXXXXXXXXXXXXXXXXXXXXXXXXXXXXXXXXXXXXXXX--XXXXXXXXXXXXXXXXX--XXXXXXXXXXXXXXXXXXXXXXXXXXXXXXXXXXXXXXXXXXXXXXXXXXXXXXXXX---X
XXXXXXXXXXXXXXXXXXXXXXXXXXXXXXXXXXXXXXXXXXXXXXXXXXXXXXXXXXXXXXXXXXXXXXXXXXXXXXXXXXXXXXXXXXXXXXXXXXXXXXXX--XXXXXXXXXXXXXXXXX--XXXXXXXXXXXXXXXXXXXXXXXXXXXXXXXXXXXXXXXXXXXXXXXXXXXXXXXXX---X
