----------------------------------------------------------------------------------------------------------------------------------------------------------------------------------------------------------
----------------------------------------------------------------------------------------------------------------------------------------------------------------------------------------------------------
----------------------------------------------------------------------------------------------------------------------------------------------------------------------------------------------------------
----------------------------------------------------------------------------------------------------------------------------------------------------------------------------------------------------------
----------------------------------------------------------------------------------------------------------------------------------------------------------------------------------------------------------
----------------------------------------------------------------------------------------------------------------------------------------------------------------------------------------------------------
--------------------------------------------------------------------------------------------------------##-----------------!!S--!-------------------------------------------------------------------------
-------------------------------------------------------------------------------------------------------###------------------------------------------------------------------------------------------------
------------------------------------------------------------------------------------------------------#-------------------#-------------------------------------------------------------------------------
-----------------------------------------------------------------------------------------------------##------------------##-------------------------------------------!--!-------------1------------------
--------------------S----!---S@-----------------------------------------S---------------------------####--#-------------###SS---S!S-------#--#----------g-------------------------------------------------
---------------------------------------------------------------------------------------------------#####--##-----------####---------------#--##-------SSS-------------------------------------------------
---------###------------------------------------------------------tt--------------------------tt--######--###-----tt--#####---------------#--###-###------------------###---------------------------------
-M--gg-g-###------------------g-----------------------------------tt-----------------gg-g-----tt--######--####----tt--#####g---------gg-g-#--#######-------------gg-g-###---------------------------------
XXXXXXXXXXXXXXXXXXXXXXXXXXXXXXXXXXXXXXXXXXXXXXXXXXXXXXXXXXXXXX--XXXXXXXXXXXXXXXXXXXXXXXXXXXXXXXXXXXXXXXX--XXXXXXXXXXXXXXXXXXXXXXXXXXXXXXXXX--XXXXXXXXXXXXXXXXXXXXXXXXXXXXXXXXXXXX--XXXXXXXXXXXXXXXXXXX---X
XXXXXXXXXXXXXXXXXXXXXXXXXXXXXXXXXXXXXXXXXXXXXXXXXXXXXXXXXXXXXX--XXXXXXXXXXXXXXXXXXXXXXXXXXXXXXXXXXXXXXXX--XXXXXXXXXXXXXXXXXXXXXXXXXXXXXXXXX--XXXXXXXXXXXXXXXXXXXXXXXXXXXXXXXXXXXX--XXXXXXXXXXXXXXXXXXX---X
