----------------------------------------------------------------------------------------------------------------------------------------------------------------------------------------------------------
----------------------------------------------------------------------------------------------------------------------------------------------------------------------------------------------------------
----------------------------------------------------------------------------------------------------------------------------------------------------------------------------------------------------------
----------------------------------------------------------------------------------------------------------------------------------------------------------------------------------------------------------
----------------------------------------------------------------------------------------------------------------------------------------------------------------------------------------------------------
----------------------------------------------------------------------------------------------------------------------------------------------------------------------------------------------------------
---------------##-----------------------------------------------------------------------------------------------------------------------------------------------------------------------------------------
--------------###-----------------------------------------------------------------------------------------------------------------------------------------------------------------------------------------
-------------####-----------------------------------------------------------------------------------------------------------------------------------------------------------------------------------------
------------#####----------------------------------------------------------------------------SS!S------------------------------------------------------------------------------------------------------SS!
--------SU--#####----##--#------------------------#-----------##--#---------------SU---------------#-------------##--#---SU--------------#----------SS!S------------#-------------------------------------
------------#####---###--##----------------------##----------###--##-------------------------------##-----------###--#------------------##-------------------------##-------------------------------------
------------#####--####--###--------#####----tt-###---------####--###-----------------#####--####--###---------####--#--------------tt-###---------------------tt-###---------------------------#####-----
-M-#----tt--#####--####--###--------#####----tt#####----tt--####--###--------#----tt--#####--####--####----tt--####--###-------gg---tt#####----tt---------gg---tt####-------gg-#----tt----------#####-----
XXXXXXXXXXXXXXXXXXXXXXX--XXXX--XXXXXXXXXXXXXXXXXXXXXXXXXXXXXXXXX--XXXX--XXXXXXXXXXXXXXXXXXXXXXXXX--XXXXXXXXXXXXXXXX--XXXXXXXXXXXXXXXXXXXXXXXXXXXXXXXXXXXXXXXXXXXXXXXXXXXXXXXXXXXXXXXXXXXX--XXXXXXXXXXXXX--
XXXXXXXXXXXXXXXXXXXXXXX--XXXX--XXXXXXXXXXXXXXXXXXXXXXXXXXXXXXXXX--XXXX--XXXXXXXXXXXXXXXXXXXXXXXXX--XXXXXXXXXXXXXXXX--XXXXXXXXXXXXXXXXXXXXXXXXXXXXXXXXXXXXXXXXXXXXXXXXXXXXXXXXXXXXXXXXXXXX--XXXXXXXXXXXXX--
