----------------------------------------------------------------------------------------------------------------------------------------------------------------------------------------------------------
----------------------------------------------------------------------------------------------------------------------------------------------------------------------------------------------------------
----------------------------------------------------------------------------------------------------------------------------------------------------------------------------------------------------------
----------------------------------------------------------------------------------------------------------------------------------------------------------------------------------------------------------
----------------------------------------------------------------------------------------------------------------------------------------------------------------------------------------------------------
----------------------------------------------------------------------------------------------------------------------------------------------------------------------------------------------------------
--------------##-----------------------------------------------------------------------------------------##---------------##------------------------------------------------------------------------------
-------------###----------------------------------------------------------------------------------------###--------------###------------------------------------------------------------------------------
------------####---------------------------------------------------------------------------------------####-------------####-------------------SS!S-------------------------------------------------------
-----------#####--------------------------------------------------------------------------------------#####--------#---#####-----------------------------------------SU---------##--#---SS!S------------#-
----------######-----SS!S----------SU---SU-----------------##--#-------------##--#-------------------######-------##---#####---------------#-----------------------------------###--#------------------##-
---------#######------------------------------------------###--##-----------###--##-----------------#######---tt-###---#####-----------tt-########------------tt-#------------####--#--------------tt-####
-----tt-###----------------------------------------------####--###---------####--###------------tt-#----tt----tt#####----tt------------tt#########------------tt####-------gg-####--###-------gg---tt#####
-M---tt#####----tt---------gg-#----tt---------gg---------####--####----tt--####--###-------gg---tt#XXXXXXXXXXXXXXXXXXXXXXXXXXX--XXXXXXXXXXXXXXXXXXXXX--XXXXXXXXXXXXXXXXXXXXXXXXXXX--XXXXXXXXXXXXXXXXXXXXXX
XXXXXXXXXXXXXXXXXXXXXXXXXXXXXXXXXXXXXXXXXXXXXXXXXX--XXXXXXXXX--XXXXXXXXXXXXXXXX--XXXXXXXXXXXXXXXXXXXXXXXXXXXXXXXXXXXXXXXXXXXXX--XXXXXXXXXXXXXXXXXXXXX--XXXXXXXXXXXXXXXXXXXXXXXXXXX--XXXXXXXXXXXXXXXXXXXXXX
XXXXXXXXXXXXXXXXXXXXXXXXXXXXXXXXXXXXXXXXXXXXXXXXXX--XXXXXXXXX--XXXXXXXXXXXXXXXX--XXXXXXXXXXXXXXXXXXXXX----------------------------------------------------------------------------------------------------
