----------------------------------------------------------------------------------------------------------------------------------------------------------------------------------------------------------
----------------------------------------------------------------------------------------------------------------------------------------------------------------------------------------------------------
----------------------------------------------------------------------------------------------------------------------------------------------------------------------------------------------------------
----------------------------------------------------------------------------------------------------------------------------------------------------------------------------------------------------------
----------------------------------------------------------------------------------------------------------------------------------------------------------------------------------------------------------
---------------------------------------------------------------------------------------------------------------------------##-----------------------------------------------------------------------------
----------------##--------------------------------------------------------------------------------------------------------###-----------------------------------------------------------------------------
---------------###-------------------------------------------------------------------------------------------------------####-----------------------------------------------------------------------------
--------------####------------------------------------------------------------------------------------------------------#####-----------------------------------------------------------------------------
----------SS!#####--------##--#-------SU----------------------------SU---------##--#---SS!S--------------##--#----------#####--------------##--#-------------##--#----------------------------SS!S--------
-------------#####-------###--##----------------------------------------------###--#--------------------###--##---------#####-------------###--##-----------###--##---------------------------------------
-------------#####------####--###----------------------------tt-#------------####--#------------#####--####--###--------#####------------####--###---------####--###---------#####---------------------###
---###----tt---------gg-####--####----tt----------#----tt----tt####-------gg-####--###-------gg-#####--####--###--------#####---------gg-####--####----tt--####--####----tt--#####--#----tt---------gg-###
-M-##XXXXXXXXXXXXXXXXXXXXXXX--XXXXXXXXXXXXX--XXXXXXXXXXXXXXXXXXXXXXXXXXXXXXXXXXXX--XXXXXXXXXXXXXXXXXXXXXXXX--XXXX--XXXXXXXXXXXXXXXXXXXXXXXXXX--XXXXXXXXXXXXXXXX--XXXXXXXXXXXXXXXXXXXXXXXXXXXXXXXXXXXXXXXXX
XXXXXXXXXXXXXXXXXXXXXXXXXXXX--XXXXXXXXXXXXX--XXXXXXXXXXXXXXXXXXXXXXXXXXXXXXXXXXXX--XXXXXXXXXXXXXXXXXXXXXXXX--XXXX--XXXXXXXXXXXXXXXXXXXXXXXXXX--XXXXXXXXXXXXXXXX--XXXXXXXXXXXXXXXXXXXXXXXXXXXXXXXXXXXXXXXXX
XXXXXXXXXX------------------------------------------------------------------------------------------------------------------------------------------------------------------------------------------------
