----------------------------------------------------------------------------------------------------------------------------------------------------------------------------------------------------------
----------------------------------------------------------------------------------------------------------------------------------------------------------------------------------------------------------
----------------------------------------------------------------------------------------------------------------------------------------------------------------------------------------------------------
----------------------------------------------------------------------------------------------------------------------------------------------------------------------------------------------------------
----------------------------------------------------------------------------------------------------------------------------------------------------------------------------------------------------------
--------------------------------------------------------------------------------##------------------------------------------------------------------------------------------------------------------------
---------------------------------------------------------------------##--------###--------------------------------------##--------------------------------------------------------------------------------
-----##-------------------------------------------------------------###-------####-------------------------------------###--------------------------------------------------------------------------------
----###------------------------------------------------------------####------#####------------------------------------####--------------------------------------------------------------------------------
---####-----------------------------------------------------------#####------#####------------##--#------------##--#-#####------------------------SS!S--------------##--#-------------------------------##
--#####-----------SU---SS!S---------------------#--##--#---------######------#####-----------###--##----------###--#######-----------------------------------------###--##-----------------------------###
--#####----------------------------------------##-###--##-------#######------#####----------####--###--------####--#######---------------------------------#####--####--###---------------------------####
--#####------------------------------------tt-#######--###--tt-###--------gg-#####----------####--###--------####--###-------gg---------#----tt---------gg-#####--####--###---------------gg-#----tt--####
-M--------gg-#----tt---------gg-#----tt----tt########--###--tt####-XXXXXXXXXXXXXXXXXX--XXXXXXXXX--XXXX--XXXXXXXXX--XXXXXXXXXXXXXX--XXXXXXXXXXXXXXXXXXXXXXXXXXXXXXXXXXX--XXXX--XXXXXXXXXXXXXXXXXXXXXXXXXXXX
XXXXXXXXXXXXXXXXXXXXXXXXXXXXXXXXXXXXXXXXXXXXXXXXXXXXX--XXXXXXXXXXX-XXXXXXXXXXXXXXXXXX--XXXXXXXXX--XXXX--XXXXXXXXX--XXXXXXXXXXXXXX--XXXXXXXXXXXXXXXXXXXXXXXXXXXXXXXXXXX--XXXX--XXXXXXXXXXXXXXXXXXXXXXXXXXXX
XXXXXXXXXXXXXXXXXXXXXXXXXXXXXXXXXXXXXXXXXXXXXXXXXXXXX--XXXXXXXXXXX----------------------------------------------------------------------------------------------------------------------------------------
