----------------------------------------------------------------------------------------------------------------------------------------------------------------------------------------------------------
----------------------------------------------------------------------------------------------------------------------------------------------------------------------------------------------------------
----------------------------------------------------------------------------------------------------------------------------------------------------------------------------------------------------------
----------------------------------------------------------------------------------------------------------------------------------------------------------------------------------------------------------
----------------------------------------------------------------------------------------------------------------------------------------------------------------------------------------------------------
----------------------------------------------------------------------------------------------------------------------------------------------------------------------------------------------------------
------------------------------------------------------------------------------------------#---------------------------------------------------------------------------------------------------------------
-----------------------------------------------------------------------------------------##---------------------------------------------------------------------------------------------------------------
----------------------------------------------------------------------------------------###---------------------------------------------------------------------------------------------------------------
---------------------------------------------------------------------------------------####---SU-----------------##--#---------#-------------------------------------------------------------------#--##--
----SU---------##--#--------------------------#--------------#------------------------#####---------------------###--##-------##------------------------------------------------------------------##-###--
--------------###--##------------------------##-------------##-----------------------######--------------------####--###--tt-########------------------------------------------------#####----tt-#######--
-------------####--###-------------------tt-########----tt-###-------------------tt-#----tt---------gg---------####--###--tt#########--#----tt---------gg-#----tt-----------------gg-#####----tt########--
-M--------gg-####--###--------#----tt----tt#########----tt####--------#----tt----tt#XXXXXXXXXXXXXXXXXXXX--XXXXXXXXX--XXXXXXXXXXXXXXXXXXXXXXXXXXXXXXXXXXXXXXXXXXXXXXX--XXXXXXXXXXXXXXXXXXXXXXXXXXXXXXXXXX--
XXXXXXXXXXXXXXXXX--XXXX--XXXXXXXXXXXXXXXXXXXXXXXXXXXXXXXXXXXXXX--XXXXXXXXXXXXXXXXXXXXXXXXXXXXXXXXXXXXXXX--XXXXXXXXX--XXXXXXXXXXXXXXXXXXXXXXXXXXXXXXXXXXXXXXXXXXXXXXX--XXXXXXXXXXXXXXXXXXXXXXXXXXXXXXXXXX--
XXXXXXXXXXXXXXXXX--XXXX--XXXXXXXXXXXXXXXXXXXXXXXXXXXXXXXXXXXXXX--XXXXXXXXXXXXXXXXXXXXXX-------------------------------------------------------------------------------------------------------------------
