----------------------------------------------------------------------------------------------------------------------------------------------------------------------------------------------------------
----------------------------------------------------------------------------------------------------------------------------------------------------------------------------------------------------------
----------------------------------------------------------------------------------------------------------------------------------------------------------------------------------------------------------
----------------------------------------------------------------------------------------------------------------------------------------------------------------------------------------------------------
----------------------------------------------------------------------------------------------------------------------------------------------------------------------------------------------------------
----------------------------------------------------------------------------------------------------------------------------------------------------------------------------------------------------------
---------------------##-----------------------##-----------------------------------------------------------------##---------------------------------------------------------------------------------------
--------------------###----------------------###----------------------------------------------------------------###---------------------------------------------------------------------------------------
-------------------####---------------------####---------------------------------------------------------------####---------------------------------------------------------------------------------------
------------------#####--------------------#####--------------------------------------------------------------#####-------------------------------SU------------------------------------------------------
-----------------######-------------------######----------------------------------#------SS!S-----SU----------#####-------SS!S---------------------------##--#-------------##--#--------------------------
----------------#######------------------#######---------------------------------##---------------------------#####-------------------------------------###--##-----------###--##------------------------#
---#####----tt-###-------------------tt-########-----------------------------tt-###---------------------------#####-----------------------------#####--####--###---------####--###----------#####----tt-##
-M-#####----tt#####----tt------------tt#########----------#----tt------------tt####-------gg-#----tt----------#####--#----tt-----------------gg-#####--####--####----tt--####--###-------gg-#####----tt###
XXXXXXXXXXXXXXXXXXXXXXXXXXXXX-XXXXXXXXXXXXXXXXXXXXX--XXXXXXXXXXXXXXX--XXXXXXXXXXXXXXXXXXXXXXXXXXXXXXXXX--XXXXXXXXXXXXXXXXXXXXXX--XXXXXXXXXXXXXXXXXXXXXXXXXX--XXXXXXXXXXXXXXXX--XXXXXXXXXXXXXXXXXXXXXXXXXXX
XXXXXXXXXXXXXXXXXXXXXXXXXXXXX-XXXXXXXXXXXXXXXXXXXXX--XXXXXXXXXXXXXXX--XXXXXXXXXXXXXXXXXXXXXXXXXXXXXXXXX--XXXXXXXXXXXXXXXXXXXXXX--XXXXXXXXXXXXXXXXXXXXXXXXXX--XXXXXXXXXXXXXXXX--XXXXXXXXXXXXXXXXXXXXXXXXXXX
