----------------------------------------------------------------------------------------------------------------------------------------------------------------------------------------------------------
----------------------------------------------------------------------------------------------------------------------------------------------------------------------------------------------------------
----------------------------------------------------------------------------------------------------------------------------------------------------------------------------------------------------------
----------------------------------------------------------------------------------------------------------------------------------------------------------------------------------------------------------
----------------------------------------------------------------------------------------------------------------------------------------------------------------------------------------------------------
----------------------------------------------------------------------------------------------------------------------------------------------------------------------------------------------------------
------------------------------------------------------------------------------------------------------------------------##--------------------------------------------------------------------------------
-----------------------------------------------------------------------------------------------------------------------###--------------------------------------------------------------------------------
----------------------------------------------------------------------------------------------------------------------####--------------------------------------------------------------------------------
----------------------------------------------------------------------------------------------------------------------------------------------------------------------------------------------------------
--------------##--#-----------------------##--#-------------------SS!S----------------##--#---------#---------------#-----------------##--#---------#---------##--#--------------------SU-----------------
-------------###--##---------------------###--##-------------------------------------###--##-------##--------------##----------------###--##-------##--------###--##--------------------------------------
------------####--###-------------------####--###---------#####---------------------####--###--tt-###----------tt-###--------#####--####--###--tt-########--####--###---------------------------#####----t
-M-#----tt--####--###-------gg-#----tt--####--####----tt--#####---------gg-#----tt--####--###--tt####----------tt####--------#####--####--###--tt#########--####--###--------#----tt---------gg-#####----t
XXXXXXXXXXXXXXXX--XXXXXXXXXXXXXXXXXXXXXXXXXX--XXXXXXXXXXXXXXXXXXXXXXXXXXXXXXXXXXXXXXXXXX--XXXXXXXXXXXX--XXXXXXXXXXXXXX--XXXXXXXXXXXXXXXX--XXXXXXXXXXXXXXXXXXXXXX--XXXX--XXXXXXXXXXXXXXXXXXXXXXXXXXXXXXXXXX
XXXXXXXXXXXXXXXX--XXXXXXXXXXXXXXXXXXXXXXXXXX--XXXXXXXXXXXXXXXXXXXXXXXXXXXXXXXXXXXXXXXXXX--XXXXXXXXXXXX--XXXXXXXXXXXXXX--XXXXXXXXXXXXXXXX--XXXXXXXXXXXXXXXXXXXXXX--XXXX--XXXXXXXXXXXXXXXXXXXXXXXXXXXXXXXXXX
