----------------------------------------------------------------------------------------------------------------------------------------------------------------------------------------------------------
----------------------------------------------------------------------------------------------------------------------------------------------------------------------------------------------------------
----------------------------------------------------------------------------------------------------------------------------------------------------------------------------------------------------------
----------------------------------------------------------------------------------------------------------------------------------------------------------------------------------------------------------
----------------------------------------------------------------------------------------------------------------------------------------------------------------------------------------------------------
----------------------------------------------------------------------------------------------------------------------------------------------------------------------------------------------------------
--------------##-----------------------------------------------------------------------------------------------------------------------------------------------------------------##-----------------------
-------------###----------------------------------------------------------------------------------------------------------------------------------------------------------------###-----------------------
------------####---------------------------------------------------------------------------------------------------------------------------------------------------------------####-----------------------
-----------#####--------------------------------------------SS!S--------------------------------------------------------------------------------------------------------------#####-----------------------
----------#--##--#----------------------------------------------------------------------------------------------#------------##--#-------------------------------------------######------##--#------------
---------##-###--##--------------------------------------------------------------------------------------------##-----------###--##-----------------------------------------#######-----###--##-----------
-----tt-#######--###--------#####--------------------##########---------------------------#####------------tt-###----------####--########-------------------------------tt-###---------####--########-----
-M---tt########--###--------#####---------gg---------##########----------#----tt----------#####------------tt####-------gg-####--########--#----tt-----------------gg---tt#####----tt--####--########--#--
XXXXXXXXXXXXXXX--XXXX--XXXXXXXXXXXXXXXXXXXXXXX--XXXXXXXXXXXXXXXXXX--XXXXXXXXXXXXXXX--XXXXXXXXXXXXX--XXXXXXXXXXXXXXXXXXXXXXXXXXX--XXXXXXXXXXXXXXXXXXXX--XXXXXXXXXXXXXXXXXXXXXXXXXXXXXXXXXXXX--XXXXXXXXXXXXX
XXXXXXXXXXXXXXX--XXXX--XXXXXXXXXXXXXXXXXXXXXXX--XXXXXXXXXXXXXXXXXX--XXXXXXXXXXXXXXX--XXXXXXXXXXXXX--XXXXXXXXXXXXXXXXXXXXXXXXXXX--XXXXXXXXXXXXXXXXXXXX--XXXXXXXXXXXXXXXXXXXXXXXXXXXXXXXXXXXX--XXXXXXXXXXXXX
