----------------------------------------------------------------------------------------------------------------------------------------------------------------------------------------------------------
----------------------------------------------------------------------------------------------------------------------------------------------------------------------------------------------------------
----------------------------------------------------------------------------------------------------------------------------------------------------------------------------------------------------------
----------------------------------------------------------------------------------------------------------------------------------------------------------------------------------------------------------
----------------------------------------------------------------------------------------------------------------------------------------------------------------------------------------------------------
----------------------------------------------------------------------------------------------------------------------------------------------------------------------------------------------------------
-------------------------------------------------------------------------------------------------------------------------------------------------------------------##-----------------------------------##
---------------------------------------------------##---##--------------------------------------------------------------------------------------------------------###----------------------------------###
--------------------------------------------------###--###-------------------------------------------------------------------------------------------------------####---------------------------------####
-------------SS!S--------------------------------####-####------------------------------------------------------------------------------------------------------#####--------------------------------#####
--------------------##--#-----------SU----------##########--------##--#-------SU-------------------##--#--------------##--#---SS!S-------##--#-----------------#--##--#-----------SU-----------------#####
-------------------###--##----------------------##########-------###--##--------------------------###--##------------###--#-------------###--##---------------##-###--##-----------------------------#####
-----------#####--####--###--tt-#---------------##########------####--###---------#####----------####--###----------####--#------------####--###----------tt-#######--###--tt-#---------------------------
-M---------#####--####--###--tt####-------gg-#----tt---------gg-####--####----tt--#####----------####--###-------gg-####--###-------gg-####--###----------tt########--###--tt####-------gg---------#----tt
XXXX--XXXXXXXXXXXXXXXX--XXXXXXXXXXXXXXXXXXXXXXXXXXXXXXXXXXXXXXXXXXXX--XXXXXXXXXXXXXXXXXXXX--XXXXXXXXX--XXXXXXXXXXXXXXXXX--XXXXXXXXXXXXXXXXX--XXXX--XXXXXXXXXXXXXXXXX--XXXXXXXXXXXXXXXXXXXXXX--XXXXXXXXXXXX
XXXX--XXXXXXXXXXXXXXXX--XXXXXXXXXXXXXXXXXXXXXXXXXXXXXXXXXXXXXXXXXXXX--XXXXXXXXXXXXXXXXXXXX--XXXXXXXXX--XXXXXXXXXXXXXXXXX--XXXXXXXXXXXXXXXXX--XXXX--XXXXXXXXXXXXXXXXX--XXXXXXXXXXXXXXXXXXXXXX--XXXXXXXXXXXX
