----------------------------------------------------------------------------------------------------------------------------------------------------------------------------------------------------------
----------------------------------------------------------------------------------------------------------------------------------------------------------------------------------------------------------
----------------------------------------------------------------------------------------------------------------------------------------------------------------------------------------------------------
----------------------------------------------------------------------------------------------------------------------------------------------------------------------------------------------------------
----------------------------------------------------------------------------------------------------------------------------------------------------------------------------------------------------------
--------------------------------------------------------------------------------------------------------------------------------------------------------------------------##------------------------------
------------------------------------------------------------------------------------------------------------------------------------------------------------##-----------###------------------------------
-----------------------------------------------------------------------------------------------------------------------------------------------------------###----------####------------------------------
----------------------------------------------------------------------------------------------------------------------------------------------------------####---------#####------------------------------
---------------------------------------------------------------------------------------------------------------------------------------------------------#####--------######---------#------SS!S----------
------------------#--##--#---------#----------------SU-----------------SS!S------------------#-----------------------------------------#----------------######-------#######--------##--------------------
-----------------##-###--##-------##--------------------------------------------------------##----------------------------------------##---------------#######---tt-########----tt-###--------------------
-------------tt-#######--###--tt-###--------#####---------------------#####-------------tt-########-------------------------------tt-###-----------tt-#----tt----tt#########----tt####-------gg-----------
-M-----------tt########--###--tt####--------#####---------gg-#----tt--#####--#----tt----tt#########--#----tt-----------------gg---tt#####----tt----tt#XXXXXXXXXXXXXXXXXXXXXXXXXXXXXXXXXXXXXXXXXXX--XXXXXXX
XXXX--XXXXXXXXXXXXXXXXX--XXXXXXXXXXXX--XXXXXXXXXXXXXXXXXXXXXXXXXXXXXXXXXXXXXXXXXXXXXXXXXXXXXXXXXXXXXXXXXXXXXXXX--XXXXXXXXXXXXXXXXXXXXXXXXXXXXXXXXXXXXXXXXXXXXXXXXXXXXXXXXXXXXXXXXXXXXXXXXXXXXXXXX--XXXXXXX
XXXX--XXXXXXXXXXXXXXXXX--XXXXXXXXXXXX--XXXXXXXXXXXXXXXXXXXXXXXXXXXXXXXXXXXXXXXXXXXXXXXXXXXXXXXXXXXXXXXXXXXXXXXX--XXXXXXXXXXXXXXXXXXXXXXXXXXXXXXXXXXXXXXXX-------------------------------------------------
