----------------------------------------------------------------------------------------------------------------------------------------------------------------------------------------------------------
----------------------------------------------------------------------------------------------------------------------------------------------------------------------------------------------------------
----------------------------------------------------------------------------------------------------------------------------------------------------------------------------------------------------------
----------------------------------------------------------------------------------------------------------------------------------------------------------------------------------------------------------
----------------------------------------------------------------------------------------------------------------------------------------------------------------------------------------------------------
------------------------------------------------------------------------------------------------------------------------------------------------------------------------------------------##--------------
------------------------------------------##---------------------------------------------------------##-------------##--------------------------##---------------------------------------###--------------
-----------------------------------------###--------------------------------------------------------###------------###-------------------------###--------------------------------------####--------------
----------------------------------------####-------------------------------------------------------####-----------####------------------------####-------------------------------------#####--------------
---------------------------------------#####------------------------------------------------------#####----------#####--------##--#-------SS!#####---------------##--#-----------------#####---------#--##
-------------SS!S---------------------######------------##--#-----------------#------------##--#--#####---------######-------###--##---------#####--------------###--##----------------#####--------##-###
-------------------------------------#######-----------###--##---------------##-----------###--##-#####--------#######------####--###--------#####------#####--####--########----------#####----tt-#######
---------------------------------tt-########----------####--###----------tt-###----------####--########----tt-###--------gg-####--####----tt---------gg-#####--####--########----------#####----tt########
-M-#----tt---------gg-#----tt----tt#########----------####--###----------tt####-------gg-####--########----tt####-XXXXXXXXXXXXXX--XXXXXXXXXXXXXXXXXXXXXXXXXXXXXXXXX--XXXXXXXXXXX--XXXXXXXXXXXXXXXXXXXXXXXX
XXXXXXXXXXXXXXXXXXXXXXXXXXXXXXXXXXXXXXXXXXXXXXX--XXXXXXXXX--XXXX--XXXXXXXXXXXXXXXXXXXXXXXXXXX--XXXXXXXXXXXXXXXXXX-XXXXXXXXXXXXXX--XXXXXXXXXXXXXXXXXXXXXXXXXXXXXXXXX--XXXXXXXXXXX--XXXXXXXXXXXXXXXXXXXXXXXX
XXXXXXXXXXXXXXXXXXXXXXXXXXXXXXXXXXXXXXXXXXXXXXX--XXXXXXXXX--XXXX--XXXXXXXXXXXXXXXXXXXXXXXXXXX--XXXXXXXXXXXXXXXXXX-----------------------------------------------------------------------------------------
