----------------------------------------------------------------------------------------------------------------------------------------------------------------------------------------------------------
----------------------------------------------------------------------------------------------------------------------------------------------------------------------------------------------------------
----------------------------------------------------------------------------------------------------------------------------------------------------------------------------------------------------------
----------------------------------------------------------------------------------------------------------------------------------------------------------------------------------------------------------
----------------------------------------------------------------------------------------------------------------------------------------------------------------------------------------------------------
----------------------------------------------------------------------------------------------------------------------------------------------------------------------------------------------------------
----------------------------------------------------------------------------------------------------------------------------------------------------------------------------------------------------------
----------------------------------------------------------------------------------------------------------------------------------------------------------------------------------------------------------
----------------------------------------------------------------------------------------------------------------------------------------------------------------------------------------------------------
--------------------------------------------------------------------------------------------------------------------------------------------------------------------------SS!S----------------------------
---------------------------#--##--#-----------------#----------##--#---------#-----------------------#--------------#------------------------#-----------------SS!S--------------##--#--------------------
--------------------------##-###--##---------------##---------###--##-------##----------------------##-------------##-----------------------##----------------------------------###--##-------------------
----------------------tt-#######--###----------tt-###--------####--###--tt-########-------------tt-########----tt-###-------------------tt-########---------------------#####--####--###-----------------#
-M---------#----tt----tt########--###----------tt####--------####--###--tt#########--#----tt----tt#########----tt####--------#----tt----tt#########--#----tt---------gg-#####--####--####----tt----------#
XXXX--XXXXXXXXXXXXXXXXXXXXXXXXXX--XXXX--XXXXXXXXXXXXXX--XXXXXXXXX--XXXXXXXXXXXXXXXXXXXXXXXXXXXXXXXXXXXXXXXXXXXXXXXXXXX--XXXXXXXXXXXXXXXXXXXXXXXXXXXXXXXXXXXXXXXXXXXXXXXXXXXXXXXXXXX--XXXXXXXXXXXXX--XXXXXX
XXXX--XXXXXXXXXXXXXXXXXXXXXXXXXX--XXXX--XXXXXXXXXXXXXX--XXXXXXXXX--XXXXXXXXXXXXXXXXXXXXXXXXXXXXXXXXXXXXXXXXXXXXXXXXXXX--XXXXXXXXXXXXXXXXXXXXXXXXXXXXXXXXXXXXXXXXXXXXXXXXXXXXXXXXXXX--XXXXXXXXXXXXX--XXXXXX
