----------------------------------------------------------------------------------------------------------------------------------------------------------------------------------------------------------
----------------------------------------------------------------------------------------------------------------------------------------------------------------------------------------------------------
----------------------------------------------------------------------------------------------------------------------------------------------------------------------------------------------------------
----------------------------------------------------------------------------------------------------------------------------------------------------------------------------------------------------------
----------------------------------------------------------------------------------------------------------------------------------------------------------------------------------------------------------
----------------------------------------------------------------------------------------------------------------------------------------------------------------------------------------------------------
----------------------------------------------------------------------------------------------------------------------------------------------------------------------------------------------------------
------------------------------------------------------------------------------------------------------------------------------------------------##--------------------------------------------------------
-----------------------------------------------------------------------------------------------------------------------------------------------###--------------------------------------------------------
----------------------------------------------------------------------------------------------------------------------------------------------####--------------------------------------------------------
--------------##--#-----------SU--------------#------------##--#---------#-----------------#--------------#----------------------------##--#-#####--------------------#-----------------#--##--#----------
-------------###--##-------------------------##-----------###--##-------##----------------##-------------##---------------------------###--#######-------------------##----------------##-###--##---------
------------####--###--tt-#--------------tt-###----------####--###--tt-###------------tt-########----tt-###--------------------------####--#######------#####----tt-###------------tt-#######--########---
-M-#----tt--####--###--tt####-------gg---tt####-------gg-####--###--tt####-------gg---tt#########----tt####---------------gg---------####--###-------gg-#####----tt####-------gg---tt########--########---
XXXXXXXXXXXXXXXX--XXXXXXXXXXXXXXXXXXXXXXXXXXXXXXXXXXXXXXXXXXX--XXXXXXXXXXXXXXXXXXXXXXXXXXXXXXXXXXXXXXXXXXXXX--XXXXXXXXXXXXXXXX--XXXXXXXXX--XXXXXXXXXXXXXXXXXXXXXXXXXXXXXXXXXXXXXXXXXXXXXXXXXX--XXXXXXXXXXX
XXXXXXXXXXXXXXXX--XXXXXXXXXXXXXXXXXXXXXXXXXXXXXXXXXXXXXXXXXXX--XXXXXXXXXXXXXXXXXXXXXXXXXXXXXXXXXXXXXXXXXXXXX--XXXXXXXXXXXXXXXX--XXXXXXXXX--XXXXXXXXXXXXXXXXXXXXXXXXXXXXXXXXXXXXXXXXXXXXXXXXXX--XXXXXXXXXXX
