----------------------------------------------------------------------------------------------------------------------------------------------------------------------------------------------------------
----------------------------------------------------------------------------------------------------------------------------------------------------------------------------------------------------------
----------------------------------------------------------------------------------------------------------------------------------------------------------------------------------------------------------
----------------------------------------------------------------------------------------------------------------------------------------------------------------------------------------------------------
----------------------------------------------------------------------------------------------------------------------------------------------------------------------------------------------------------
----------------------------------------------------------------------------------------------------------------------------------------------------------------------------------------------------------
---------------------------------------------------------------------------------------------------------------------##---------------------------------------##------------------------------------------
--------------------------------------------------------------------------------------------------------------------###--------#-----------------------------###------------------------------------------
-------------------------------------------------------------------------------------------------------------------####-------##----------------------------####------------------------------------------
----------------------------SU------------------------------------------------------------------------------------#####------###--------------SU-----------#####------------------------------------------
-----------------#----------------------------------------------#--##--#----------------#------------------##--#--#####-----####---SS!S--------------------#####-----------------------------SU-----------
----------------##---------------------------------------------##-###--##--------------##-----------------###--##-#####-----####---------------------------#####------------------------------------------
---#####----tt-###--------#####-----------#####------------tt-#######--########----tt-########-----------####--########-----####------------#####----------#####----------------------------------------tt
-M-#####----tt####--------#####--#----tt--#####------------tt########--########----tt#########--#----tt--####--########--#----tt---------gg-#####----------#####--#----tt----------#----tt---------gg---tt
XXXXXXXXXXXXXXXXXXX--XXXXXXXXXXXXXXXXXXXXXXXXXXXXX--XXXXXXXXXXXXXXXXX--XXXXXXXXXXXXXXXXXXXXXXXXXXXXXXXXXXXXXX--XXXXXXXXXXXXXXXXXXXXXXXXXXXXXXXXXXXXX--XXXXXXXXXXXXXXXXXXXXXX--XXXXXXXXXXXXXXXXXXXXXXXXXXXX
XXXXXXXXXXXXXXXXXXX--XXXXXXXXXXXXXXXXXXXXXXXXXXXXX--XXXXXXXXXXXXXXXXX--XXXXXXXXXXXXXXXXXXXXXXXXXXXXXXXXXXXXXX--XXXXXXXXXXXXXXXXXXXXXXXXXXXXXXXXXXXXX--XXXXXXXXXXXXXXXXXXXXXX--XXXXXXXXXXXXXXXXXXXXXXXXXXXX
