----------------------------------------------------------------------------------------------------------------------------------------------------------------------------------------------------------
----------------------------------------------------------------------------------------------------------------------------------------------------------------------------------------------------------
----------------------------------------------------------------------------------------------------------------------------------------------------------------------------------------------------------
----------------------------------------------------------------------------------------------------------------------------------------------------------------------------------------------------------
----------------------------------------------------------------------------------------------------------------------------------------------------------------------------------------------------------
----------------------------------------------------------------------------------------------------------------------------------------------------------------------------------------------------------
----------------------------------------------------------------------------------------------------------------------------------------------------------------------------------------------------------
--------------------------------------------------------------------------------------------------------------------------------##---------------------------------------------------##-------------------
-------------------------------------------------------------------------------------------------------------------------------###--------------------------------------------------###-------------------
----------------------SS!S-----------------------------------SS!S-------------------------------------------------------------####-------------------------------------------------####-------------------
-------------##--#---------------------------SS!S--------------##--#---------#--------------------------------#--------------#####--------##--#---------------------##--#---------#####-------------------
------------###--##-------------------------------------------###--##-------##-------------------------------##--------------#####-------###--##-------------------###--##-------######-------------------
-----------####--########-----------------------------#####--####--###--tt-###----------#####------------tt-########---------#####------####--###-----------------####--###--tt-#######----------------tt-
-M---------####--########--#----tt-----------------gg-#####--####--###--tt####-------gg-#####------------tt#########-----------------gg-####--####----tt----------####--###--tt####-------gg-----------tt#
XXXX--XXXXXXXXX--XXXXXXXXXXXXXXXXXXXX--XXXXXXXXXXXXXXXXXXXXXXXXXX--XXXXXXXXXXXXXXXXXXXXXXXXXXXXX--XXXXXXXXXXXXXXXXXXXXX--XXXXXXXXXXXXXXXXXXX--XXXXXXXXXXXXX--XXXXXXXXX--XXXXXXXXXXXXXXXXXXXXXX--XXXXXXXXXX
XXXX--XXXXXXXXX--XXXXXXXXXXXXXXXXXXXX--XXXXXXXXXXXXXXXXXXXXXXXXXX--XXXXXXXXXXXXXXXXXXXXXXXXXXXXX--XXXXXXXXXXXXXXXXXXXXX--XXXXXXXXXXXXXXXXXXX--XXXXXXXXXXXXX--XXXXXXXXX--XXXXXXXXXXXXXXXXXXXXXX--XXXXXXXXXX
