----------------------------------------------------------------------------------------------------------------------------------------------------------------------------------------------------------
----------------------------------------------------------------------------------------------------------------------------------------------------------------------------------------------------------
----------------------------------------------------------------------------------------------------------------------------------------------------------------------------------------------------------
----------------------------------------------------------------------------------------------------------------------------------------------------------------------------------------------------------
----------------------------------------------------------------------------------------------------------------------------------------------------------------------------------------------------------
----------------------------------------------------------------------------------------------------------------------------------------------------------------------------------------------------------
--------------------------------------------------------------------------------------------------------------------------------##--------------------------------------##--------------------------------
---------------------------------------------------------------------------------------##--------------------------------------###-------------------------------------###--------------------------------
--------------------------------------------------------------------------------------###-------------------------------------####------------------------------------####--------------------------------
-------------------------------------------------------------------------------------####------------------------------------#####-----------------------------------#####-----------------------SS!S----#
--------SU-----------------------##--#---------------------##--#----------------#---#####-----------##--#---SS!S------------######---------#------------------------######------------------------------##
--------------------------------###--##-------------------###--##--------------##---#####----------###--#------------------#######--------##-----------------------#######------#####-----------#####--###
-------------------------------####--###-----------------####--########----tt-###---#####---------####--#--------------tt-########----tt-###----------#####----tt-###--------gg-#####--#----tt--#####--###
-M-#----tt---------gg-#----tt--####--####----tt----------####--########----tt#####----tt----------####--###-------gg---tt#########----tt####-------gg-#####----tt####-XXXXXXXXXXXXXXXXXXXXXXXXXXXXXXXXXXXX
XXXXXXXXXXXXXXXXXXXXXXXXXXXXXXXXXXX--XXXXXXXXXXXXX--XXXXXXXXX--XXXXXXXXXXXXXXXXXXXXXXXXXXXX--XXXXXXXXX--XXXXXXXXXXXXXXXXXXXXXXXXXXXXXXXXXXXXXXXXXXXXXXXXXXXXXXXXXXXXX-XXXXXXXXXXXXXXXXXXXXXXXXXXXXXXXXXXXX
XXXXXXXXXXXXXXXXXXXXXXXXXXXXXXXXXXX--XXXXXXXXXXXXX--XXXXXXXXX--XXXXXXXXXXXXXXXXXXXXXXXXXXXX--XXXXXXXXX--XXXXXXXXXXXXXXXXXXXXXXXXXXXXXXXXXXXXXXXXXXXXXXXXXXXXXXXXXXXXX-------------------------------------
