----------------------------------------------------------------------------------------------------------------------------------------------------------------------------------------------------------
----------------------------------------------------------------------------------------------------------------------------------------------------------------------------------------------------------
----------------------------------------------------------------------------------------------------------------------------------------------------------------------------------------------------------
----------------------------------------------------------------------------------------------------------------------------------------------------------------------------------------------------------
----------------------------------------------------------------------------------------------------------------------------------------------------------------------------------------------------------
----------------------------------------------------------------------------------------------------------------------------------------------------------------------------------------------------------
----------------------------------------------------------------------------------------------------------------------------------------------##----------------------------------------------------------
----------------------------------------------------##---------------------------------------------------------------------##----------------###----------------------------------------------------------
---------------------------------------------------###--------------------------------------------------------------------###---------------####----------------------------------------------------------
--------------------------------------------------####------------------------------------------------------SS!S---------####--------------#####---------------------#--##--#-----------------------------
---------------##--#---------#---------------#---#####------------------------------------------------------------------#####-------------######--------------------##-###--##----------------------------
--------------###--##-------##--------------##---#####------------------------------------------------------------------#####------------#######----------------tt-#######--########----------#####-------
-------------####--###--tt-###----------tt-###---#####----------------------------#####-------------------#####---------#####--------tt-###--------gg-----------tt########--########----------#####-------
-M--------gg-####--###--tt####----------tt#####----tt----------#----tt---------gg-#####--#----tt----------#####-----------------gg---tt####-XXXXXXXXXXX--XXXXXXXXXXXXXXXXX--XXXXXXXXXXX--XXXXXXXXXXXXXXXXX
XXXXXXXXXXXXXXXXX--XXXXXXXXXXXX--XXXXXXXXXXXXXXXXXXXXXXX--XXXXXXXXXXXXXXXXXXXXXXXXXXXXXXXXXXXXXXXXX--XXXXXXXXXXXXX--XXXXXXXXXXXXXXXXXXXXXXX-XXXXXXXXXXX--XXXXXXXXXXXXXXXXX--XXXXXXXXXXX--XXXXXXXXXXXXXXXXX
XXXXXXXXXXXXXXXXX--XXXXXXXXXXXX--XXXXXXXXXXXXXXXXXXXXXXX--XXXXXXXXXXXXXXXXXXXXXXXXXXXXXXXXXXXXXXXXX--XXXXXXXXXXXXX--XXXXXXXXXXXXXXXXXXXXXXX---------------------------------------------------------------
