----------------------------------------------------------------------------------------------------------------------------------------------------------------------------------------------------------
----------------------------------------------------------------------------------------------------------------------------------------------------------------------------------------------------------
----------------------------------------------------------------------------------------------------------------------------------------------------------------------------------------------------------
----------------------------------------------------------------------------------------------------------------------------------------------------------------------------------------------------------
----------------------------------------------------------------------------------------------------------------------------------------------------------------------------------------------------------
----------------------------------------------------------------------------------------------------------------------------------------------------------------------------------------------------------
-------------------------------##----------------------------------------------------------##-------------------------------------------------------------------------------------------------------------
------------------------------###---------------------------------------------------------###--------------SS!S-------------------------------------------------------------------------------------------
-----------------------------####--------------------------------------------------------####--------SS!-------------------------------------------##--#----------------------##--#-----------------------
----------------------------------------------------------------------------------------#####-----------------------------------------------------###--##--------------------###--##----------------------
----------#--##--#---------#------------------------------------------#--##--#---------######------------#####-------------------#####-----------####--###------------------####--###---------------------
---------##-###--##-------##-----------------------------------------##-###--##-------#######-###----tt--#####--#----tt----------#####--#----tt--####--###---------------gg-####--###-------gg-#----tt----
-----tt-#######--###--tt-###-------------------------------------tt-#######--###--tt-#----tt--##XXXXXXXXXXXXXXXXXXXXXXXXXX--XXXXXXXXXXXXXXXXXXXXXXXXX--XXXX--XXXXXXXXXXXXXXXXXXX--XXXXXXXXXXXXXXXXXXXXXXXX
-M---tt########--###--tt####---------------gg-#----tt------------tt########--###--tt#XXXXXXXXXXXXXXXXXXXXXXXXXXXXXXXXXXXXX--XXXXXXXXXXXXXXXXXXXXXXXXX--XXXX--XXXXXXXXXXXXXXXXXXX--XXXXXXXXXXXXXXXXXXXXXXXX
XXXXXXXXXXXXXXX--XXXXXXXXXXXX--XXXXXXXXXXXXXXXXXXXXXXXXX--XXXXXXXXXXXXXXXXX--XXXXXXXXXXXXXXXXXXXXXXXX-----------------------------------------------------------------------------------------------------
XXXXXXXXXXXXXXX--XXXXXXXXXXXX--XXXXXXXXXXXXXXXXXXXXXXXXX--XXXXXXXXXXXXXXXXX--XXXXXXXXXXX------------------------------------------------------------------------------------------------------------------
