----------------------------------------------------------------------------------------------------------------------------------------------------------------------------------------------------------
----------------------------------------------------------------------------------------------------------------------------------------------------------------------------------------------------------
----------------------------------------------------------------------------------------------------------------------------------------------------------------------------------------------------------
----------------------------------------------------------------------------------------------------------------------------------------------------------------------------------------------------------
----------------------------------------------------------------------------------------------------------------------------------------------------------------------------------------------------------
----------------------------------------------------------------------------------------------------------------------------------------------------------------------------------------------------------
------##---------------------------------------------------------------------------------------------------------------------------------------------##---------------------------------------------------
-----###--------------------------------------------------------------------------------------------------------------------------------------------###---------------------------------------------------
----####-------------------------------------------------------------------------------------------------------------------------------------------####---------------------------------------------------
---#####---------------------------------------------------------------------------------------------------------------------SU-------------------#####---------------------------------------------------
---#####--------SS!S----------##--#----------------#------SS!S--##--#-------------------##--#-------------##--#----------------------------------######------------#-----------------------#--------------
---#####---------------------###--##--------------##------------##--##-----------------###--##-----------###--##--------------------------------#######-----------##----------------------##--------------
---#####--------------------####--########----tt-###------------##--###--------#####--####--###---------####--###----------#####------------tt-###------------tt-###---------#####----tt-###----------tt-#
-M-#####---------gg---------####--########----tt####-------gg-####--###--------#####--####--####----tt--####--###-------gg-#####------------tt####-------gg---tt####-----tt--#####----tt####----------tt##
XXXXXXXXXXXXXXXXXXXXX--XXXXXXXXX--XXXXXXXXXXXXXXXXXXXXXXXXXXXXXXXX--XXXX--XXXXXXXXXXXXXXXX--XXXXXXXXXXXXXXXX--XXXXXXXXXXXXXXXXXXXXX--XXXXXXXXXXXXXXXXXXXXXXXXXXXXXXXXXXXXXXXXXXXXXXXXXXXXXXXX--XXXXXXXXXXX
XXXXXXXXXXXXXXXXXXXXX--XXXXXXXXX--XXXXXXXXXXXXXXXXXXXXXXXXXXXXXXXX--XXXX--XXXXXXXXXXXXXXXX--XXXXXXXXXXXXXXXX--XXXXXXXXXXXXXXXXXXXXX--XXXXXXXXXXXXXXXXXXXXXXXXXXXXXXXXXXXXXXXXXXXXXXXXXXXXXXXX--XXXXXXXXXXX
