----------------------------------------------------------------------------------------------------------------------------------------------------------------------------------------------------------
----------------------------------------------------------------------------------------------------------------------------------------------------------------------------------------------------------
----------------------------------------------------------------------------------------------------------------------------------------------------------------------------------------------------------
----------------------------------------------------------------------------------------------------------------------------------------------------------------------------------------------------------
----------------------------------------------------------------------------------------------------------------------------------------------------------------------------------------------------------
----------------------------------------------------------------------------------------------------------------------------------------------------------------------------------------------------------
-----------------------------------------------------##-------------##------------------------------------------------------------------------------------------------------------------------------------
----------------------------------------------------###------------###------------------------------------------------------------------------------------------------------------------------------------
---------------------------------------------------####-----------####------------------------------------------------------------------------------------------------------------------------------------
--------------------------------------------------#####----------#####------------------------------------------------------------------------------------------------------------------------------------
--------SU-----------------------##--#------------#####----------#####---------#-----------------------SU---------#-------------------------SS!S-------##--#-------------------------------##--#----------
--------------------------------###--##-----------#####----------#####--------##---------------------------------##-----------------------------------###--##-----------------------------###--##---------
-------------------------------####--###----------#####----------#####----tt-###-----------------------------tt-########-----------------------------####--###---------------------------####--###--------
-M-#----tt---------gg-#----tt--####--###-------gg-#####----------#####----tt####---------------gg-#----tt----tt#########--#----tt-----------------gg-####--###--------#----tt---------gg-####--####----tt-
XXXXXXXXXXXXXXXXXXXXXXXXXXXXXXXXXXX--XXXXXXXXXXXXXXXXXXXXX--XXXXXXXXXXXXXXXXXXXXX--XXXXXXXXXXXXXXXXXXXXXXXXXXXXXXXXXXXXXXXXXXXXXXXXX--XXXXXXXXXXXXXXXXXXX--XXXX--XXXXXXXXXXXXXXXXXXXXXXXXXXXX--XXXXXXXXXXX
XXXXXXXXXXXXXXXXXXXXXXXXXXXXXXXXXXX--XXXXXXXXXXXXXXXXXXXXX--XXXXXXXXXXXXXXXXXXXXX--XXXXXXXXXXXXXXXXXXXXXXXXXXXXXXXXXXXXXXXXXXXXXXXXX--XXXXXXXXXXXXXXXXXXX--XXXX--XXXXXXXXXXXXXXXXXXXXXXXXXXXX--XXXXXXXXXXX
