----------------------------------------------------------------------------------------------------------------------------------------------------------------------------------------------------------
----------------------------------------------------------------------------------------------------------------------------------------------------------------------------------------------------------
----------------------------------------------------------------------------------------------------------------------------------------------------------------------------------------------------------
----------------------------------------------------------------------------------------------------------------------------------------------------------------------------------------------------------
----------------------------------------------------------------------------------------------------------------------------------------------------------------------------------------------------------
----------------------------------------------------------------------------------------------------------------------------------------------------------------------------------------------------------
----------------------##-------------------------------------------------------------------------------------------------------------------------------------------------------------------##-------------
---------------------###------------------------------------------------------------------------------------------------------------------------------------------------------------------###-------------
--------------------####-------------------------------------------------------------------------SS!S-----------SU-----------------------------------------------------------------------####--------SS!S-
-------------------#####-----------------------------SS!S-------##--#-------SU----------------------------------------SU---------##--#---------#----------------------------------------#####-------------
------------------######---------------------------------------###--##-----------------------#----------------------------------###--##-------##----------------------------------------#####-------------
-----------------#######--------------------------------------####--###---------#####----tt-########----------#####------------####--###--tt-###-----------------#####------------------#####------#####--
-------------tt-#----tt-----------------gg-#----tt---------gg-####--####----tt--#####----tt#########----------#####---------gg-####--###--tt####--------#----tt--#####--#----tt-----------------gg-#####--
-M-----------tt#XXXXXXXXXX--XXXXXXXXXXXXXXXXXXXXXXXXXXXXXXXXXXXXXX--XXXXXXXXXXXXXXXXXXXXXXXXXXXXXXXXXXX--XXXXXXXXXXXXXXXXXXXXXXXXXX--XXXXXXXXXXXX--XXXXXXXXXXXXXXXXXXXXXXXXXXXXXXX--XXXXXXXXXXXXXXXXXXXXXX
XXXX--XXXXXXXXXXXXXXXXXXXX--XXXXXXXXXXXXXXXXXXXXXXXXXXXXXXXXXXXXXX--XXXXXXXXXXXXXXXXXXXXXXXXXXXXXXXXXXX--XXXXXXXXXXXXXXXXXXXXXXXXXX--XXXXXXXXXXXX--XXXXXXXXXXXXXXXXXXXXXXXXXXXXXXX--XXXXXXXXXXXXXXXXXXXXXX
XXXX--XXXXXXXXXXXXX---------------------------------------------------------------------------------------------------------------------------------------------------------------------------------------
