----------------------------------------------------------------------------------------------------------------------------------------------------------------------------------------------------------
----------------------------------------------------------------------------------------------------------------------------------------------------------------------------------------------------------
----------------------------------------------------------------------------------------------------------------------------------------------------------------------------------------------------------
----------------------------------------------------------------------------------------------------------------------------------------------------------------------------------------------------------
----------------------------------------------------------------------------------------------------------------------------------------------------------------------------------------------------------
----------------------------------------------------------------------------------------------------------------------------------------------------------------------------------------------------------
-----------------------------------------------------------------------------------------------------##-----------------------------------------------------------------##--------------------------------
----------------------------------------------------------------------------------------------------###----------------------------------------------------------------###--------------------------------
---------------------------------------------------------------------------------------------------####---------------------------------------------------------------####--------------------------------
----------------------------------------SU--------------------------------------------------------#####-----------------------SU-------------------------------------#####--------------------------------
----------------SS!S---------SS!S--------------##--#---------------------------#------SS!S-------######--------------##--#-----------##--#--------------------------######---SU------------------##--#----
----------------------------------------------###--##-------------------------##----------------#######-------------###--##---------###--##------------------------#######----------------------###--##---
---#####------------------------------#####--####--###--------------------tt-###------------tt-###-----------------####--########--####--###-------------------tt-########---------------------####--###--
-M-#####---------gg----------------gg-#####--####--###---------------gg---tt####-------gg---tt#####----tt----------####--########--####--####----tt------------tt#########---------gg-#----tt--####--###--
XXXXXXXXXXXXXXXXXXXXX--XXXXXXXXXXXXXXXXXXXXXXXXXX--XXXX--XXXXXXXXXXXXXXXXXXXXXXXXXXXXXXXXXXXXXXXXXXXXXXXXXXX--XXXXXXXXX--XXXXXXXXXXXXXX--XXXXXXXXXXXXX--XXXXXXXXXXXXXXXXXXXXXXXXXXXXXXXXXXXXXXXXXXX--XXXX-
XXXXXXXXXXXXXXXXXXXXX--XXXXXXXXXXXXXXXXXXXXXXXXXX--XXXX--XXXXXXXXXXXXXXXXXXXXXXXXXXXXXXXXXXXXXXXXXXXXXXXXXXX--XXXXXXXXX--XXXXXXXXXXXXXX--XXXXXXXXXXXXX--XXXXXXXXXXXXXXXXXXXXXXXXXXXXXXXXXXXXXXXXXXX--XXXX-
