----------------------------------------------------------------------------------------------------------------------------------------------------------------------------------------------------------
----------------------------------------------------------------------------------------------------------------------------------------------------------------------------------------------------------
----------------------------------------------------------------------------------------------------------------------------------------------------------------------------------------------------------
----------------------------------------------------------------------------------------------------------------------------------------------------------------------------------------------------------
----------------------------------------------------------------------------------------------------------------------------------------------------------------------------------------------------------
----------------------------------------------------------------------------------------------------------------------------------------------------------------------------------------------------------
----------------------------------------------------------------------------##----------------------------------------------------------------------------------------------------------------------------
---------------------------------------------------------------------------###--------------------##------------------------------------------------------------------------------------------------------
--------------------------------------------------------------------------####-------------------###------------------------------------------------------------------------------------------------------
-------------------------------------------------------------------------#####------------------####---------------------SS!S-----------------------------------------------------------------------------
-----------------------------------------##--#---------#--##--#---------######-------##--#-----#####----------SS!S---------------------------#--------------------##--#-----------SU----------------------
----------------------------------------###--##-------##-###--##-------#######------###--##----#####----------------------------------------##-------------------###--##----------------------------------
---------------------------------------####--###--tt-#######--###--tt-###-----------###--###---#####---tt-#------------#####------------tt-###------------------####--###-----------------------------tt-#
-M-#----tt---------gg-#----tt----------####--###--tt########--###--tt####-----------###--####----tt----tt####-------gg-#####------------tt####-------gg---------####--###---------------gg-#----tt----tt##
XXXXXXXXXXXXXXXXXXXXXXXXXXXXXXXX--XXXXXXXXX--XXXXXXXXXXXXXXX--XXXXXXXXXXXXXXXXXXXXXXXXX--XXXXXXXXXXXXXXXXXXXXXXXXXXXXXXXXXXXXXX--XXXXXXXXXXXXXXXXXXXXXXXX--XXXXXXXXX--XXXX--XXXXXXXXXXXXXXXXXXXXXXXXXXXXXX
XXXXXXXXXXXXXXXXXXXXXXXXXXXXXXXX--XXXXXXXXX--XXXXXXXXXXXXXXX--XXXXXXXXXXXXXXXXXXXXXXXXX--XXXXXXXXXXXXXXXXXXXXXXXXXXXXXXXXXXXXXX--XXXXXXXXXXXXXXXXXXXXXXXX--XXXXXXXXX--XXXX--XXXXXXXXXXXXXXXXXXXXXXXXXXXXXX
