----------------------------------------------------------------------------------------------------------------------------------------------------------------------------------------------------------
----------------------------------------------------------------------------------------------------------------------------------------------------------------------------------------------------------
----------------------------------------------------------------------------------------------------------------------------------------------------------------------------------------------------------
----------------------------------------------------------------------------------------------------------------------------------------------------------------------------------------------------------
----------------------------------------------------------------------------------------------------------------------------------------------------------------------------------------------------------
----------------------------------------------------------------------------------------------------------------------------------------------------------------------------------------------------------
----------------------------------------------------------------------------------------------------------------------------------------------------------------------------------------------------------
---------------------------------------------------------------##--------------------------------------------##---##-----------------------##-------------------------------------------------------------
--------------------------------------------------------------###-------------------------------------------###--###----------------------###-------------------------------------------------------------
--------------SU---------------------------------------------####------------------------------------------####-####--------SU-----------####-------------------------------------------------------------
-----------------------------SS!S----##--#------------------#####----------------##--#--------------------##########--------------------#####-----------------##--#---------#-----------------------SS!S--
------------------------------------###--##-----------------#####---------------###--##-------------------##########-------------------######----------------###--##-------##----------------------------#
------------#####-----------#####--####--###----------------#####--------------####--###--------#####-----##########------#####----tt-#######---------------####--###--tt-###---------------------------##
-M-#----tt--#####--#----tt--#####--####--####----tt-----------------gg---------####--###--------#####--#----tt---------gg-#####----tt####-------gg-#----tt--####--###--tt#####----tt-----------------gg-##
XXXXXXXXXXXXXXXXXXXXXXXXXXXXXXXXXXXXXXX--XXXXXXXXXXXXX--XXXXXXXXXXXXXXXX--XXXXXXXXX--XXXX--XXXXXXXXXXXXXXXXXXXXXXXXXXXXXXXXXXXXXXXXXXXXXXXXXXXXXXXXXXXXXXXXXXXXX--XXXXXXXXXXXXXXXXXXXXX--XXXXXXXXXXXXXXXXX
XXXXXXXXXXXXXXXXXXXXXXXXXXXXXXXXXXXXXXX--XXXXXXXXXXXXX--XXXXXXXXXXXXXXXX--XXXXXXXXX--XXXX--XXXXXXXXXXXXXXXXXXXXXXXXXXXXXXXXXXXXXXXXXXXXXXXXXXXXXXXXXXXXXXXXXXXXX--XXXXXXXXXXXXXXXXXXXXX--XXXXXXXXXXXXXXXXX
