----------------------------------------------------------------------------------------------------------------------------------------------------------------------------------------------------------
----------------------------------------------------------------------------------------------------------------------------------------------------------------------------------------------------------
----------------------------------------------------------------------------------------------------------------------------------------------------------------------------------------------------------
----------------------------------------------------------------------------------------------------------------------------------------------------------------------------------------------------------
----------------------------------------------------------------------------------------------------------------------------------------------------------------------------------------------------------
----------------------------------------------------------------------------------------------------------------------------------------------------------------------------------------------------------
------------------------------------------------------------------------------------------------------------------------------##--------------------------------------------------------------------------
---------##------------------------------------------------------------------------------------------------------------------###-------------------------------------------------------##-----------------
--------###-----------------------------------------------------------------------------------------------------------------####------------------------------------------------------###-----------------
-------####------------------------------------------------------------------------------------------SU--------------------#####-----------------------------------------------------####-----------------
------#####---##--#--------------##--#-----------------#--##--#---------#--##--#---------#--##--#-------------------##--#--#####----##--#---------#--##--#---------#----------##--#-#####---------------##
------#####--###--##------------###--##---------------##-###--##-------##-###--##-------##-###--##-----------------###--##-#####---###--##-------##-###--##-------##---------###--#######--------------###
------#####-####--###----------####--###----------tt-#######--###--tt-#######--###--tt-#######--########----------####--########--####--###--tt-#######--###--tt-###--------####--#######------#####--####
-M-#----tt--####--###-------gg-####--###----------tt########--###--tt########--###--tt########--########----------####--########--####--###--tt########--###--tt####--------####--###-------gg-#####--####
XXXXXXXXXXXXXXXX--XXXXXXXXXXXXXXXXX--XXXX--XXXXXXXXXXXXXXXXX--XXXXXXXXXXXXXXX--XXXXXXXXXXXXXXX--XXXXXXXXXXX--XXXXXXXXX--XXXXXXXXXXXXXX--XXXXXXXXXXXXXXX--XXXXXXXXXXXX--XXXXXXXXX--XXXXXXXXXXXXXXXXXXXXXXXX
XXXXXXXXXXXXXXXX--XXXXXXXXXXXXXXXXX--XXXX--XXXXXXXXXXXXXXXXX--XXXXXXXXXXXXXXX--XXXXXXXXXXXXXXX--XXXXXXXXXXX--XXXXXXXXX--XXXXXXXXXXXXXX--XXXXXXXXXXXXXXX--XXXXXXXXXXXX--XXXXXXXXX--XXXXXXXXXXXXXXXXXXXXXXXX
