----------------------------------------------------------------------------------------------------------------------------------------------------------------------------------------------------------
----------------------------------------------------------------------------------------------------------------------------------------------------------------------------------------------------------
----------------------------------------------------------------------------------------------------------------------------------------------------------------------------------------------------------
----------------------------------------------------------------------------------------------------------------------------------------------------------------------------------------------------------
----------------------------------------------------------------------------------------------------------------------------------------------------------------------------------------------------------
-------------------------------------------------------------------------------------------------------------------------##-------------------------------------------------------------------------------
-----------------------##---------------------------------------##------------------------------------------------------###-------------------------------------------------------------------------------
----------------------###--------------------------------------###-----------------------------------------------------####-------------------------------------------------------------------------------
---------------------####-------------------------------------####-----------------------------SS!S-------------------#####-----------------##--#------------------#--##--#---------#-----SU--------------
--------------------#####------------------------------------#####---##--#-------------------------------------------######----------------###--##----------------##-###--##-------##---------------------
-------------------######----##--#------------##--#---------######--###--##-----------------------------------------#######---------------####--###-----------tt-#######--###--tt-###---------------------
------------------#######---###--##----------###--##-------#######-####--###-----------------#####--------------tt-###--------gg-#----tt--####--####----tt----tt########--###--tt#####----tt---------gg---
--------------tt-########--####--###--------####--###--tt-#----tt--####--###--------#----tt--#####---------gg---tt####-XXXXXXXXXXXXXXXXXXXXXXX--XXXXXXXXXXXXXXXXXXXXXXXX--XXXXXXXXXXXXXXXXXXXXXXXXXXXXXXX-
-M-#----tt----tt#########--####--###--------####--###--tt#XXXXXXXXXXXXX--XXXX--XXXXXXXXXXXXXXXXXXXXXXXXXXXXXXXXXXXXXXX-XXXXXXXXXXXXXXXXXXXXXXX--XXXXXXXXXXXXXXXXXXXXXXXX--XXXXXXXXXXXXXXXXXXXXXXXXXXXXXXX-
XXXXXXXXXXXXXXXXXXXXXXXXXXXXXXX--XXXX--XXXXXXXXX--XXXXXXXXXXXXXXXXXXXXX--XXXX--XXXXXXXXXXXXXXXXXXXXXXXXXXXXXXXXXXXXXXX------------------------------------------------------------------------------------
XXXXXXXXXXXXXXXXXXXXXXXXXXXXXXX--XXXX--XXXXXXXXX--XXXXXXXXXXX---------------------------------------------------------------------------------------------------------------------------------------------
