----------------------------------------------------------------------------------------------------------------------------------------------------------------------------------------------------------
----------------------------------------------------------------------------------------------------------------------------------------------------------------------------------------------------------
----------------------------------------------------------------------------------------------------------------------------------------------------------------------------------------------------------
----------------------------------------------------------------------------------------------------------------------------------------------------------------------------------------------------------
----------------------------------------------------------------------------------------------------------------------------------------------------------------------------------------------------------
----------------------------------------------------------------------------------------------------------------------------------------------------------------------------------------------------------
-----------------------------------------##---------------------------------------------------------------------------------------------------------------------------------------------------------------
-----##---------------------------------###---------------------------------------------------------------------------------------------------------------------------------------------------------------
----###--------------------------------####----------------------------SS!S-------------------------------------------------------------------------------------------------------------------------------
---####-------------------------------#####---##--#---------#-----------------##--#---------#-----SU---------------SU-----------##--#--------------##--#---SS!S-------------------------------#-----------
--#####----------------##--#---------######--###--##-------##----------------###--##-------##----------------------------------###--##------------###--#-------------------------------------##-----------
--#####---------------###--##-------#######-####--###--tt-###--------#####--####--###--tt-###--------------------------#####--####--###----------####--#---------------------------------tt-###-----------
--#####--------------####--###--tt-#----tt--####--###--tt####--------#####--####--###--tt#####----tt----------#----tt--#####--####--###-------gg-####--###-------gg-#----tt---------gg---tt####-------gg--
-M--------gg---------####--###--tt#XXXXXXXXXXXXX--XXXXXXXXXXXX--XXXXXXXXXXXXXXXX--XXXXXXXXXXXXXXXXXXXXX--XXXXXXXXXXXXXXXXXXXXXXXXX--XXXXXXXXXXXXXXXXX--XXXXXXXXXXXXXXXXXXXXXXXXXXXXXXXXXXXXXXXXXXXXXXXXXXX
XXXXXXXXXXXXXX--XXXXXXXXX--XXXXXXXXXXXXXXXXXXXXX--XXXXXXXXXXXX--XXXXXXXXXXXXXXXX--XXXXXXXXXXXXXXXXXXXXX--XXXXXXXXXXXXXXXXXXXXXXXXX--XXXXXXXXXXXXXXXXX--XXXXXXXXXXXXXXXXXXXXXXXXXXXXXXXXXXXXXXXXXXXXXXXXXXX
XXXXXXXXXXXXXX--XXXXXXXXX--XXXXXXXXXXX--------------------------------------------------------------------------------------------------------------------------------------------------------------------
