----------------------------------------------------------------------------------------------------------------------------------------------------------------------------------------------------------
----------------------------------------------------------------------------------------------------------------------------------------------------------------------------------------------------------
----------------------------------------------------------------------------------------------------------------------------------------------------------------------------------------------------------
----------------------------------------------------------------------------------------------------------------------------------------------------------------------------------------------------------
----------------------------------------------------------------------------------------------------------------------------------------------------------------------------------------------------------
----------------------------------------------------------------------------------------------------------------------------------------------------------------------------------------------------------
----------------------------------------------------------------------------------------------------------------------------------------------------------------------------------------------------------
----------------------------------------------------------------------------------------------------------------------------------------------------------------------------------------------------------
----------------------------------------------------------------------------------------------------------------------------------------------------------------------------------------------------------
-----------------------------------------------------------------------------------------SS!S---------------------SS!S------------------------------------------------------------------------------------
-----------------------------SS!S------------#-------------------##--#---------------------------------------------------------------##--#------------##--#---SS!S-------##--#------------##--#---SS!S----
--------------------------------------------##------------------###--##-------------------------------------------------------------###--##----------###--#-------------###--##----------###--#-----------
---#####--------------tt-#--------------tt-###-----------------####--###----------#####--------------------#####-------------------####--###--------####--#------------####--###--------####--#-----------
-M-#####---------gg---tt####-------gg---tt####-----tt----------####--###-------gg-#####---------gg---------#####--#----tt----------####--###--------####--###-------gg-####--###--------####--###-------gg
XXXXXXXXXXXXXXXXXXXXXXXXXXXXXXXXXXXXXXXXXXXXXXXXXXXXXXXX--XXXXXXXXX--XXXXXXXXXXXXXXXXXXXXXXXXXXXXXXX--XXXXXXXXXXXXXXXXXXXXXX--XXXXXXXXX--XXXX--XXXXXXXXX--XXXXXXXXXXXXXXXXX--XXXX--XXXXXXXXX--XXXXXXXXXXXX
XXXXXXXXXXXXXXXXXXXXXXXXXXXXXXXXXXXXXXXXXXXXXXXXXXXXXXXX--XXXXXXXXX--XXXXXXXXXXXXXXXXXXXXXXXXXXXXXXX--XXXXXXXXXXXXXXXXXXXXXX--XXXXXXXXX--XXXX--XXXXXXXXX--XXXXXXXXXXXXXXXXX--XXXX--XXXXXXXXX--XXXXXXXXXXXX
