----------------------------------------------------------------------------------------------------------------------------------------------------------------------------------------------------------
----------------------------------------------------------------------------------------------------------------------------------------------------------------------------------------------------------
----------------------------------------------------------------------------------------------------------------------------------------------------------------------------------------------------------
----------------------------------------------------------------------------------------------------------------------------------------------------------------------------------------------------------
----------------------------------------------------------------------------------------------------------------------------------------------------------------------------------------------------------
----------------------------------------------------------------------------------------------------------------------------------------------------------------------------------------------------------
------------------------##-------------------------------##-----------------------------------------------------------------------------------------------------------##----------------------------------
-----------------------###------------------------------###----------------------------------------------------------------------------------------------------------###----------------------------------
----------------------####-----------------------------####---------------------------------------------------------------------------------------------------------####----------------------------------
---------------------#####----------------------------#####----------------------------SS!S---------------------------------------------------------------------------------------------------------------
-----##--#----------######-----------SU--------------######----------------------------------#---------#----------------------------##--#------------SS!S---------#-----------------SU----------------SU--
----###--##--------#######--------------------------#######----------------------------------##-------##---------------------------###--##-----------------------##---------------------------------------
---####--###---tt-########----------------------tt-###--------------------------#####--####--###--tt-########---------------------####--###---------#####----tt-###----------tt-#-------------------------
-M-####--####--tt#########-----------------gg---tt#####----tt----------#----tt--#####--####--###--tt#########--#----tt---------gg-####--####----tt--#####----tt####----------tt####-------gg--------------
XXXXXXX--XXXXXXXXXXXXXXXXXXXX--XXXXXXXXXXXXXXXXXXXXXXXXXXXXXXXXX--XXXXXXXXXXXXXXXXXXXXXXXXX--XXXXXXXXXXXXXXXXXXXXXXXXXXXXXXXXXXXXXXXXX--XXXXXXXXXXXXXXXXXXXXXXXXXXXX--XXXXXXXXXXXXXXXXXXXXXXXX--XXXXXXXXXX
XXXXXXX--XXXXXXXXXXXXXXXXXXXX--XXXXXXXXXXXXXXXXXXXXXXXXXXXXXXXXX--XXXXXXXXXXXXXXXXXXXXXXXXX--XXXXXXXXXXXXXXXXXXXXXXXXXXXXXXXXXXXXXXXXX--XXXXXXXXXXXXXXXXXXXXXXXXXXXX--XXXXXXXXXXXXXXXXXXXXXXXX--XXXXXXXXXX
