---------------------------------------------------------------------------------------------------------------------------------------------------------------------------------------------------------
---------------------------------------------------------------------------------------------------------------------------------------------------------------------------------------------------------
---------------------------------------------------------------------------------------------------------------------------------------------------------------------------------------------------------
---------------------------------------------------------------------------------------------------------------------------------------------------------------------------------------------------------
---------------------------------------------------------------------------------------------------------------------------------------------------------------------------------------------------------
---------------------------------------------------------------------------------------------------------------------------------------------------------------------------------------------------------
------------------------------##-------------------------------------------------------------------------##---------------------------------------##-----------------------------------------##----------
----------------##-----------###------------------------------------------------------------------------###--------------------------------------###---------------##-----------------------###----------
---------------###----------####-----------------------------------------------------------------------####-------------------------------------####--------------###----------------------####----------
--------------####---------#####--------------------------------------------------------SS!S----------#####------------------------------------#####-------------####---------------------#####----------
-------------#####--------######-------------------#----------------#--------------------------------######-------------##--#-----------------######------------#####--------------------######----------
-------------#####-------#######------------------##---------------##-------------------------------#######------------###--##---------------#######-----------######-------------------#######----------
---#####-----#####---tt-###----------#####----tt-###-----------tt-###-----------------#####-----tt-########-----------####--###----------tt-###------------tt-#######------#####----tt-########----------
-M-#####--#----tt----tt####-------gg-#####----tt#####----tt----tt####-----tt----------#####--#--tt#########--#----tt--####--###----------tt####------------tt####-------gg-#####----tt#########----------
XXXXXXXXXXXXXXXXXXXXXXXXXXXXXXXXXXXXXXXXXXXXXXXXXXXXXXXXXXXXXXXXXXXXXXXXXXXXXXX--XXXXXXXXXXXXXXXXXXXXXXXXXXXXXXXXXXXXXXXXX--XXXX--XXXXXXXXXXXXXXXXXXXXXXXXXXXXXXXXXXXXXXXXXXXXXXXXXXXXXXXXXXXXXXXX--XXXXX
XXXXXXXXXXXXXXXXXXXXXXXXXXXXXXXXXXXXXXXXXXXXXXXXXXXXXXXXXXXXXXXXXXXXXXXXXXXXXXX--XXXXXXXXXXXXXXXXXXXXXXXXXXXXXXXXXXXXXXXXX--XXXX--XXXXXXXXXXXXXXXXXXXXXXXXXXXXXXXXXXXXXXXXXXXXXXXXXXXXXXXXXXXXXXXX--XXXXX
