----------------------------------------------------------------------------------------------------------------------------------------------------------------------------------------------------------
----------------------------------------------------------------------------------------------------------------------------------------------------------------------------------------------------------
----------------------------------------------------------------------------------------------------------------------------------------------------------------------------------------------------------
----------------------------------------------------------------------------------------------------------------------------------------------------------------------------------------------------------
----------------------------------------------------------------------------------------------------------------------------------------------------------------------------------------------------------
----------------------------------------------------------------------------------------------------------------------------------------------------------------------------------------------------------
-------------------------------------------------------------------------------------------------------------------------------------------------------##-------------------------------------------------
-----------------------------------------------------------------------##-----------------------------------------------------------------------------###--------------##----------------##---------------
----------------------------------------------------------------------###----------------------------------------------------------------------------####-------------###---------------###---------------
----------------------------------------------------------------SS!S-####------------------------------------------------SS!S----------------------------------------####--------------####---------------
----------#--##--#----------SS!S-------##--#------------------------#####-----------SU-----------------#-------------------##--#--------SS!S-------#----------------#####-------------#####--------##--#--
---------##-###--##-------------------###--##---------------#-------#####-----------------------------##------------------###--##-----------------##----------------#####-------------#####-------###--##-
-----tt-#######--########------------####--###----------tt-########-#####-------------------------tt-###----------#####--####--###------------tt-###----------------#####-------------#####------####--###
-M---tt########--########---------gg-####--###----------tt#########---------gg-#----tt------------tt####-------gg-#####--####--###-------gg---tt####--------#----tt---------gg----------------gg-####--###
XXXXXXXXXXXXXXX--XXXXXXXXXXXXXXXXXXXXXXXX--XXXX--XXXXXXXXXXXXXXXXXXXXXXXXXXXXXXXXXXXXXXXX--XXXXXXXXXXXXXXXXXXXXXXXXXXXXXXXXXX--XXXXXXXXXXXXXXXXXXXXXX--XXXXXXXXXXXXXXXXXXXXXXXXX--XXXXXXXXXXXXXXXXXXX--XXX
XXXXXXXXXXXXXXX--XXXXXXXXXXXXXXXXXXXXXXXX--XXXX--XXXXXXXXXXXXXXXXXXXXXXXXXXXXXXXXXXXXXXXX--XXXXXXXXXXXXXXXXXXXXXXXXXXXXXXXXXX--XXXXXXXXXXXXXXXXXXXXXX--XXXXXXXXXXXXXXXXXXXXXXXXX--XXXXXXXXXXXXXXXXXXX--XXX
