----------------------------------------------------------------------------------------------------------------------------------------------------------------------------------------------------------
----------------------------------------------------------------------------------------------------------------------------------------------------------------------------------------------------------
----------------------------------------------------------------------------------------------------------------------------------------------------------------------------------------------------------
----------------------------------------------------------------------------------------------------------------------------------------------------------------------------------------------------------
----------------------------------------------------------------------------------------------------------------------------------------------------------------------------------------------------------
----------------------------------------------------------------------------------------------------------------------------------------------------------------------------------------------------------
-----------------------------------------------##----------------------------------------------------------------------------------------------------------------------------------------------##---------
----------------##----------------------------###---------------------------------------------------------------------------------------------------------------------------------------------###---------
---------------###---------------------------####--------------------------------------------------------------------------------------------------------------------------------------------####---------
-----SU-------####--------SS!S--------------#####-------------------------------------------------------------------------------------------------------------------------------------------#####---------
-------------#####-------------------------######----##--#------------------------#-------------------------#----------SS!S------------#-------------------------------------------SU-------#####---------
-------------#####------------------------#######---###--##----------------------##------------------------##-------------------------##----------------------------------------------------#####---------
---#####-----#####-#####--------------tt-########--####--###--------#####----tt-###--------------------tt-###---------------------tt-###-----------------------------------#####------------#####---------
-M-#####--#----tt--#####---------gg---tt#########--####--###--------#####----tt####---------------gg---tt#####----tt---------gg---tt####---------------gg---------#----tt--#####---------gg-#####---------
XXXXXXXXXXXXXXXXXXXXXXXXXXXXXXXXXXXXXXXXXXXXXXXXXXXXXXX--XXXX--XXXXXXXXXXXXXXXXXXXXX--XXXXXXXXXXXXXXXXXXXXXXXXXXXXXXXXXXXXXXXXXXXXXXXXXXX--XXXXXXXXXXXXXXXX--XXXXXXXXXXXXXXXXXXXXXXXXXXXXXXXXXXXXXXX--XXXX
XXXXXXXXXXXXXXXXXXXXXXXXXXXXXXXXXXXXXXXXXXXXXXXXXXXXXXX--XXXX--XXXXXXXXXXXXXXXXXXXXX--XXXXXXXXXXXXXXXXXXXXXXXXXXXXXXXXXXXXXXXXXXXXXXXXXXX--XXXXXXXXXXXXXXXX--XXXXXXXXXXXXXXXXXXXXXXXXXXXXXXXXXXXXXXX--XXXX
