--------------------------------------------------------------------------------------------------------------------------------------------------------------------------------------------------------
--------------------------------------------------------------------------------------------------------------------------------------------------------------------------------------------------------
--------------------------------------------------------------------------------------------------------------------------------------------------------------------------------------------------------
--------------------------------------------------------------------------------------------------------------------------------------------------------------------------------------------------------
--------------------------------------------------------------------------------------------------------------------------------------------------------------------------------------------------------
--------------------------------------------------------------------------------------------------------------------------------------------------------------------------------------------------------
--------------------------------------------------------------------------------------------------------------------------------------------------------------------------------------------------------
-------------------------------------------------------------------------------------------------------------------------------------------##-----------------------------------------------------------
------------------------------------------------------------------------------------------------------------------------------------------###-----------------------------------------------------------
--------------------------------------------------------------------------------------------SU-------------------SS!---------------------####-----------------------------------------------------SU----
----------#--##--#------------SS!S--##--#----------------#---------SS!S---------------SS!----------##--#---------------SU---------##--#-#####-------------#-----SS!S--##--#-------SU--------------------
---------##-###--##----------------###--##--------------##----------------------------------------###--##------------------------###--#######------------##----------###--##----------------------------
-----tt-#######--###--------------####--########----tt-###--------------------------------#####--####--#############------------####--#######--------tt-###---------####--###-------------------#####---
-M---tt########--####----#----tt--####--########----tt####---------------gg-#----#----tt--#####--####--#############---------gg-####--###-------gg---tt#####----tt--####--####----tt---------gg-#####---
XXXXXXXXXXXXXXX--XXXXXXXXXXXXXXXXXXXXX--XXXXXXXXXXXXXXXXXXX--XXXXXXXXXXXXXXXXXXXXXXXXXXXXXXXXXXXXXXXX--XXXXXXXXXXXXXXXXXXXXXXXXXXXXX--XXXXXXXXXXXXXXXXXXXXXXXXXXXXXXXXXX--XXXXXXXXXXXXXXXXXXXXXXXXXXXXX-
XXXXXXXXXXXXXXX--XXXXXXXXXXXXXXXXXXXXX--XXXXXXXXXXXXXXXXXXX--XXXXXXXXXXXXXXXXXXXXXXXXXXXXXXXXXXXXXXXX--XXXXXXXXXXXXXXXXXXXXXXXXXXXXX--XXXXXXXXXXXXXXXXXXXXXXXXXXXXXXXXXX--XXXXXXXXXXXXXXXXXXXXXXXXXXXXX-
