----------------------------------------------------------------------------------------------------------------------------------------------------------------------------------------------------------
----------------------------------------------------------------------------------------------------------------------------------------------------------------------------------------------------------
----------------------------------------------------------------------------------------------------------------------------------------------------------------------------------------------------------
----------------------------------------------------------------------------------------------------------------------------------------------------------------------------------------------------------
----------------------------------------------------------------------------------------------------------------------------------------------------------------------------------------------------------
----------------------------------------------------------------------------------------------------------------------------------------------------------------------------------------------------------
---------------------------------------------------------##-----------------------------------------------------------------------------------------------------------------------------------------------
--------------------------------------------------------###----------------------------------------------------------------------------------------------------------------------##-----------------------
-------------------------------------------------------####---------------------------------------------------------------------------------------------------------------------###-----------------------
------------------------------------------------------#####--------------------------------------------------------------SU----------------------------------------------------####-----------------------
----SS!S----------------------------#----------------######---------------------------SU---------------------#--##--#-----------##--#--------------------------SS!S-----------#####-------------##--#-----
-----------------------------------##---------------#######-------------------------------------------------##-###--##---------###--##----------------------------------------#####------------###--##----
----------------------#####----tt-###-----------tt-########-----------#####--------------------#####----tt-#######--########--####--###---------------------------------------#####-----------####--######
-M--------gg-#----tt--#####----tt#####----tt----tt#########-------tt--#####-----------------gg-#####----tt########--########--####--###-------gg----------------gg---------#----tt---------gg-####--######
XXXXXXXXXXXXXXXXXXXXXXXXXXXXXXXXXXXXXXXXXXXXXXXXXXXXXXXXXXXXXXXXXXXXXXXXXXXXXX--XXXXXXXXXXXXXXXXXXXXXXXXXXXXXXXXXX--XXXXXXXXXXXXXX--XXXXXXXXXXXXXX--XXXXXXXXXXXXXXXX--XXXXXXXXXXXXXXXXXXXXXXXXXXXX--XXXXXX
XXXXXXXXXXXXXXXXXXXXXXXXXXXXXXXXXXXXXXXXXXXXXXXXXXXXXXXXXXXXXXXXXXXXXXXXXXXXXX--XXXXXXXXXXXXXXXXXXXXXXXXXXXXXXXXXX--XXXXXXXXXXXXXX--XXXXXXXXXXXXXX--XXXXXXXXXXXXXXXX--XXXXXXXXXXXXXXXXXXXXXXXXXXXX--XXXXXX
