----------------------------------------------------------------------------------------------------------------------------------------------------------------------------------------------------------
----------------------------------------------------------------------------------------------------------------------------------------------------------------------------------------------------------
----------------------------------------------------------------------------------------------------------------------------------------------------------------------------------------------------------
----------------------------------------------------------------------------------------------------------------------------------------------------------------------------------------------------------
----------------------------------------------------------------------------------------------------------------------------------------------------------------------------------------------------------
----------------------------------------------------------------------------------------------------------------------------------------------------------------------------------------------------------
------------------------------------------------------------------------------------------------------------------------------------------------------------------------------##--------------##----------
-----------------------------------------------------------------------------------------------------------------------------------------------------------------------------###-------------###----------
----------------------------------------------------------------------------------------------------------------------------------------------------------------------------####------------####----------
-----------------------------------------------------SS!S--------SS!S-------------------------SS!S-----------------------------------------------------------------------------------------#####------SU--
---------------SU----##--#-------------------#----------------------------------##--#--------------------##--#---SU----------------------#-----SU-----------##--#---------#---------------######----------
--------------------###--##-----------------##---------------------------------###--##------------------###--#--------------------------##-----------------###--##-------##--------------#######----------
---#####-----------####--###------------tt-########------------#####----------####--########-----------####--#----------------------tt-###---------#####--####--###--tt-###----------tt-###---------#####-
-M-#####--#----tt--####--###-------gg---tt#########---------gg-#####----------####--########--#----tt--####--###-------gg-----------tt#####----tt--#####--####--###--tt####----------tt#####----tt--#####-
XXXXXXXXXXXXXXXXXXXXXXX--XXXXXXXXXXXXXXXXXXXXXXXXXXXXXXXXXXXXXXXXXXXXXX--XXXXXXXXX--XXXXXXXXXXXXXXXXXXXXXXX--XXXXXXXXXXXXXX--XXXXXXXXXXXXXXXXXXXXXXXXXXXXXXXXX--XXXXXXXXXXXX--XXXXXXXXXXXXXXXXXXXXXXXXXXXX
XXXXXXXXXXXXXXXXXXXXXXX--XXXXXXXXXXXXXXXXXXXXXXXXXXXXXXXXXXXXXXXXXXXXXX--XXXXXXXXX--XXXXXXXXXXXXXXXXXXXXXXX--XXXXXXXXXXXXXX--XXXXXXXXXXXXXXXXXXXXXXXXXXXXXXXXX--XXXXXXXXXXXX--XXXXXXXXXXXXXXXXXXXXXXXXXXXX
