----------------------------------------------------------------------------------------------------------------------------------------------------------------------------------------------------------
----------------------------------------------------------------------------------------------------------------------------------------------------------------------------------------------------------
----------------------------------------------------------------------------------------------------------------------------------------------------------------------------------------------------------
----------------------------------------------------------------------------------------------------------------------------------------------------------------------------------------------------------
----------------------------------------------------------------------------------------------------------------------------------------------------------------------------------------------------------
----------------------------------------------------------------------------------------------------------------------------------------------------------------------------------------##----------------
-----------------------------------------------------------------------------------------##--------------------------------------------------------------------------------------------###----------------
----------------------------------------------------------------------------------------###-------------------------------------------------------------------------------------------####----------------
---------------------------------------------------------------------------------------####------------------------------------------------------------------------------------------#####----------------
-----------------------------------SS!S-----------------------------------------------#####-------------#---------------#----------##--#------------SS!S------------SU--------------######-------##--#----
---------------------------#--------------------------------------SS!S---------------######------------##--------------##---------###--##------------------------------------------#######------###--##---
--------------------------##--------------------------------------------------------#######--------tt-###----------tt-###--------####--###---------#####-----------------------tt-###----------####--###--
----------------------tt-########-----------------------------------------------tt-###--------gg---tt####----------tt####--------####--####----tt--#####--#----tt---------gg---tt####-------gg-####--####-
-M---------#----tt----tt#########----------#----tt-----------------gg-----------tt####-XXXXXXXXXXXXXXXXXXX--XXXXXXXXXXXXXX--XXXXXXXXX--XXXXXXXXXXXXXXXXXXXXXXXXXXXXXXXXXXXXXXXXXXXXXXXXXXXXXXXXXXXX--XXXXX
XXXX--XXXXXXXXXXXXXXXXXXXXXXXXXXXXXX--XXXXXXXXXXXXXXX--XXXXXXXXXXXXXXXX--XXXXXXXXXXXXX-XXXXXXXXXXXXXXXXXXX--XXXXXXXXXXXXXX--XXXXXXXXX--XXXXXXXXXXXXXXXXXXXXXXXXXXXXXXXXXXXXXXXXXXXXXXXXXXXXXXXXXXXX--XXXXX
XXXX--XXXXXXXXXXXXXXXXXXXXXXXXXXXXXX--XXXXXXXXXXXXXXX--XXXXXXXXXXXXXXXX--XXXXXXXXXXXXX-------XXXX---------------------------------------------------------------------------------------------------------
