----------------------------------------------------------------------------------------------------------------------------------------------------------------------------------------------------------
----------------------------------------------------------------------------------------------------------------------------------------------------------------------------------------------------------
----------------------------------------------------------------------------------------------------------------------------------------------------------------------------------------------------------
----------------------------------------------------------------------------------------------------------------------------------------------------------------------------------------------------------
----------------------------------------------------------------------------------------------------------------------------------------------------------------------------------------------------------
----------------------------------------------------------------------------------------------------------------------------------------------------------------------------------------------------------
----------------------------------------------------------------------------------------------------------------------------------------------------------------------------------------------------------
----------------------------------------------------------------------------------------------------------------------------------------------------------------------------------------------------------
----------------------------------------------------------------------------------------------------------------------------------------------------------------------------------------------------------
----------------------------------------------------------------------------------------------------------------------------------------------------------------------------------------------------------
---------SS!S------------------##--#------------##--#---------#-------------------##--#---SS!S------------#----------##--#------------------------#----------##--#--------------------------SU------------
------------------------------###--##----------###--##-------##------------------###--#------------------##---------###--##----------------------##---------###--##---------------------------------------
----------------------#####--####--###--------####--###--tt-###-----------------####--#--------------tt-###--------####--########------------tt-###--------####--###--------#####-------------------------
-M--------gg-#----tt--#####--####--###--------####--###--tt####--------#----tt--####--###-------gg---tt####--------####--########------------tt####--------####--###--------#####-----------------gg------
XXXXXXXXXXXXXXXXXXXXXXXXXXXXXXXXX--XXXX--XXXXXXXXX--XXXXXXXXXXXX--XXXXXXXXXXXXXXXXXX--XXXXXXXXXXXXXXXXXXXXXX--XXXXXXXXX--XXXXXXXXXXX--XXXXXXXXXXXXXX--XXXXXXXXX--XXXX--XXXXXXXXXXXXX--XXXXXXXXXXXXXXXX--XX
XXXXXXXXXXXXXXXXXXXXXXXXXXXXXXXXX--XXXX--XXXXXXXXX--XXXXXXXXXXXX--XXXXXXXXXXXXXXXXXX--XXXXXXXXXXXXXXXXXXXXXX--XXXXXXXXX--XXXXXXXXXXX--XXXXXXXXXXXXXX--XXXXXXXXX--XXXX--XXXXXXXXXXXXX--XXXXXXXXXXXXXXXX--XX
