----------------------------------------------------------------------------------------------------------------------------------------------------------------------------------------------------------
----------------------------------------------------------------------------------------------------------------------------------------------------------------------------------------------------------
----------------------------------------------------------------------------------------------------------------------------------------------------------------------------------------------------------
----------------------------------------------------------------------------------------------------------------------------------------------------------------------------------------------------------
----------------------------------------------------------------------------------------------------------------------------------------------------------------------------------------------------------
--------------------------------------------------------------------------------------------------------------------------------------------------------------------##------------------------------------
----------------------------------------##----------------------------------------------------##----------------------------------------------------------------------------------------------------------
---------------------------------------###---------------------------------------------------###------------------------------------------------------------------#---------------------------------------
--------------------------------------####--------------------------------------------------####-----------------------------------------------------------------##---------------------------------------
-------------------------------------#####-------------#-----SS---SU------------SS!S-------#####-------------#------------##--#------------##--#----------------###---SU----##--#--------------------##--#
------------------------------------######------------##----------------------------------######------------##-----------###--##----------###--##--------------####--------###--##------------------###--#
-----------------------------------#######--------tt-###------------------------------tt-#######--------tt-###----------####--###--------####--########----tt-###---------####--########-----------####--#
-------------------------------tt-###--------gg---tt#####----tt---------gg-#----tt----tt####-------gg---tt####-------gg-####--###--------####--########----tt#####----tt--####--########--#----tt--####--#
-M-#----tt----------#----tt----tt####-XXXXXXXXXXXXXXXXXXXXXXXXXXXXXXXXXXXXXXXXXXXXXXXXXXXXXXXXXXXXXXXXXXXXXXXXXXXXXXXXXXXXXX--XXXX--XXXXXXXXX--XXXXXXXXXXXXXXXXXXXXXXXXXXXXXXX--XXXXXXXXXXXXXXXXXXXXXXX--X
XXXXXXXXXXXXX--XXXXXXXXXXXXXXXXXXXXXX-XXXXXXXXXXXXXXXXXXXXXXXXXXXXXXXXXXXXXXXXXXXXXXXXXXXXXXXXXXXXXXXXXXXXXXXXXXXXXXXXXXXXXX--XXXX--XXXXXXXXX--XXXXXXXXXXXXXXXXXXXXXXXXXXXXXXX--XXXXXXXXXXXXXXXXXXXXXXX--X
XXXXXXXXXXXXX--XXXXXXXXXXXXXXXXXXXXXX---------------------------------------------------------------------------------------------------------------------------------------------------------------------
