----------------------------------------------------------------------------------------------------------------------------------------------------------------------------------------------------------
----------------------------------------------------------------------------------------------------------------------------------------------------------------------------------------------------------
----------------------------------------------------------------------------------------------------------------------------------------------------------------------------------------------------------
----------------------------------------------------------------------------------------------------------------------------------------------------------------------------------------------------------
----------------------------------------------------------------------------------------------------------------------------------------------------------------------------------------------------------
----------------------------------------------------------------------------------------------------------------------------------------------------------------------------------------------------------
---------------------------------------------------------------------------------------------------------------------------------------------##-----------------------------------------------------------
--------------------------------------------------------------------------------------------------------------------------------------------###------------------##---------------------------------------
-------------------------------------------------------------------------------------------------------------------------------------------####-----------------###---------------------------------------
---------------------------------------------SU-------------------------------------------------------------------------------------------#####----------------####------------SS!S------------SU---------
-----##--#---------#---------------------------------------------SU----##--#---------#------SS!S--##--#----------------------------##--#--#####---------------#####---##--#-----------##--#---------------
----###--##-------##--------------------------------------------------###--##-------##-----------###--##--------------------------###--##-#####---------------#####--###--##---------###--##--------------
---####--###--tt-###--------#####----------#####---------------------####--###--tt-###----------####--########-------------------####--########---------------#####-####--########--####--########----tt-#
-M-####--###--tt####--------#####----------#####---------gg-#----tt--####--###--tt####-------gg-####--########----------#----tt--####--########---------gg-#----tt--####--########--####--########----tt##
XXXXXXX--XXXXXXXXXXXX--XXXXXXXXXXXXX--XXXXXXXXXXXXXXXXXXXXXXXXXXXXXXXXXXX--XXXXXXXXXXXXXXXXXXXXXXXXX--XXXXXXXXXXX--XXXXXXXXXXXXXXXXXX--XXXXXXXXXXXXXXXXXXXXXXXXXXXXXXXXX--XXXXXXXXXXXXXX--XXXXXXXXXXXXXXXX
XXXXXXX--XXXXXXXXXXXX--XXXXXXXXXXXXX--XXXXXXXXXXXXXXXXXXXXXXXXXXXXXXXXXXX--XXXXXXXXXXXXXXXXXXXXXXXXX--XXXXXXXXXXX--XXXXXXXXXXXXXXXXXX--XXXXXXXXXXXXXXXXXXXXXXXXXXXXXXXXX--XXXXXXXXXXXXXX--XXXXXXXXXXXXXXXX
