----------------------------------------------------------------------------------------------------------------------------------------------------------------------------------------------------------
----------------------------------------------------------------------------------------------------------------------------------------------------------------------------------------------------------
----------------------------------------------------------------------------------------------------------------------------------------------------------------------------------------------------------
----------------------------------------------------------------------------------------------------------------------------------------------------------------------------------------------------------
----------------------------------------------------------------------------------------------------------------------------------------------------------------------------------------------------------
----------------------------------------------------------------------------------------------------------------------------------------------------------------------------------------------------------
-------------------------------------------------------------------------------------------------------------------------------------------------------------------------------------------------##-------
--------------------------------------------------------------------------------------------------------------------------------------------##--------------------------------------------------###-------
-------------------------------------------------------------------------------------------------------------------------------------------###-------------------------------------------------####-------
-----------------------------------------------------------------------------------------------SU-------------------SS!S------------------####---------------------------------------SS!S-----#####-------
----SS!S----------------##--#------------##--#-----------------------------SS!S-----------------------##--#---------------------#--##--#-#####--------------------SS!S-----------------##--#--#####-------
-----------------------###--##----------###--##------------------------------------------------------###--##-------------------##-###--#######----------------------------------------###--##-#####-------
----------------------####--###--------####--###---------------------------------------------#####--####--#############----tt-#######--#######--------------------------------#####--####--########-------
-M--------gg-#----tt--####--###--------####--####----tt----------#----tt---------gg-#----tt--#####--####--#############----tt########--###-------gg----------------gg---------#####--####--########-------
XXXXXXXXXXXXXXXXXXXXXXXXXX--XXXX--XXXXXXXXX--XXXXXXXXXXXXX--XXXXXXXXXXXXXXXXXXXXXXXXXXXXXXXXXXXXXXXXXXXX--XXXXXXXXXXXXXXXXXXXXXXXXXXX--XXXXXXXXXXXXXX--XXXXXXXXXXXXXXXX--XXXXXXXXXXXXXXXX--XXXXXXXXXXXXXXX
XXXXXXXXXXXXXXXXXXXXXXXXXX--XXXX--XXXXXXXXX--XXXXXXXXXXXXX--XXXXXXXXXXXXXXXXXXXXXXXXXXXXXXXXXXXXXXXXXXXX--XXXXXXXXXXXXXXXXXXXXXXXXXXX--XXXXXXXXXXXXXX--XXXXXXXXXXXXXXXX--XXXXXXXXXXXXXXXX--XXXXXXXXXXXXXXX
