----------------------------------------------------------------------------------------------------------------------------------------------------------------------------------------------------------
----------------------------------------------------------------------------------------------------------------------------------------------------------------------------------------------------------
----------------------------------------------------------------------------------------------------------------------------------------------------------------------------------------------------------
----------------------------------------------------------------------------------------------------------------------------------------------------------------------------------------------------------
----------------------------------------------------------------------------------------------------------------------------------------------------------------------------------------------------------
------------------------------------------------------------------------------------------------------------------------------------------------------##--------------------------------------------------
----------------------------------------------------------------------------------------------------#------------------------------------------------###--------##----------------------------------------
----------------------------------------------------------------------------------------------------#-----------------------------------------------####-------###----------------------------------------
----------------------------------------------------------------------------------------------------#----------------------------------------------#####------####---SS!S---------------------------------
-------------------------------SS!S-----------------------------------------------------------------#----------------------------------------------#####-----#####---------------------SS!S------------##-
--------------##--#------------------------------SS!S-------#------SS!S----------##--#---------#----#----------------------------------------------#####-----#####------------------------------------###-
-------------###--##---------------------------------------##-------------------###--##-------##----#-------------------------------#####----------#####-----#####-#####-----------------------------####-
------------####--###--------#####---------------------tt-###------------------####--###--tt-###--------gg---------#----tt----------#####----------#####--#----tt--#####----------#----tt---------gg-####-
-M-#----tt--####--###--------#####----------#----tt----tt####-------gg---------####--###--tt####-XXXXXXXXXXX--XXXXXXXXXXXXXXX--XXXXXXXXXXXXX--XXXXXXXXXXXXXXXXXXXXXXXXXXXXX--XXXXXXXXXXXXXXXXXXXXXXXXXXXX-
XXXXXXXXXXXXXXXX--XXXX--XXXXXXXXXXXXX--XXXXXXXXXXXXXXXXXXXXXXXXXXXXXXXXX--XXXXXXXXX--XXXXXXXXXXXXXXXXXXXXXXX--XXXXXXXXXXXXXXX--XXXXXXXXXXXXX--XXXXXXXXXXXXXXXXXXXXXXXXXXXXX--XXXXXXXXXXXXXXXXXXXXXXXXXXXX-
XXXXXXXXXXXXXXXX--XXXX--XXXXXXXXXXXXX--XXXXXXXXXXXXXXXXXXXXXXXXXXXXXXXXX--XXXXXXXXX--XXXXXXXXXXXXXXX------------------------------------------------------------------------------------------------------
