----------------------------------------------------------------------------------------------------------------------------------------------------------------------------------------------------------
----------------------------------------------------------------------------------------------------------------------------------------------------------------------------------------------------------
----------------------------------------------------------------------------------------------------------------------------------------------------------------------------------------------------------
----------------------------------------------------------------------------------------------------------------------------------------------------------------------------------------------------------
----------------------------------------------------------------------------------------------------------------------------------------------------------------------------------------------------------
----------------------------------------------------------------------------------------------------------------------------------------------------------------------------------------------------------
----------------------------------------------------------------------------------------------------------------------------------------------------------------------------------------------------------
----------------------------------------------------------------------------------------------------------------------------------------##----------------------------------------------------------------
---------------------------------------------------------------------------------------------------------------------------------------###----------------------------------------------------------------
----------------------------SS!S------------------------------------------------------------SS!---------------------------------------####---------------------------------------------------------SS!----
--------------##--#--------------------##--#-----------------------------------#------SS!---------SS!S-------------------------##--#-#####------------------------##--#----------------#--##--#----------S
-------------###--##------------------###--##---------------------------------##----------------------------------------------###--#######-----------------------###--##--------------##-###--##----------
------------####--########-----------####--###---------#####--------------tt-###----------#####------------------------------####--#######---------------#####--####--########----tt-#######--########----
-M-#----tt--####--########--#----tt--####--####----tt--#####---------gg---tt####-------gg-#####---------gg----------------gg-####--###-------gg-#----tt--#####--####--########----tt########--########----
XXXXXXXXXXXXXXXX--XXXXXXXXXXXXXXXXXXXXXXX--XXXXXXXXXXXXXXXXXXXXXXXXXXXXXXXXXXXXXXXXXXXXXXXXXXXXXXXXXXXXXXXXX--XXXXXXXXXXXXXXXXXXX--XXXXXXXXXXXXXXXXXXXXXXXXXXXXXXXXX--XXXXXXXXXXXXXXXXXXXXXX--XXXXXXXXXXXX
XXXXXXXXXXXXXXXX--XXXXXXXXXXXXXXXXXXXXXXX--XXXXXXXXXXXXXXXXXXXXXXXXXXXXXXXXXXXXXXXXXXXXXXXXXXXXXXXXXXXXXXXXX--XXXXXXXXXXXXXXXXXXX--XXXXXXXXXXXXXXXXXXXXXXXXXXXXXXXXX--XXXXXXXXXXXXXXXXXXXXXX--XXXXXXXXXXXX
