----------------------------------------------------------------------------------------------------------------------------------------------------------------------------------------------------------
----------------------------------------------------------------------------------------------------------------------------------------------------------------------------------------------------------
----------------------------------------------------------------------------------------------------------------------------------------------------------------------------------------------------------
----------------------------------------------------------------------------------------------------------------------------------------------------------------------------------------------------------
----------------------------------------------------------------------------------------------------------------------------------------------------------------------------------------------------------
----------------------------------------------------------------------------------------------------------------------------------------------------------------------------------------------------------
-----------------------------------------------------------------------------------------------------------------------------------------------##----------------------------------##---------------------
----------------------------------------------------------------------------------------------------------------------------------------------###---------------------------------###---------------------
---------------------------------------------------------------------------------------------------------------------------------------------####--------------------------------####---------------------
-----------------------------------------------------------------------------SU--------------SS!S-------------SS!S--------------------------#####--------##--#--------SS!S------#####---------------------
----------------------##--#-------SU---------------------SU---------##--#--------------SU---------------SS!--------------------------------######-------###--##-----------------#####---------------------
---------------------###--##---------------------------------------###--##----------------------------------------------------------------#######------####--###----------#####-#####---------------------
--------------------####--###---------------------tt-#------------####--########-----------#####------------#####------------#####----tt-###--------gg-####--###-------gg-#####---------gg-#----tt--------
-M-#----tt----------####--####----tt---------gg---tt####-------gg-####--########--#----tt--#####---------gg-#####---------gg-#####----tt####-XXXXXXXXXXXXXX--XXXXXXXXXXXXXXXXXXXXXXXXXXXXXXXXXXXXXXXXXXXXX
XXXXXXXXXXXXX--XXXXXXXXX--XXXXXXXXXXXXXXXXXXXXXXXXXXXXXXXXXXXXXXXXXXXX--XXXXXXXXXXXXXXXXXXXXXXXXXXXXXXXXXXXXXXXXXXXXXXXXXXXXXXXXXXXXXXXXXXXX-XXXXXXXXXXXXXX--XXXXXXXXXXXXXXXXXXXXXXXXXXXXXXXXXXXXXXXXXXXXX
XXXXXXXXXXXXX--XXXXXXXXX--XXXXXXXXXXXXXXXXXXXXXXXXXXXXXXXXXXXXXXXXXXXX--XXXXXXXXXXXXXXXXXXXXXXXXXXXXXXXXXXXXXXXXXXXXXXXXXXXXXXXXXXXXXXXXXXXX--------------------------------------------------------------
