----------------------------------------------------------------------------------------------------------------------------------------------------------------------------------------------------------
----------------------------------------------------------------------------------------------------------------------------------------------------------------------------------------------------------
----------------------------------------------------------------------------------------------------------------------------------------------------------------------------------------------------------
----------------------------------------------------------------------------------------------------------------------------------------------------------------------------------------------------------
----------------------------------------------------------------------------------------------------------------------------------------------------------------------------------------------------------
----------------------------------------------------------------------------------------------------------------------------------------------------------------------------------------------------------
----------------------------------------------------------------------------------------------------------------------------------------------------------------------------------------------------------
------------------##--------------------------------------------------------------------------------------------------------------------------------------------------------------------------------------
-----------------###--------------------------------------------------------------------------------------------------------------------------------------------------------------------------------------
----------------####--------------------------------------------------------------------------------------------------------------------------------------------------------------------------------------
-----##--#-----#####-------SS!S--------------------------------------##--#---------#--------------------------------#----------------------------------#--------------#----------##--#---SS!S-------##--#-
----###--##----#####------------------------------------------------###--##-------##-------------------------------##---------------------------------##-------------##---------###--#-------------###--##
---####--###---#####-----------------------------------------------####--###--tt-###--------#####--------------tt-###-----------------------------tt-########----tt-###--------####--#------------####--##
-M-####--####----tt---------gg-#----tt---------gg-#----tt----------####--###--tt####--------#####---------gg---tt####---------------gg-#----tt----tt#########----tt####--------####--###-------gg-####--##
XXXXXXX--XXXXXXXXXXXXXXXXXXXXXXXXXXXXXXXXXXXXXXXXXXXXXXXXXXX--XXXXXXXXX--XXXXXXXXXXXX--XXXXXXXXXXXXXXXXXXXXXXXXXXXXXXX--XXXXXXXXXXXXXXXXXXXXXXXXXXXXXXXXXXXXXXXXXXXXXXXX--XXXXXXXXX--XXXXXXXXXXXXXXXXX--XX
XXXXXXX--XXXXXXXXXXXXXXXXXXXXXXXXXXXXXXXXXXXXXXXXXXXXXXXXXXX--XXXXXXXXX--XXXXXXXXXXXX--XXXXXXXXXXXXXXXXXXXXXXXXXXXXXXX--XXXXXXXXXXXXXXXXXXXXXXXXXXXXXXXXXXXXXXXXXXXXXXXX--XXXXXXXXX--XXXXXXXXXXXXXXXXX--XX
