----------------------------------------------------------------------------------------------------------------------------------------------------------------------------------------------------------
----------------------------------------------------------------------------------------------------------------------------------------------------------------------------------------------------------
----------------------------------------------------------------------------------------------------------------------------------------------------------------------------------------------------------
----------------------------------------------------------------------------------------------------------------------------------------------------------------------------------------------------------
----------------------------------------------------------------------------------------------------------------------------------------------------------------------------------------------------------
----------------------------------------------------------------------------------------------------------------------------------------------------------------------------------------------------------
----------------------------------------------------------------------------------------------------------------------------------------------------------------------------------------------------------
-------------------------------------##-------------------------------------------------------------------------------------------------------------------------------------------------------------------
------------------------------------###-------------------------------------------------------------------------------------------------------------------------------------------------------------------
-----SU----------------------------####------------------------------------------------------------------------------SS!S------------------------------------------------SS!S-----------------------------
---------------------##--#--------#####--------##--#--------------##--#-------SU-----------------#--##--#-------------------------------------------#--------------------------------#--------------------
--------------------###--##-------#####-------###--##------------###--##------------------------##-###--##-------#---------------------------------##-------------------------------##--------------------
---#####-----------####--########-#####------####--###----------####--###-------------------tt-#######--###--tt-########-----------------------tt-###------------------#####----tt-###--------------------
-M-#####--#----tt--####--########---------gg-####--###-------gg-####--####----tt------------tt########--###--tt#########---------gg-#----tt----tt####---------------gg-#####----tt####---------------gg---
XXXXXXXXXXXXXXXXXXXXXXX--XXXXXXXXXXXXXXXXXXXXXXXX--XXXXXXXXXXXXXXXXX--XXXXXXXXXXXXX--XXXXXXXXXXXXXXXXX--XXXXXXXXXXXXXXXXXXXXXXXXXXXXXXXXXXXXXXXXXXXXXX--XXXXXXXXXXXXXXXXXXXXXXXXXXXXXXX--XXXXXXXXXXXXXXXX-
XXXXXXXXXXXXXXXXXXXXXXX--XXXXXXXXXXXXXXXXXXXXXXXX--XXXXXXXXXXXXXXXXX--XXXXXXXXXXXXX--XXXXXXXXXXXXXXXXX--XXXXXXXXXXXXXXXXXXXXXXXXXXXXXXXXXXXXXXXXXXXXXX--XXXXXXXXXXXXXXXXXXXXXXXXXXXXXXX--XXXXXXXXXXXXXXXX-
