----------------------------------------------------------------------------------------------------------------------------------------------------------------------------------------------------------
----------------------------------------------------------------------------------------------------------------------------------------------------------------------------------------------------------
----------------------------------------------------------------------------------------------------------------------------------------------------------------------------------------------------------
----------------------------------------------------------------------------------------------------------------------------------------------------------------------------------------------------------
----------------------------------------------------------------------------------------------------------------------------------------------------------------------------------------------------------
----------------------------------------------------------------------------------------------------------------------------------------------------------------------------------------------------------
--------------------------------------------------------------------------------------##------------------------------------------------------------------------------------------------------------------
-------------------------------#---##------------------------------------------------###---------------------##-------------------------------------------------------------------------------------------
------------------------------##--###-----------------------------------------------####--------------------###-------------------------------------------------------------------------------------------
-----------------------------###-####----------------------------------------------#####-------------------####-------------SS!S--------------------------------------------SU----------------------------
------------SU--------------#########---##--#-------------------#-----------------######---------#--##--#-#####-------------------SS!S--##--#-----------SS!S-----------------------##--#---------#--##--#-
---------------------------##########--###--##-----------------##----------------#######--------##-###--#######-------------------------##--##------------------------------------###--##-------##-###--##
-----------------------tt-###---#####-####--###------------tt-###------------tt-########----tt-#######--#######------#####--------------##--###--tt-#---------------------#####--####--###--tt-#######--##
-M----------------gg---tt#####----tt--####--###-------gg---tt####-------gg---tt#########----tt########--###-------gg-#####---------gg-####--###--tt####-------gg-#----tt--#####--####--###--tt########--##
XXXX--XXXXXXXXXXXXXXXXXXXXXXXXXXXXXXXXXXXX--XXXXXXXXXXXXXXXXXXXXXXXXXXXXXXXXXXXXXXXXXXXXXXXXXXXXXXXXXX--XXXXXXXXXXXXXXXXXXXXXXXXXXXXXXXXXX--XXXXXXXXXXXXXXXXXXXXXXXXXXXXXXXXXXXXXXXXX--XXXXXXXXXXXXXXX--XX
XXXX--XXXXXXXXXXXXXXXXXXXXXXXXXXXXXXXXXXXX--XXXXXXXXXXXXXXXXXXXXXXXXXXXXXXXXXXXXXXXXXXXXXXXXXXXXXXXXXX--XXXXXXXXXXXXXXXXXXXXXXXXXXXXXXXXXX--XXXXXXXXXXXXXXXXXXXXXXXXXXXXXXXXXXXXXXXXX--XXXXXXXXXXXXXXX--XX
