----------------------------------------------------------------------------------------------------------------------------------------------------------------------------------------------------------
----------------------------------------------------------------------------------------------------------------------------------------------------------------------------------------------------------
----------------------------------------------------------------------------------------------------------------------------------------------------------------------------------------------------------
----------------------------------------------------------------------------------------------------------------------------------------------------------------------------------------------------------
----------------------------------------------------------------------------------------------------------------------------------------------------------------------------------------------------------
----------------------------------------------------------------------------------------------------------------------------------------------------------------------------------------------------------
--------------------------------------------------##-------------------------------------------------------------------------------------------------------------##---------------------------------------
--------------------------------------------##---###------------------------------------------------------------------------------------------------------------###--------------##------------##---------
-------------------------------------------###--####-----------------------------------------------------------------------------------------------------------####-------------###-----------###---------
------------------------------------------####-#####-------------------------------SS!S----------------------------------------------------------------------------------------####----------####---------
------------SU--------------#--##--#-----#####-#####-----------SS!S-----------------------##--#------------SS!S-------##--#------------------#---------------#----------------#####---------#####---##--#-
---------------------------##-###--##----#####-#####-------------------------------------###--##---------------------###--##----------------##--------------##----------------#####---------#####--###--##
-----------------------tt-#######--###---#####-#####----tt-#---------------------#####--####--###-------------------####--###-----------tt-###----------tt-###----------------#####---------#####-####--##
-M----------------gg---tt########--####----tt--#####----tt####-------gg-#----tt--#####--####--####----tt---------gg-####--####----tt----tt####----------tt####--------#----tt---------gg-#----tt--####--##
XXXX--XXXXXXXXXXXXXXXXXXXXXXXXXXX--XXXXXXXXXXXXXXXXXXXXXXXXXXXXXXXXXXXXXXXXXXXXXXXXXXXXXXXXX--XXXXXXXXXXXXXXXXXXXXXXXXXX--XXXXXXXXXXXXXXXXXXXXX--XXXXXXXXXXXXXX--XXXXXXXXXXXXXXXXXXXXXXXXXXXXXXXXXXXXX--XX
XXXX--XXXXXXXXXXXXXXXXXXXXXXXXXXX--XXXXXXXXXXXXXXXXXXXXXXXXXXXXXXXXXXXXXXXXXXXXXXXXXXXXXXXXX--XXXXXXXXXXXXXXXXXXXXXXXXXX--XXXXXXXXXXXXXXXXXXXXX--XXXXXXXXXXXXXX--XXXXXXXXXXXXXXXXXXXXXXXXXXXXXXXXXXXXX--XX
