----------------------------------------------------------------------------------------------------------------------------------------------------------------------------------------------------------
----------------------------------------------------------------------------------------------------------------------------------------------------------------------------------------------------------
----------------------------------------------------------------------------------------------------------------------------------------------------------------------------------------------------------
----------------------------------------------------------------------------------------------------------------------------------------------------------------------------------------------------------
----------------------------------------------------------------------------------------------------------------------------------------------------------------------------------------------------------
----------------------------------------------------------------------------------------------------------------------------------------------------------------------------------------------------------
----------------------------------------------------------------------------------------------------------------------------------------------------------------------------------------------------------
---------------------------------------------------------------------##-----------------------------------------------------------------------------------------------------------------------------------
--------------------------------------------------------------------###-----------------------------------------------------------------------------------------------------------------------------------
-------------------------------------------------------------------####-----------------SS!S----------------------------------SU-----------------------------SS!S-----------------------------------------
-----##--#---------------------##--#---------#----------##--#-----#####---##--#----------------------------##--#---SS!S------------------------##--#---------------S!S-------#--------------------------#-
----###--##-------------------###--##-------##---------###--##----#####--###--##--------------------------###--#------------------------------###--##-----------------------##-------------------------##-
---####--########------------####--###--tt-###--------####--###---#####-####--########-------------------####--#------------#####------------####--########-------------tt-###---------------------tt-###-
-M-####--########---------gg-####--###--tt####--------####--####----tt--####--########----------#----tt--####--###-------gg-#####---------gg-####--########--#----tt----tt####-------gg-#----tt----tt####-
XXXXXXX--XXXXXXXXXXXXXXXXXXXXXXXX--XXXXXXXXXXXX--XXXXXXXXX--XXXXXXXXXXXXXXXX--XXXXXXXXXXX--XXXXXXXXXXXXXXXXXX--XXXXXXXXXXXXXXXXXXXXXXXXXXXXXXXXXX--XXXXXXXXXXXXXXXXXXXXXXXXXXXXXXXXXXXXXXXXXXXXXXXXXXXXXXX
XXXXXXX--XXXXXXXXXXXXXXXXXXXXXXXX--XXXXXXXXXXXX--XXXXXXXXX--XXXXXXXXXXXXXXXX--XXXXXXXXXXX--XXXXXXXXXXXXXXXXXX--XXXXXXXXXXXXXXXXXXXXXXXXXXXXXXXXXX--XXXXXXXXXXXXXXXXXXXXXXXXXXXXXXXXXXXXXXXXXXXXXXXXXXXXXXX
