----------------------------------------------------------------------------------------------------------------------------------------------------------------------------------------------------------
----------------------------------------------------------------------------------------------------------------------------------------------------------------------------------------------------------
----------------------------------------------------------------------------------------------------------------------------------------------------------------------------------------------------------
----------------------------------------------------------------------------------------------------------------------------------------------------------------------------------------------------------
----------------------------------------------------------------------------------------------------------------------------------------------------------------------------------------------------------
----------------------------------------------------------------------------------------------------------------------------------------------------------------------------------------------------------
-------------------------------------------------------------##---------------------------------------------##--------------------------------------------------------------------------------------------
-------------------------------------------------------##---###--------------------------------------------###--------------------------------------------------------------------------------------------
------------------------------------------------------###--####-------------------------------------------####--------------------SU----------------------------------------------------------------------
-----------------------------------------------------####-#####-----------------------------SS!S---------#####---------------------------##--#---------#--##--#---------------------------##--#----------#
----------#------------##--#---SU---------##--#-----#####-#####------------##--#------------------------######--------------------------###--##-------##-###--##-------------------------###--##---------#
---------##-----------###--#-------------###--##----#####-#####-----------###--##----------------------#######------------------#####--####--###--tt-#######--###--------#####----------####--###--------#
-----tt-###----------####--#------------####--###---#####-#####----------####--###--------#####----tt-#----tt----------#----tt--#####--####--###--tt########--###--------#####----------####--####----tt--
-M---tt####-------gg-####--###-------gg-####--####----tt--#####----------####--###--------#####----tt#XXXXXXXXXX--XXXXXXXXXXXXXXXXXXXXXXXXX--XXXXXXXXXXXXXXX--XXXX--XXXXXXXXXXXXX--XXXXXXXXX--XXXXXXXXXXXX
XXXXXXXXXXXXXXXXXXXXXXXXX--XXXXXXXXXXXXXXXXX--XXXXXXXXXXXXXXXXXXXX--XXXXXXXXX--XXXX--XXXXXXXXXXXXXXXXXXXXXXXXXXX--XXXXXXXXXXXXXXXXXXXXXXXXX--XXXXXXXXXXXXXXX--XXXX--XXXXXXXXXXXXX--XXXXXXXXX--XXXXXXXXXXXX
XXXXXXXXXXXXXXXXXXXXXXXXX--XXXXXXXXXXXXXXXXX--XXXXXXXXXXXXXXXXXXXX--XXXXXXXXX--XXXX--XXXXXXXXXXXXXXXXXXXX-------------------------------------------------------------------------------------------------
