----------------------------------------------------------------------------------------------------------------------------------------------------------------------------------------------------------
----------------------------------------------------------------------------------------------------------------------------------------------------------------------------------------------------------
----------------------------------------------------------------------------------------------------------------------------------------------------------------------------------------------------------
----------------------------------------------------------------------------------------------------------------------------------------------------------------------------------------------------------
----------------------------------------------------------------------------------------------------------------------------------------------------------------------------------------------------------
--------------------------------------------------------------------------------------------------------------------------------##------------------------------------------------------------------------
-------------------------------------------------------------------------------------------------------------##----------------###------------------##----------------------------------------------------
---------------------------------------##--------------------------------------##---------------------------###---------------####-----------------###----------------------------------------------------
--------------------------------------###-------------------------------------###--------------------------####--------------#####----------------####----------------------------------------------------
-------------------------------------####------------------------------------####-------------------------#####-------------######---SU----------#####-------------##--#--------------------SS!S----------
----------#-------------------##--#-#####-----------------------------------#####---##--#----------------######------------#######---------------#####------------###--##---------------------------------
---------##------------------###--#######-----------------------------------#####--###--##--------------#######--------tt-########---------------#####-----------####--###--------------------------------
-----tt-###-----------------####--#######-----------------------------------#####-####--########----tt-###--------gg---tt#########---------gg-#----tt---------gg-####--####----tt-----------------gg------
-M---tt####--------#----tt--####--###-------gg----------------gg---------#----tt--####--########----tt####-XXXXXXXXXXXXXXXXXXXXXXXXXXXXXXXXXXXXXXXXXXXXXXXXXXXXXXXXXX--XXXXXXXXXXXXX--XXXXXXXXXXXXXXXX--XX
XXXXXXXXXXXX--XXXXXXXXXXXXXXXXXX--XXXXXXXXXXXXXX--XXXXXXXXXXXXXXXX--XXXXXXXXXXXXXXXXXX--XXXXXXXXXXXXXXXXXX-XXXXXXXXXXXXXXXXXXXXXXXXXXXXXXXXXXXXXXXXXXXXXXXXXXXXXXXXXX--XXXXXXXXXXXXX--XXXXXXXXXXXXXXXX--XX
XXXXXXXXXXXX--XXXXXXXXXXXXXXXXXX--XXXXXXXXXXXXXX--XXXXXXXXXXXXXXXX--XXXXXXXXXXXXXXXXXX--XXXXXXXXXXXXXXXXXX------------------------------------------------------------------------------------------------
