----------------------------------------------------------------------------------------------------------------------------------------------------------------------------------------------------------
----------------------------------------------------------------------------------------------------------------------------------------------------------------------------------------------------------
----------------------------------------------------------------------------------------------------------------------------------------------------------------------------------------------------------
----------------------------------------------------------------------------------------------------------------------------------------------------------------------------------------------------------
----------------------------------------------------------------------------------------------------------------------------------------------------------------------------------------------------------
----------------------------------------------------------------------------------------------------------------------------------------------------------------------------------------------------------
----------------------------------------------##-----------------------------------------------##---------------------------------------------------------------------------------------------------------
---------------------------------------------###----------------------------------------------###---------------------------------------------------------------##----------------------------------------
--------------------------------------------####---------------------------------------------####--------------------------------------------------------------###----------------------------------------
--------------------------------------------------------------------------------------------#####-------------------------------------------------------------####--------------------------------------SS
-------------------------#----------------#---------------------------------------#--##--#--#####---------#------------------------#----------SS!S-----------#####-------------#--##--#---------#---------
------------------------##---------------##--------------------------------------##-###--##-#####--------##-----------------------##-------------------------#####------------##-###--##-------##--------#
---#####------------tt-###-----------tt-###-----------------#####------------tt-#######--########----tt-###-------------------tt-###-------------------#####-#####--------tt-#######--###--tt-########--##
-M-#####------------tt#####----tt----tt####--------#----tt--#####------------tt########--########----tt####-----tt------------tt#####----tt---------gg-#####---------gg---tt########--###--tt#########--##
XXXXXXXXXXX--XXXXXXXXXXXXXXXXXXXXXXXXXXXXXXX--XXXXXXXXXXXXXXXXXXXXXX--XXXXXXXXXXXXXXXXX--XXXXXXXXXXXXXXXXXXXXXXXXXXXX--XXXXXXXXXXXXXXXXXXXXXXXXXXXXXXXXXXXXXXXXXXXXXXXXXXXXXXXXXXXXX--XXXXXXXXXXXXXXXXXXXX
XXXXXXXXXXX--XXXXXXXXXXXXXXXXXXXXXXXXXXXXXXX--XXXXXXXXXXXXXXXXXXXXXX--XXXXXXXXXXXXXXXXX--XXXXXXXXXXXXXXXXXXXXXXXXXXXX--XXXXXXXXXXXXXXXXXXXXXXXXXXXXXXXXXXXXXXXXXXXXXXXXXXXXXXXXXXXXX--XXXXXXXXXXXXXXXXXXXX
