----------------------------------------------------------------------------------------------------------------------------------------------------------------------------------------------------------
----------------------------------------------------------------------------------------------------------------------------------------------------------------------------------------------------------
----------------------------------------------------------------------------------------------------------------------------------------------------------------------------------------------------------
----------------------------------------------------------------------------------------------------------------------------------------------------------------------------------------------------------
----------------------------------------------------------------------------------------------------------------------------------------------------------------------------------------------------------
----------------------------------------------------------------------------------------------------------------------------------------------------------------------------------------------------------
---------------------------------------------------------------------------------------------------------------------------##-----------------------------------------------------------------------------
-----##-------------------------------------------------------------------------------------------------------------------###-------------------##------------------------------------------------##------
----###------------------------------------------------------------------------------------------------------------------####------------------###-----------------------------------------------###------
---####----------------------------------------------------------------SS!S-------------SS!S--------------------------------------------------####----------------------------------------------####------
--#####----------------##--#---------#-------------------##--#---------------SS!S------------------------##--#---------#---------------------#####-------SS!S--##--#------------##--#-------SS!#####------
--#####---------------###--##-------##------------------###--##-----------------------------------------###--##-------##---------------------#####-------------##--##----------###--##---------#####------
--#####--------------####--###--tt-###-----------------####--########------------##########------------####--###--tt-###---------------------#####-------------##--###--------####--###--------#####------
-M--------gg---------####--###--tt####--------#----tt--####--########---------gg-##########---------gg-####--###--tt####---------------gg-#----tt---------gg-####--###--------####--####----tt---------gg-
XXXXXXXXXXXXXX--XXXXXXXXX--XXXXXXXXXXXX--XXXXXXXXXXXXXXXXXX--XXXXXXXXXXXXXXXXXXXXXXXXXXXXXXXXXXXXXXXXXXXXXX--XXXXXXXXXXXX--XXXXXXXXXXXXXXXXXXXXXXXXXXXXXXXXXXXXXX--XXXX--XXXXXXXXX--XXXXXXXXXXXXXXXXXXXXXX
XXXXXXXXXXXXXX--XXXXXXXXX--XXXXXXXXXXXX--XXXXXXXXXXXXXXXXXX--XXXXXXXXXXXXXXXXXXXXXXXXXXXXXXXXXXXXXXXXXXXXXX--XXXXXXXXXXXX--XXXXXXXXXXXXXXXXXXXXXXXXXXXXXXXXXXXXXX--XXXX--XXXXXXXXX--XXXXXXXXXXXXXXXXXXXXXX
