----------------------------------------------------------------------------------------------------------------------------------------------------------------------------------------------------------
----------------------------------------------------------------------------------------------------------------------------------------------------------------------------------------------------------
----------------------------------------------------------------------------------------------------------------------------------------------------------------------------------------------------------
----------------------------------------------------------------------------------------------------------------------------------------------------------------------------------------------------------
----------------------------------------------------------------------------------------------------------------------------------------------------------------------------------------------------------
----------------------------------------------------------------------------------------------------------------------------------------------------------------------------------------------------------
----------------------------------------------------------------------------------------------------------------------------------------------------------##----------------------------------------------
---------------------------------------------------------------------------------------------------------------------------------------------------------###---------------------------------------------#
--------------------------------------------------------------------------------------------------------------------------------------------------------####-----------SS!S-----------------------------##
-------------------------------------------------------------------------------------------------SS!S--------------------------------------------------#####--------------------------##--#------------###
-------------SS!S--S!S--------------------SU------------------------------##--#--------------------------------------------------------#--------------######-------#-----------------###--##-----------###
-------------------------------------------------------------------------###--##------------------------------------------------------##-------------#######---tt-########----------####--########-----###
----------------------#####---------------------------------------------####--###---------#####-----------#####----------#####----tt-########----tt-#----tt----tt#########----------####--########--#----t
-M-#----tt---------gg-#####----------#----tt-----------------gg---------####--####----tt--#####--#----tt--#####----------#####----tt#########----tt#XXXXXXXXXXXXXXXXXXXXXXXXX--XXXXXXXXX--XXXXXXXXXXXXXXXX
XXXXXXXXXXXXXXXXXXXXXXXXXXXXXX--XXXXXXXXXXXXXXX--XXXXXXXXXXXXXXXX--XXXXXXXXX--XXXXXXXXXXXXXXXXXXXXXXXXXXXXXXXXXXXX--XXXXXXXXXXXXXXXXXXXXXXXXXXXXXXXXXXXXXXXXXXXXXXXXXXXXXXXXX--XXXXXXXXX--XXXXXXXXXXXXXXXX
XXXXXXXXXXXXXXXXXXXXXXXXXXXXXX--XXXXXXXXXXXXXXX--XXXXXXXXXXXXXXXX--XXXXXXXXX--XXXXXXXXXXXXXXXXXXXXXXXXXXXXXXXXXXXX--XXXXXXXXXXXXXXXXXXXXXXXXXXXXXXXXXXX---------------------------------------------------
