----------------------------------------------------------------------------------------------------------------------------------------------------------------------------------------------------------
----------------------------------------------------------------------------------------------------------------------------------------------------------------------------------------------------------
----------------------------------------------------------------------------------------------------------------------------------------------------------------------------------------------------------
----------------------------------------------------------------------------------------------------------------------------------------------------------------------------------------------------------
----------------------------------------------------------------------------------------------------------------------------------------------------------------------------------------------------------
----------------------------------------------------------------------------------------------------------------------------------------------------------------------------------------------------------
----------------------------------------------------------------------------------------------------------------------------------------------------------------------------------------------------------
---------------------------------##---------------------------------------------------------##--------------------------------------##--------------------------------------------------------------------
--------------------------------###--------------------------------------------------------###-------------------------------------###--------------------------------------------------------------------
-------------------------------####-------------------------------------------------------####--------SU--------------------------####---SS!S----------------------SU------------------------------------#
----------#--##--#------------#####---------------------##--#-----------SS!S-------##--#-#####---------------##--#---------------#####--------------------##--#-------------------------#---------------##
---------##-###--##-----------#####--------------------###--##--------------------###--#######--------------###--##--------------#####-------------------###--##-----------------------##--------------###
-----tt-#######--########-----#####-------------------####--###------------------####--#######------#####--####--###-------------#####-#####------------####--########-------------tt-###----------tt-####
-M---tt########--########--#----tt---------gg---------####--###---------------gg-####--###-------gg-#####--####--###-------gg-#----tt--#####---------gg-####--########--#----tt----tt####----------tt#####
XXXXXXXXXXXXXXX--XXXXXXXXXXXXXXXXXXXXXXXXXXXXXX--XXXXXXXXX--XXXX--XXXXXXXXXXXXXXXXXXX--XXXXXXXXXXXXXXXXXXXXXXXX--XXXXXXXXXXXXXXXXXXXXXXXXXXXXXXXXXXXXXXXXXXX--XXXXXXXXXXXXXXXXXXXXXXXXXXXX--XXXXXXXXXXXXXX
XXXXXXXXXXXXXXX--XXXXXXXXXXXXXXXXXXXXXXXXXXXXXX--XXXXXXXXX--XXXX--XXXXXXXXXXXXXXXXXXX--XXXXXXXXXXXXXXXXXXXXXXXX--XXXXXXXXXXXXXXXXXXXXXXXXXXXXXXXXXXXXXXXXXXX--XXXXXXXXXXXXXXXXXXXXXXXXXXXX--XXXXXXXXXXXXXX
