----------------------------------------------------------------------------------------------------------------------------------------------------------------------------------------------------------
----------------------------------------------------------------------------------------------------------------------------------------------------------------------------------------------------------
----------------------------------------------------------------------------------------------------------------------------------------------------------------------------------------------------------
----------------------------------------------------------------------------------------------------------------------------------------------------------------------------------------------------------
----------------------------------------------------------------------------------------------------------------------------------------------------------------------------------------------------------
-----------------------------------------------------------------------------------------------------------------------------##------------------------------------------------------------------------##-
----------------------------------------------------------------------------------##----------------------------------------###-----------------------------------------------------------------------###-
---------------------------------------------------------------------------------###---------------------------------------####----------------------------------------------------------------------####-
--------------------------------------------------------------------------------####--------------------------------------#####---------------------------------------------------------------------#####-
-------------------------------------------------------------------------------#####-----------------------##--#---------######-------------------#------SS!S--------------------------------------######-
-----##--#--------------------------SS!S--------------------------------------######----------------------###--##-------#######------------------##-----------------------------------------------#######-
----###--##------------------------------------------------------------------#######--------------#####--####--###--tt-########--------------tt-###------------------#####-----------#####----tt-###------
---####--########-----------#####----------------------------------------tt-###--------gg---------#####--####--###--tt#########---------gg---tt####-------gg---------#####--#----tt--#####----tt####-XXXXX
-M-####--########--#----tt--#####---------gg----------------gg-----------tt####-XXXXXXXXXXX--XXXXXXXXXXXXXXXX--XXXXXXXXXXXXXXXXXXXXXXXXXXXXXXXXXXXXXXXXXXXXXXX--XXXXXXXXXXXXXXXXXXXXXXXXXXXXXXXXXXXX-XXXXX
XXXXXXX--XXXXXXXXXXXXXXXXXXXXXXXXXXXXXXXXXXXXX--XXXXXXXXXXXXXXXX--XXXXXXXXXXXXX-XXXXXXXXXXX--XXXXXXXXXXXXXXXX--XXXXXXXXXXXXXXXXXXXXXXXXXXXXXXXXXXXXXXXXXXXXXXX--XXXXXXXXXXXXXXXXXXXXXXXXXXXXXXXXXXXX------
XXXXXXX--XXXXXXXXXXXXXXXXXXXXXXXXXXXXXXXXXXXXX--XXXXXXXXXXXXXXXX--XXXXXXXXXXXXX---------------------------------------------------------------------------------------------------------------------------
