----------------------------------------------------------------------------------------------------------------------------------------------------------------------------------------------------------
----------------------------------------------------------------------------------------------------------------------------------------------------------------------------------------------------------
----------------------------------------------------------------------------------------------------------------------------------------------------------------------------------------------------------
----------------------------------------------------------------------------------------------------------------------------------------------------------------------------------------------------------
----------------------------------------------------------------------------------------------------------------------------------------------------------------------------------------------------------
----------------------------------------------------------------------------------------------------------------------------------------------------------------------------------------------------------
----------------------------------------##----------------------------------------------------------------------------------------------------------------------------------------------------------------
---------------------------------------###----##----------------------------------------------------------------------------------------------------------------------------------------------------------
--------------------------------------####---###----------------------------------------------------------------------------------------------------------------------------------------------------------
-------------------------------------#####--####---------------------------------SU-----------------------------------------------------------------------------------------------------------------------
-----##--#---------#--##--#----------#####-#####--------------------------------------------------------SU-----------------SU-----------------##--#--------SS!S--------------#----------------------------
----###--##-------##-###--##---------#####-#####---------------------------------------------------------------------------------------------###--##------------------------##----------------------------
---####--###--tt-#######--###--------#####-#####-------------------------------#####--------------------------------------------------------####--###----------#####----tt-###----------------------------
-M-####--###--tt########--###--------#####---------gg---------#----tt----------#####--#----tt-----------------gg-#----tt---------gg---------####--###-------gg-#####----tt####--------#----tt----------#--
XXXXXXX--XXXXXXXXXXXXXXX--XXXX--XXXXXXXXXXXXXXXXXXXXXXX--XXXXXXXXXXXXXXX--XXXXXXXXXXXXXXXXXXXXXX--XXXXXXXXXXXXXXXXXXXXXXXXXXXXXXXXXXX--XXXXXXXXX--XXXXXXXXXXXXXXXXXXXXXXXXXXXXX--XXXXXXXXXXXXXXX--XXXXXXXX
XXXXXXX--XXXXXXXXXXXXXXX--XXXX--XXXXXXXXXXXXXXXXXXXXXXX--XXXXXXXXXXXXXXX--XXXXXXXXXXXXXXXXXXXXXX--XXXXXXXXXXXXXXXXXXXXXXXXXXXXXXXXXXX--XXXXXXXXX--XXXXXXXXXXXXXXXXXXXXXXXXXXXXX--XXXXXXXXXXXXXXX--XXXXXXXX
