----------------------------------------------------------------------------------------------------------------------------------------------------------------------------------------------------------
----------------------------------------------------------------------------------------------------------------------------------------------------------------------------------------------------------
----------------------------------------------------------------------------------------------------------------------------------------------------------------------------------------------------------
----------------------------------------------------------------------------------------------------------------------------------------------------------------------------------------------------------
----------------------------------------------------------------------------------------------------------------------------------------------------------------------------------------------------------
----------------------------------------------------------------------------------------------------------------------------------------------------------------------------------------------------------
-----------------------------------------------------------------------------------------------------------------------------------------------##---------------------------------------------------------
----------------------------------------------------------------------------------------------------------------------------------------------###---------------------------------------------------------
---------------------------------------------------------------------------------------------------------------------------------------------####---------------------------------------------------------
-----------------------------------------------------------------------------------SU-------------------------------------------------------#####---------------------------------------------------------
-------------##--#-----------------------------------#--##--#-------------##--#-----------##--#---------#-----------##--#-------SS!S-------######-----------#--##--#---------#--##--#---------------SU----
------------###--##---------------------------------##-###--##-----------###--##---------###--##-------##----------###--##----------------#######----------##-###--##-------##-###--##-------------------#
-----------####--###----------#####-------------tt-#######--###---------####--########--####--###--tt-###---------####--###-----------tt-###-----------tt-#######--###--tt-#######--###-----------------##
-M---------####--###-------gg-#####--#----tt----tt########--####----tt--####--########--####--###--tt#####----tt--####--####----tt----tt#####----tt----tt########--###--tt########--###--------#----tt--##
XXXX--XXXXXXXXX--XXXXXXXXXXXXXXXXXXXXXXXXXXXXXXXXXXXXXXXXX--XXXXXXXXXXXXXXXX--XXXXXXXXXXXXXX--XXXXXXXXXXXXXXXXXXXXXXXX--XXXXXXXXXXXXXXXXXXXXXXXXXXXXXXXXXXXXXXXXX--XXXXXXXXXXXXXXX--XXXX--XXXXXXXXXXXXXXXX
XXXX--XXXXXXXXX--XXXXXXXXXXXXXXXXXXXXXXXXXXXXXXXXXXXXXXXXX--XXXXXXXXXXXXXXXX--XXXXXXXXXXXXXX--XXXXXXXXXXXXXXXXXXXXXXXX--XXXXXXXXXXXXXXXXXXXXXXXXXXXXXXXXXXXXXXXXX--XXXXXXXXXXXXXXX--XXXX--XXXXXXXXXXXXXXXX
