----------------------------------------------------------------------------------------------------------------------------------------------------------------------------------------------------------
----------------------------------------------------------------------------------------------------------------------------------------------------------------------------------------------------------
----------------------------------------------------------------------------------------------------------------------------------------------------------------------------------------------------------
----------------------------------------------------------------------------------------------------------------------------------------------------------------------------------------------------------
----------------------------------------------------------------------------------------------------------------------------------------------------------------------------------------------------------
----------------------------------------------------------------------------------------------------------------------------------------------------------------------------------------------------------
--------------------------------------------------------------------------##-----------------------------------##-----------------------------------------------------------------------------------------
-------------------------------------------------------------------------###----------------------------------###-----------------------------------------------------------------------------------------
------------------------------------------------------------------------####----------------------------SS!S-####--------------------------------------------SU-------------------------------------------
-----------------------------------------------------------------------#####---##--#------------------------#####--------##--#-------SU------------------------------------SS!S------------#---------##--#
-----##--#-------SU--------SS!S----------------#----------------------######--###--##---------------#-------#####-------###--##--------------------------#--------------------------------##--------###--#
----###--##-----------------------------------##---------------------#######-####--###----------tt-########-#####------####--###---------------------tt-########----------------------tt-########--####--#
---####--###------------------------------tt-########------------tt-#----tt--####--###----------tt#########---------gg-####--####----tt---------gg---tt#########-----------------gg---tt#########--####--#
-M-####--####----tt---------gg-#----tt----tt#########------------tt#XXXXXXXXXXXXX--XXXX--XXXXXXXXXXXXXXXXXXXXXXXXXXXXXXXXXX--XXXXXXXXXXXXXXXXXXXXXXXXXXXXXXXXXXXXXX--XXXXXXXXXXXXXXXXXXXXXXXXXXXXXXXXXX--X
XXXXXXX--XXXXXXXXXXXXXXXXXXXXXXXXXXXXXXXXXXXXXXXXXXXXXXX--XXXXXXXXXXXXXXXXXXXXXXX--XXXX--XXXXXXXXXXXXXXXXXXXXXXXXXXXXXXXXXX--XXXXXXXXXXXXXXXXXXXXXXXXXXXXXXXXXXXXXX--XXXXXXXXXXXXXXXXXXXXXXXXXXXXXXXXXX--X
XXXXXXX--XXXXXXXXXXXXXXXXXXXXXXXXXXXXXXXXXXXXXXXXXXXXXXX--XXXXXXXXXXXXX-----------------------------------------------------------------------------------------------------------------------------------
