----------------------------------------------------------------------------------------------------------------------------------------------------------------------------------------------------------
----------------------------------------------------------------------------------------------------------------------------------------------------------------------------------------------------------
----------------------------------------------------------------------------------------------------------------------------------------------------------------------------------------------------------
----------------------------------------------------------------------------------------------------------------------------------------------------------------------------------------------------------
----------------------------------------------------------------------------------------------------------------------------------------------------------------------------------------------------------
----------------------------------------------------------------------------------------------------------------------------------------------------------------------------------------------------------
--------------##---------------------------------------------------------------------------------------------------------------------##-----------------------------------------##------------------------
-------------###--------------------------------------------------------------------------------------------------------------------###----------------------------------------###------------------------
------------####-------------------------------------------------------------------------------------------------------------------####---------------------------------------####------------------------
-----------#####---------------------------------------------------------------------------SU-------------------------------------#####--------------------------------------#####------------------------
-----------#####----##--#-----------SU-----------------##--#-------------##--#-------------------------------------##--#---------######----##--#-------------##--#-----------#####----------------------##
-----------#####---###--##----------------------------###--##-----------###--##-----------------------------------###--##-------#######---###--##-----------###--##----------#####---------------------###
-----------#####--####--###--------------------------####--###---------####--###---------#####------------#####--####--###--tt-########--####--###---------####--###---------#####--------------------####
-M---------#####--####--###---------------gg---------####--####----tt--####--####----tt--#####---------gg-#####--####--###--tt#########--####--####----tt--####--####----tt--#####-----------------gg-####
XXXX--XXXXXXXXXXXXXXXX--XXXX--XXXXXXXXXXXXXXXX--XXXXXXXXX--XXXXXXXXXXXXXXXX--XXXXXXXXXXXXXXXXXXXXXXXXXXXXXXXXXXXXXXXX--XXXXXXXXXXXXXXXXXXXXXX--XXXXXXXXXXXXXXXX--XXXXXXXXXXXXXXXXXXXX--XXXXXXXXXXXXXXXXXXX
XXXX--XXXXXXXXXXXXXXXX--XXXX--XXXXXXXXXXXXXXXX--XXXXXXXXX--XXXXXXXXXXXXXXXX--XXXXXXXXXXXXXXXXXXXXXXXXXXXXXXXXXXXXXXXX--XXXXXXXXXXXXXXXXXXXXXX--XXXXXXXXXXXXXXXX--XXXXXXXXXXXXXXXXXXXX--XXXXXXXXXXXXXXXXXXX
