----------------------------------------------------------------------------------------------------------------------------------------------------------------------------------------------------------
----------------------------------------------------------------------------------------------------------------------------------------------------------------------------------------------------------
----------------------------------------------------------------------------------------------------------------------------------------------------------------------------------------------------------
----------------------------------------------------------------------------------------------------------------------------------------------------------------------------------------------------------
----------------------------------------------------------------------------------------------------------------------------------------------------------------------------------------------------------
----------------------------------------------------------------------------------------------------------------------------------------------------------------------------------------------------------
-------------------------------------------------------------------------------------------------------------##-------------------------------------------------------------------------------------------
------------------------------------------------------------------------------------------------------------###-------------------------------------------------------------------------------------------
-----------------------------------------------------------------------------------------------------------####-------------------------------------------------------------------------------------------
-----------------------------------------------------------------------------------------------------------------------------------------------SU---------------------------------------------------------
---------------------------#--##--#-----------------SS!S--##--#---------#--##--#---------#---------------#----------##--#--------------------------------------------------------##--#---SU---------------
--------------------------##-###--##---------------------###--##-------##-###--##-------##--------------##---------###--##-----------------#------------------------------------###--#--------------------
----------------------tt-#######--###-------------------####--###--tt-#######--###--tt-###----------tt-###--------####--###------------tt-########-----------------------------####--#--------------------
-M---------#----tt----tt########--####----tt---------gg-####--###--tt########--###--tt####----------tt####--------####--###-------gg---tt#########----------#----tt---------gg-####--###-------gg-#----tt-
XXXX--XXXXXXXXXXXXXXXXXXXXXXXXXX--XXXXXXXXXXXXXXXXXXXXXXXXXX--XXXXXXXXXXXXXXX--XXXXXXXXXXXX--XXXXXXXXXXXXXX--XXXXXXXXX--XXXXXXXXXXXXXXXXXXXXXXXXXXXXX--XXXXXXXXXXXXXXXXXXXXXXXXXXXX--XXXXXXXXXXXXXXXXXXXXX
XXXX--XXXXXXXXXXXXXXXXXXXXXXXXXX--XXXXXXXXXXXXXXXXXXXXXXXXXX--XXXXXXXXXXXXXXX--XXXXXXXXXXXX--XXXXXXXXXXXXXX--XXXXXXXXX--XXXXXXXXXXXXXXXXXXXXXXXXXXXXX--XXXXXXXXXXXXXXXXXXXXXXXXXXXX--XXXXXXXXXXXXXXXXXXXXX
