----------------------------------------------------------------------------------------------------------------------------------------------------------------------------------------------------------
----------------------------------------------------------------------------------------------------------------------------------------------------------------------------------------------------------
----------------------------------------------------------------------------------------------------------------------------------------------------------------------------------------------------------
----------------------------------------------------------------------------------------------------------------------------------------------------------------------------------------------------------
----------------------------------------------------------------------------------------------------------------------------------------------------------------------------------------------------------
----------------------------------------------------------------------------------------------------------------------------------------------------------------------------------------------------------
---------------------------------------------------------------------------------------------------------------------------------------------------------------------------------------------------------#
--------------------------------------------------------------------------------------------------------------------------------------------------------------------------------------------------------##
-------------------------------------------------------------------------------------------------------------------------------------------------------------------------------------------------------###
---------------------SU-------------------------------------------------------------------------------------------------------------------------------------------------------------------------------####
----------#----------------SS!S----------SU-------------------------#--------------------------------------------#----------------------------##--#---------#-----------------------------------------####
---------##--------------------------------------------------------##-------------------------------------------##---------------------------###--##-------##-----------------------------------------####
-----tt-###--------#####---------------------#####-------------tt-###---------------------------------------tt-###--------------------------####--###--tt-###-------------------------#####-----------####
-M---tt####--------#####---------gg-#----tt--#####--#----tt----tt####-------gg-#----tt-----------------gg---tt#####----tt----------#----tt--####--###--tt####--------#----tt----------#####--#----tt--####
XXXXXXXXXXXX--XXXXXXXXXXXXXXXXXXXXXXXXXXXXXXXXXXXXXXXXXXXXXXXXXXXXXXXXXXXXXXXXXXXXXXXXXXX--XXXXXXXXXXXXXXXXXXXXXXXXXXXXXXXXX--XXXXXXXXXXXXXXXXXX--XXXXXXXXXXXX--XXXXXXXXXXXXXXX--XXXXXXXXXXXXXXXXXXXXXXXXX
XXXXXXXXXXXX--XXXXXXXXXXXXXXXXXXXXXXXXXXXXXXXXXXXXXXXXXXXXXXXXXXXXXXXXXXXXXXXXXXXXXXXXXXX--XXXXXXXXXXXXXXXXXXXXXXXXXXXXXXXXX--XXXXXXXXXXXXXXXXXX--XXXXXXXXXXXX--XXXXXXXXXXXXXXX--XXXXXXXXXXXXXXXXXXXXXXXXX
