----------------------------------------------------------------------------------------------------------------------------------------------------------------------------------------------------------
----------------------------------------------------------------------------------------------------------------------------------------------------------------------------------------------------------
----------------------------------------------------------------------------------------------------------------------------------------------------------------------------------------------------------
----------------------------------------------------------------------------------------------------------------------------------------------------------------------------------------------------------
----------------------------------------------------------------------------------------------------------------------------------------------------------------------------------------------------------
----------------------------------------------------------------------------------------------------------------------------------------------------------------------------------------------------------
----------------------------------------------------------------------------------------------------------------------------------------------------------------------------------------------------------
-----##---------------------------------------------------------------------------------------------------------------------------------------------------------------------------------------------------
----###---------------------------------------------------------------------------------------------------------------------------------------------------------------------------------------------------
---####--------SS!S---------------------------------------------------------------------------------------------------------------------------------------------------------------------------------------
--#####--------------------#---------------------------------------------------------------------SS!S------------#---------------#-----------------#--------------SS!S----------SS!S----------------##--#-
--#####-------------------##------------------------------------------------------------------------------------##--------------##----------------##-----------------------------------------------###--##
--#####------#####----tt-###----------------------------------------------------#####-----------------------tt-###----------tt-###------------tt-###----------------------------------------------####--##
-M--------gg-#####----tt####---------------gg-#----tt----------#----tt----------#####--#----tt---------gg---tt####----------tt####-------gg---tt####---------------gg-#----tt---------gg-#----tt--####--##
XXXXXXXXXXXXXXXXXXXXXXXXXXXXX--XXXXXXXXXXXXXXXXXXXXXXXXX--XXXXXXXXXXXXXXX--XXXXXXXXXXXXXXXXXXXXXXXXXXXXXXXXXXXXXXXX--XXXXXXXXXXXXXXXXXXXXXXXXXXXXXXXX--XXXXXXXXXXXXXXXXXXXXXXXXXXXXXXXXXXXXXXXXXXXXXXX--XX
XXXXXXXXXXXXXXXXXXXXXXXXXXXXX--XXXXXXXXXXXXXXXXXXXXXXXXX--XXXXXXXXXXXXXXX--XXXXXXXXXXXXXXXXXXXXXXXXXXXXXXXXXXXXXXXX--XXXXXXXXXXXXXXXXXXXXXXXXXXXXXXXX--XXXXXXXXXXXXXXXXXXXXXXXXXXXXXXXXXXXXXXXXXXXXXXX--XX
