----------------------------------------------------------------------------------------------------------------------------------------------------------------------------------------------------------
----------------------------------------------------------------------------------------------------------------------------------------------------------------------------------------------------------
----------------------------------------------------------------------------------------------------------------------------------------------------------------------------------------------------------
----------------------------------------------------------------------------------------------------------------------------------------------------------------------------------------------------------
----------------------------------------------------------------------------------------------------------------------------------------------------------------------------------------------------------
----------------------------------------------------------------------------------------------------------------------------------------------------------------------------------------------------------
-----------------------##----------------------##---------------------------------------------------------------------------------------------------------------------------##----------------------------
----------------------------------------------###--------------------------------------------------------------------------------------------------------------------------###----------------------------
---------------------#-----------------------####-------------------------------------------------------------------------------------------------------------------------####----------------------------
--------------------##----------------------#####------------------------------------------------------------------------------------------------------------------------#####---##--#--------------------
-------------------###---SU----------------######------------#-------------SS!S-----------------##--#------------------------------------------SS!S-------##--#---------######--###--##-------------------
------------------####--------------------#######-----------##---------------------------------###--##---------------------------------------------------###--##-------#######-####--###------------------
--------------tt-###---------#####----tt-###------------tt-###-------------------------#####--####--########----------#####-----------------------------####--###--tt-#----tt--####--###---------------gg-
-M-#----tt----tt#####----tt--#####----tt####-------gg---tt####--------#----tt----------#####--####--########----------#####----------#----tt---------gg-####--###--tt#XXXXXXXXXXXXX--XXXX--XXXXXXXXXXXXXXX
XXXXXXXXXXXXXXXXXXXXXXXXXXXXXXXXXXXXXXXXXXXXXXXXXXXXXXXXXXXXXXX--XXXXXXXXXXXXXXX--XXXXXXXXXXXXXXXX--XXXXXXXXXXX--XXXXXXXXXXXXX--XXXXXXXXXXXXXXXXXXXXXXXXXXXX--XXXXXXXXXXXXXXXXXXXXX--XXXX--XXXXXXXXXXXXXXX
XXXXXXXXXXXXXXXXXXXXXXXXXXXXXXXXXXXXXXXXXXXXXXXXXXXXXXXXXXXXXXX--XXXXXXXXXXXXXXX--XXXXXXXXXXXXXXXX--XXXXXXXXXXX--XXXXXXXXXXXXX--XXXXXXXXXXXXXXXXXXXXXXXXXXXX--XXXXXXXXXXX---------------------------------
