----------------------------------------------------------------------------------------------------------------------------------------------------------------------------------------------------------
----------------------------------------------------------------------------------------------------------------------------------------------------------------------------------------------------------
----------------------------------------------------------------------------------------------------------------------------------------------------------------------------------------------------------
----------------------------------------------------------------------------------------------------------------------------------------------------------------------------------------------------------
----------------------------------------------------------------------------------------------------------------------------------------------------------------------------------------------------------
----------------------------------------------------------------------------------------------------------------------------------------------------------------------------------------------------------
--------------------------------------------------------------------##------------------------------------------------------------------------------------------------------------------------------------
------------------------------------------##-----------------------###----------------------------------------------------------------------------------------------------##------------##----------------
-----------------------------------------###----------------------####---------------------------------------------------------------------------------------------------###-----------###----------------
----------------------------------------####----------------------------------------------------------------------------------------------------------------------------####----------####-----------SS!S-
------------------SS!S-----------------#####--------------------#------------------------#--##--#--------------------SU------------SS!S--##--#-------------------##--#-#####---------#####----------------
---------------------------------------#####-------------------##-----------------------##-###--##--------------------------------------###--##-----------------###--#######---------#####-------#--------
---------------------------------------#####------#####----tt-###-------------------tt-#######--###------------------------------------####--###--------#####--####--#######---------#####---tt-########--
-M--------gg-#----tt---------gg----------------gg-#####----tt####--------#----tt----tt########--####----tt-----------------gg-#----tt--####--###--------#####--####--###-------gg-#----tt----tt#########--
XXXXXXXXXXXXXXXXXXXXXXXXXXXXXXXXX--XXXXXXXXXXXXXXXXXXXXXXXXXXXXXXX--XXXXXXXXXXXXXXXXXXXXXXXXXX--XXXXXXXXXXXXX--XXXXXXXXXXXXXXXXXXXXXXXXXXXX--XXXX--XXXXXXXXXXXXXXXX--XXXXXXXXXXXXXXXXXXXXXXXXXXXXXXXXXXXXX
XXXXXXXXXXXXXXXXXXXXXXXXXXXXXXXXX--XXXXXXXXXXXXXXXXXXXXXXXXXXXXXXX--XXXXXXXXXXXXXXXXXXXXXXXXXX--XXXXXXXXXXXXX--XXXXXXXXXXXXXXXXXXXXXXXXXXXX--XXXX--XXXXXXXXXXXXXXXX--XXXXXXXXXXXXXXXXXXXXXXXXXXXXXXXXXXXXX
