----------------------------------------------------------------------------------------------------------------------------------------------------------------------------------------------------------
----------------------------------------------------------------------------------------------------------------------------------------------------------------------------------------------------------
----------------------------------------------------------------------------------------------------------------------------------------------------------------------------------------------------------
----------------------------------------------------------------------------------------------------------------------------------------------------------------------------------------------------------
----------------------------------------------------------------------------------------------------------------------------------------------------------------------------------------------------------
----------------------------------------------------------------------------------------------------------------------------------------------------------------------------------------------------------
-----------------------------------------------------------------------------##---------------------------------------------------------------------------------------------------------------------------
----------------------------------------------------------------------------###---------------------------------------------------------------------------------------------------------------------------
---------------------------------------------------------------------------####---------------------------------------------------------------------------------------------------------------------------
--------------------------------------------------------------------------#####---------------------------------------------------------------------------------------------------------------------------
----SU---------##--#--------SS!S---------------------------##--#---------######------------#--##--#---------#-----------------SS!S-------##--#------------##--#---------#----------SU--------------#--##--
--------------###--##-------------------------------------###--##-------#######-----------##-###--##-------##---------------------------###--##----------###--##-------##-------------------------##-###--
-------------####--###-----------------------------------####--###--tt-###------------tt-#######--###--tt-###----------tt-#------------####--###--------####--###--tt-###---------------------tt-#######--
-M--------gg-####--###-------gg---------#----tt----------####--###--tt####-------gg---tt########--###--tt####----------tt####-------gg-####--###--------####--###--tt#####----tt---------gg---tt########--
XXXXXXXXXXXXXXXXX--XXXXXXXXXXXXXX--XXXXXXXXXXXXXXX--XXXXXXXXX--XXXXXXXXXXXXXXXXXXXXXXXXXXXXXXXXX--XXXXXXXXXXXX--XXXXXXXXXXXXXXXXXXXXXXXXXXX--XXXX--XXXXXXXXX--XXXXXXXXXXXXXXXXXXXXXXXXXXXXXXXXXXXXXXXXXX--
XXXXXXXXXXXXXXXXX--XXXXXXXXXXXXXX--XXXXXXXXXXXXXXX--XXXXXXXXX--XXXXXXXXXXXXXXXXXXXXXXXXXXXXXXXXX--XXXXXXXXXXXX--XXXXXXXXXXXXXXXXXXXXXXXXXXX--XXXX--XXXXXXXXX--XXXXXXXXXXXXXXXXXXXXXXXXXXXXXXXXXXXXXXXXXX--
