----------------------------------------------------------------------------------------------------------------------------------------------------------------------------------------------------------
----------------------------------------------------------------------------------------------------------------------------------------------------------------------------------------------------------
----------------------------------------------------------------------------------------------------------------------------------------------------------------------------------------------------------
----------------------------------------------------------------------------------------------------------------------------------------------------------------------------------------------------------
----------------------------------------------------------------------------------------------------------------------------------------------------------------------------------------------------------
----------------------------------------------------------------------------------------------------------------------------------------------------------------------------------------------------------
------##--------------------------------------------------------------------------------------------------------------------------------------------------------------------------------------------------
-----###--------------------------------------------------------------------------------------------------------------------------------------------------------------------------##----------------##----
----####-------------------------------------------------------------------------------------------------------------------------------------------------------------------------###---------------###----
---#####----------------------------------------------------------------------SS!S----------------------------------------------------------------------------------------------####--------------####----
---#####------------SU---------##--#---SS!S-------##--#--------SS!S--##--#--------------------##--#---------#--##--#------------------------------SS!S---------------##--#-----#####---##--#-----#####----
---#####----------------------###--#-------------###--##------------###--##------------------###--##-------##-###--##-----------------------------------------------###--##----#####--###--##----#####----
---#####---------------------####--#------------####--###----------####--########-----------####--###--tt-#######--###---------------------------------------------####--###---#####-####--###---#####----
-M-#####--#----tt---------gg-####--###-------gg-####--###-------gg-####--########--#----tt--####--###--tt########--###---------------gg-#----tt---------gg---------####--####----tt--####--####----tt-----
XXXXXXXXXXXXXXXXXXXXXXXXXXXXXXXXX--XXXXXXXXXXXXXXXXX--XXXXXXXXXXXXXXXXX--XXXXXXXXXXXXXXXXXXXXXXX--XXXXXXXXXXXXXXX--XXXX--XXXXXXXXXXXXXXXXXXXXXXXXXXXXXXXXXXX--XXXXXXXXX--XXXXXXXXXXXXXXXX--XXXXXXXXXXXXXXX
XXXXXXXXXXXXXXXXXXXXXXXXXXXXXXXXX--XXXXXXXXXXXXXXXXX--XXXXXXXXXXXXXXXXX--XXXXXXXXXXXXXXXXXXXXXXX--XXXXXXXXXXXXXXX--XXXX--XXXXXXXXXXXXXXXXXXXXXXXXXXXXXXXXXXX--XXXXXXXXX--XXXXXXXXXXXXXXXX--XXXXXXXXXXXXXXX
