----------------------------------------------------------------------------------------------------------------------------------------------------------------------------------------------------------
----------------------------------------------------------------------------------------------------------------------------------------------------------------------------------------------------------
----------------------------------------------------------------------------------------------------------------------------------------------------------------------------------------------------------
----------------------------------------------------------------------------------------------------------------------------------------------------------------------------------------------------------
----------------------------------------------------------------------------------------------------------------------------------------------------------------------------------------------------------
----------------------------------------------------------------------------------------------------------------------------------------------------------------------------------------------------------
------------------------------------------------##--------------------------------------------------------------------------------------------------------------------------------------------------------
-------------------------##--------------------###----------------------------------------------------------------------------------------------##--------------------------------------------------------
------------------------###-------------------####---------------------------------------------------------------------------------------------###--------------------------------------------------------
-----------------------####------------------#####------SU-------------------------------------------------------SS!S-----------SS!S----------####--------------------------------------------------------
------------------#---#####---##--#---------######--------------------------SS!S-----SS!S-------------SU----------------#-----------------SS!#####----------------##--#---------#-------------------------
-----------------##---#####--###--##-------#######---------------------------------------------------------------------##--------------------#####---------------###--##-------##-------------------------
-------------tt-###---#####-####--###--tt-###---------#####-----------------------------------------------#####----tt-########---------------#####--------------####--###--tt-###-------------------------
-M-----------tt#####----tt--####--###--tt#####----tt--#####--#----tt---------gg-#----tt----------#----tt--#####----tt#########--#----#----tt---------gg---------####--###--tt####--------#----tt---------g
XXXX--XXXXXXXXXXXXXXXXXXXXXXXXXX--XXXXXXXXXXXXXXXXXXXXXXXXXXXXXXXXXXXXXXXXXXXXXXXXXXXXXXXX--XXXXXXXXXXXXXXXXXXXXXXXXXXXXXXXXXXXXXXXXXXXXXXXXXXXXXXXXXXXXX--XXXXXXXXX--XXXXXXXXXXXX--XXXXXXXXXXXXXXXXXXXXXX
XXXX--XXXXXXXXXXXXXXXXXXXXXXXXXX--XXXXXXXXXXXXXXXXXXXXXXXXXXXXXXXXXXXXXXXXXXXXXXXXXXXXXXXX--XXXXXXXXXXXXXXXXXXXXXXXXXXXXXXXXXXXXXXXXXXXXXXXXXXXXXXXXXXXXX--XXXXXXXXX--XXXXXXXXXXXX--XXXXXXXXXXXXXXXXXXXXXX
