----------------------------------------------------------------------------------------------------------------------------------------------------------------------------------------------------------
----------------------------------------------------------------------------------------------------------------------------------------------------------------------------------------------------------
----------------------------------------------------------------------------------------------------------------------------------------------------------------------------------------------------------
----------------------------------------------------------------------------------------------------------------------------------------------------------------------------------------------------------
----------------------------------------------------------------------------------------------------------------------------------------------------------------------------------------------------------
--------------------------------------------------------------------------------------##-----------------------------------------------------------------------------------------------------------##-----
----------------------##-------------------------------------------------------------###---------------------------------------------------------------------##-----------------------------------###-----
---------------------###------------------------------------------------------------####--------------------------------------------------------------------###----------------------------------####-----
--------------------####-----------------------------------------------------------#####-------------------------------------------------------------------####---------------------------------#####-----
-------------------#####--------##--#----------------SS!S-------------------------######-------##--#---SS!S-------##--#---------#-----SU------------------#####--------##--#--------------------#####-----
------------------######-------###--##-------------------------------------------#######------###--#-------------###--##-------##-------------------------#####-------###--##-------------------#####-----
-----------------#######------####--###--------------------------------------tt-###-----------###--#------------####--###--tt-###-------------------#####-#####------####--###------------------#####-----
-------------tt-###--------gg-####--###---------------gg----------------gg---tt####-----------###--###-------gg-####--###--tt#####----tt---------gg-#####---------gg-####--###---------------gg-#####--#--
-M-----------tt####-XXXXXXXXXXXXXX--XXXX--XXXXXXXXXXXXXXXX--XXXXXXXXXXXXXXXXXXXXXXXXXXXXXXXXXXXXX--XXXXXXXXXXXXXXXXX--XXXXXXXXXXXXXXXXXXXXXXXXXXXXXXXXXXXXXXXXXXXXXXXXXXX--XXXX--XXXXXXXXXXXXXXXXXXXXXXXXX
XXXX--XXXXXXXXXXXXX-XXXXXXXXXXXXXX--XXXX--XXXXXXXXXXXXXXXX--XXXXXXXXXXXXXXXXXXXXXXXXXXXXXXXXXXXXX--XXXXXXXXXXXXXXXXX--XXXXXXXXXXXXXXXXXXXXXXXXXXXXXXXXXXXXXXXXXXXXXXXXXXX--XXXX--XXXXXXXXXXXXXXXXXXXXXXXXX
XXXX--XXXXXXXXXXXXX---------------------------------------------------------------------------------------------------------------------------------------------------------------------------------------
