----------------------------------------------------------------------------------------------------------------------------------------------------------------------------------------------------------
----------------------------------------------------------------------------------------------------------------------------------------------------------------------------------------------------------
----------------------------------------------------------------------------------------------------------------------------------------------------------------------------------------------------------
----------------------------------------------------------------------------------------------------------------------------------------------------------------------------------------------------------
----------------------------------------------------------------------------------------------------------------------------------------------------------------------------------------------------------
----------------------------------------------------------------------------------------------------------------------------------------------------------------------------------------------------------
------------------------------------------------#---------------------------------------------------------------------------------------------------------------------------------------##----------------
-----------------------------------------------##--------------------------------------------------------------------------------------------------------------------------------------###----------------
----------------------------------------------###-------------------------------------------------------------------------------------------------------------------------------------####----------------
---------------------------------------------####---SU---------##--#---------#----------------------------##--#---------#---------##--#-------------##--#-------------##--#----------#####--------##--#---
-----##--#---------------SS!S---------------#####-------------###--##-------##---------------------------###--##-------##--------###--##-----------###--##-----------###--##---------#####-------###--##--
----###--##--------------------------------######------------####--###--tt-###--------------------------####--###--tt-########--####--###---------####--###---------####--###--------#####------####--###-
---####--###---------------------------tt-#----tt---------gg-####--###--tt#####----tt----------#----tt--####--###--tt#########--####--####----tt--####--####----tt--####--####----tt---------gg-####--###-
-M-####--###--------#----tt------------tt#XXXXXXXXXXXXXXXXXXXXXXX--XXXXXXXXXXXXXXXXXXXXX--XXXXXXXXXXXXXXXXXX--XXXXXXXXXXXXXXXXXXXXXX--XXXXXXXXXXXXXXXX--XXXXXXXXXXXXXXXX--XXXXXXXXXXXXXXXXXXXXXXXXXX--XXXX
XXXXXXX--XXXX--XXXXXXXXXXXXXXX--XXXXXXXXXXXXXXXXXXXXXXXXXXXXXXXXX--XXXXXXXXXXXXXXXXXXXXX--XXXXXXXXXXXXXXXXXX--XXXXXXXXXXXXXXXXXXXXXX--XXXXXXXXXXXXXXXX--XXXXXXXXXXXXXXXX--XXXXXXXXXXXXXXXXXXXXXXXXXX--XXXX
XXXXXXX--XXXX--XXXXXXXXXXXXXXX--XXXXXXXXXXXXX-------------------------------------------------------------------------------------------------------------------------------------------------------------
