----------------------------------------------------------------------------------------------------------------------------------------------------------------------------------------------------------
----------------------------------------------------------------------------------------------------------------------------------------------------------------------------------------------------------
----------------------------------------------------------------------------------------------------------------------------------------------------------------------------------------------------------
----------------------------------------------------------------------------------------------------------------------------------------------------------------------------------------------------------
----------------------------------------------------------------------------------------------------------------------------------------------------------------------------------------------------------
----------------------------------------------------------------------------------------------------------------------------------------------------------------------------------------------------------
---------------------------------------------------------------------------------------------------------------------------##-----------------------------------------------------------------------------
--------------------------------------------------------------------------------------------------------------------------###-----------------------------------------------------------------------------
-------------------------------------------------------------------------------------------------------------------------####-----------------------------------------------------------------------------
------------------------------------------------------------------------------------------------------------------------#####-----------------------------------------------------------------------------
----------------------##--#------------##--#--------------------##--#---------#--##--#---------#------------------------#####------------##--#-------SU----##--#------------##--#---------#--##--#--------
---------------------###--##----------###--##------------------###--##-------##-###--##-------##------------------------#####-----------###--##-----------###--##----------###--##-------##-###--##-------
--------------------####--###--------####--###---------#####--####--###--tt-#######--###--tt-########-------------------#####----------####--###---------####--###--------####--###--tt-#######--###------
-M-#----tt----------####--###--------####--####----tt--#####--####--###--tt########--###--tt#########--#----tt----------#####----------####--####----tt--####--###--------####--###--tt########--###------
XXXXXXXXXXXXX--XXXXXXXXX--XXXX--XXXXXXXXX--XXXXXXXXXXXXXXXXXXXXXXX--XXXXXXXXXXXXXXX--XXXXXXXXXXXXXXXXXXXXXXXXXXXX--XXXXXXXXXXXXX--XXXXXXXXX--XXXXXXXXXXXXXXXX--XXXX--XXXXXXXXX--XXXXXXXXXXXXXXX--XXXX--XXX
XXXXXXXXXXXXX--XXXXXXXXX--XXXX--XXXXXXXXX--XXXXXXXXXXXXXXXXXXXXXXX--XXXXXXXXXXXXXXX--XXXXXXXXXXXXXXXXXXXXXXXXXXXX--XXXXXXXXXXXXX--XXXXXXXXX--XXXXXXXXXXXXXXXX--XXXX--XXXXXXXXX--XXXXXXXXXXXXXXX--XXXX--XXX
