----------------------------------------------------------------------------------------------------------------------------------------------------------------------------------------------------------
----------------------------------------------------------------------------------------------------------------------------------------------------------------------------------------------------------
----------------------------------------------------------------------------------------------------------------------------------------------------------------------------------------------------------
----------------------------------------------------------------------------------------------------------------------------------------------------------------------------------------------------------
----------------------------------------------------------------------------------------------------------------------------------------------------------------------------------------------------------
----------------------------------------------------------------------------------------------------------------------------------------------------------------------------------------------------------
----------------------------------------------------------------------------------------------------------------------------------------------------------------------------------------------------------
--------------------------------------------------------------------------------------##------------------------------------------------------------------------------------------------------------------
-------------------------------------------------------------------------------------###------------------------------------------------------------------------------------------------------------------
--------------------------------------------------------SU--------------------------####---------------------SS!S-----------------------------------------------------------------------------------------
--------------------SS!S-------##--#---------#-------------------------SU----------#####-------SS!S----------------------#----------------------------------------------------------#----------------#----
------------------------------###--##-------##-------------------------------------#####-----------------#--------------##---------------------------------------------------------##---------------##----
-------------tt-#------------####--###--tt-###--------#####------------------------#####-------------tt-########----tt-###------------------------------------#####------------tt-###-----------tt-#######
-M-----------tt####-------gg-####--###--tt####--------#####--#----tt---------gg-#----tt---------gg---tt#########----tt####-------gg-#----tt----------#----tt--#####------------tt#####----tt----tt########
XXXX--XXXXXXXXXXXXXXXXXXXXXXXXXXX--XXXXXXXXXXXX--XXXXXXXXXXXXXXXXXXXXXXXXXXXXXXXXXXXXXXXXXXXXXXXXXXXXXXXXXXXXXXXXXXXXXXXXXXXXXXXXXXXXXXXXXXXXX--XXXXXXXXXXXXXXXXXXXXXX--XXXXXXXXXXXXXXXXXXXXXXXXXXXXXXXXXX
XXXX--XXXXXXXXXXXXXXXXXXXXXXXXXXX--XXXXXXXXXXXX--XXXXXXXXXXXXXXXXXXXXXXXXXXXXXXXXXXXXXXXXXXXXXXXXXXXXXXXXXXXXXXXXXXXXXXXXXXXXXXXXXXXXXXXXXXXXX--XXXXXXXXXXXXXXXXXXXXXX--XXXXXXXXXXXXXXXXXXXXXXXXXXXXXXXXXX
