----------------------------------------------------------------------------------------------------------------------------------------------------------------------------------------------------------
----------------------------------------------------------------------------------------------------------------------------------------------------------------------------------------------------------
----------------------------------------------------------------------------------------------------------------------------------------------------------------------------------------------------------
----------------------------------------------------------------------------------------------------------------------------------------------------------------------------------------------------------
----------------------------------------------------------------------------------------------------------------------------------------------------------------------------------------------------------
----------------------------------------------------------------------------------------------------------------------------------------------------------------------------------------------------------
--------------------------------##------------------------------------------------------------------------------------------------------------------------------------------------------------------------
---------------------##--------###-------------------------------------------------------------------------------------------------##---------------------------------------------------------------------
--------------------###-------####------------------------------------------------------------------------------------------------###---------------------------------------------------------------------
-------------------##--------#####-----------------------------------------------------------------------------------------------####---------------------SS!S--------------------------------------------
------------##--#-###-------######----##--#---------#--##--#---SS!S------------#---------------#------------------##--#---------#####-------------#---------##--#---------#-------------------------------
-----------###--#####------#######---###--##-------##-###--#------------------##--------------##-----------------###--##--------#####------------##--------###--##-------##-------------------------------
---#####--####--#####--tt-########--####--###--tt-#######--#--------------tt-###----------tt-########-----------####--###-------#####--------tt-########--####--###--tt-###-------------------#####-------
-M-#####--####--###----tt#########--####--###--tt########--###-------gg---tt####----------tt#########--#----tt--####--###---------------gg---tt#########--####--###--tt#####----tt---------gg-#####--#----
XXXXXXXXXXXXXX--XXXXXXXXXXXXXXXXXXXXXXXX--XXXXXXXXXXXXXXX--XXXXXXXXXXXXXXXXXXXXXX--XXXXXXXXXXXXXXXXXXXXXXXXXXXXXXXXX--XXXX--XXXXXXXXXXXXXXXXXXXXXXXXXXXXXXXXXX--XXXXXXXXXXXXXXXXXXXXXXXXXXXXXXXXXXXXXXXXXX
XXXXXXXXXXXXXX--XXXXXXXXXXXXXXXXXXXXXXXX--XXXXXXXXXXXXXXX--XXXXXXXXXXXXXXXXXXXXXX--XXXXXXXXXXXXXXXXXXXXXXXXXXXXXXXXX--XXXX--XXXXXXXXXXXXXXXXXXXXXXXXXXXXXXXXXX--XXXXXXXXXXXXXXXXXXXXXXXXXXXXXXXXXXXXXXXXXX
