----------------------------------------------------------------------------------------------------------------------------------------------------------------------------------------------------------
----------------------------------------------------------------------------------------------------------------------------------------------------------------------------------------------------------
----------------------------------------------------------------------------------------------------------------------------------------------------------------------------------------------------------
----------------------------------------------------------------------------------------------------------------------------------------------------------------------------------------------------------
----------------------------------------------------------------------------------------------------------------------------------------------------------------------------------------------------------
----------------------------------------------------------------------------------------------------------------------------------------------------------------------------------------------------------
----------------------------------------------------------------------------------------------------------------------------------------------------------------------------------------------------------
----------------------------------------------------------------------------------------------------------------------------------------------------------------------------------------------------------
-------------------------------------g------------------------------------------------------g------------------g---------------------------------------------------------------------------------------g--
--------------------------------------------------------#--#--------------#--#--------------------------------------------------#--#--------------------------------------------------#--#----------------
-----------------------------------S@S-----------------##--##------------##--##-----------S@S----------------S@S---------------##--##------------------------------------------------##--##----------S@S--
------------------------------------------------------###--##-----------###--##-----------------------------------------------###--##-----------------------------------------------###--##---------------
-----------------------------------------------------####--##----------####--##----------------------------------------------####--##----------------------------------------------####--##---------------
-M--------------------------------------------------------------------------------------------------------------------------------------------------------------------------------------------------------
XXXXXXXXX---XXXXXXXXXXXXXXX---XXXXXXXXXXXXXXX---XXXXXXXXXXXXXXX---XXXXXXXXXXXXXXX---XXXXXXXXXXXXXXX---XXXXXXXXXXXXXXX---XXXXXXXXXXXXXXX---XXXXXXXXXXXXXXX---XXXXXXXXXXXXXXX---XXXXXXXXXXXXXXX---XXXXXXXXXX
XXXXXXXXX---XXXXXXXXXXXXXXX---XXXXXXXXXXXXXXX---XXXXXXXXXXXXXXX---XXXXXXXXXXXXXXX---XXXXXXXXXXXXXXX---XXXXXXXXXXXXXXX---XXXXXXXXXXXXXXX---XXXXXXXXXXXXXXX---XXXXXXXXXXXXXXX---XXXXXXXXXXXXXXX---XXXXXXXXXX
