----------------------------------------------------------------------------------------------------------------------------------------------------------------------------------------------------------
----------------------------------------------------------------------------------------------------------------------------------------------------------------------------------------------------------
----------------------------------------------------------------------------------------------------------------------------------------------------------------------------------------------------------
----------------------------------------------------------------------------------------------------------------------------------------------------------------------------------------------------------
----------------------------------------------------------------------------------------------------------------------------------------------------------------------------------------------------------
----------------------------------------------------------------------------------------------------------------------------------------------------------------------------------------------------------
----------------------------------------------------------------------------------------------------------------------------------------------------------------------------------------------------------
----------------------------------------------------------------------------------------------------------------------------------------------------------------------------------------------------------
------------------------------------------------g---------------------------------------------------------------------------------------------------------------------------------------------------------
------------------------------#--#---------------------------------------------------------------------#--#--------------------------------------------------------------------------------------#--#-----
-----------------------------##--##-----------S@S-----------------------------------------------------##--##------------------------------------------------------------------------------------##--##----
----------------------------###--##-----------------------------------------------##--#--------------###--##-----------##--#-------------------------------------------------------------------###--##----
---------------------------####--##----------------------------------------------###--##------------####--##----------###--##-----------------------------------------------------------------####--##----
-M--------------------------------------------------------------------------------------------------------------------------------------------------------------------------------------------------------
XXX-XXXXXXXXXXXXXXX---XXXXXXXXXXXXXXX---XXXXXXXXXXXXXXX---XXXXXXXXXXXXXXX---XXXXXXXXXXXXXXX---XXXXXXXXXXXXXXX---XXXXXXXXXXXXXXX---XXXXXXXXXXXXXXX---XXXXXXXXXXXXXXX---XXXXXXXXXXXXXXX---XXXXXXXXXXXXXXX---
XXX-XXXXXXXXXXXXXXX---XXXXXXXXXXXXXXX---XXXXXXXXXXXXXXX---XXXXXXXXXXXXXXX---XXXXXXXXXXXXXXX---XXXXXXXXXXXXXXX---XXXXXXXXXXXXXXX---XXXXXXXXXXXXXXX---XXXXXXXXXXXXXXX---XXXXXXXXXXXXXXX---XXXXXXXXXXXXXXX---
