----------------------------------------------------------------------------------------------------------------------------------------------------------------------------------------------------------
----------------------------------------------------------------------------------------------------------------------------------------------------------------------------------------------------------
----------------------------------------------------------------------------------------------------------------------------------------------------------------------------------------------------------
----------------------------------------------------------------------------------------------------------------------------------------------------------------------------------------------------------
----------------------------------------------------------------------------------------------------------------------------------------------------------------------------------------------------------
----------------------------------------------------------------------------------------------------------------------------------------------------------------------------------------------------------
----------------------------------------------------------------------------------------------------------------------------------------------------------------------------------------------------------
----------------------------------------------------------------------------------------------------------------------------------------------------------------------------------------------------------
----------------------------------------------------------------------------------------------------------------------------------------------------------------------------------------------------------
--------------------#--#--------------------------------#--#--------------#--#--------------#--#--------------#--#--------------------------------------------------------------------#--#--------------#-
-------------------##--##------------------------------##--##------------##--##------------##--##------------##--##------------------------------------------------------------------##--##------------##-
------------------###--##-----------------------------###--##-----------###--##-----------###--##-----------###--##-----------------------------##--#-------------##--#-------------###--##-----------###-
-----------------####--##----------------------------####--##----------####--##----------####--##----------####--##----------------------------###--##-----------###--##-----------####--##----------####-
-M--------------------------------------------------------------------------------------------------------------------------------------------------------------------------------------------------------
XXXXXXXXX---XXXXXXXXXXXXXXX---XXXXXXXXXXXXXXX---XXXXXXXXXXXXXXX---XXXXXXXXXXXXXXX---XXXXXXXXXXXXXXX---XXXXXXXXXXXXXXX---XXXXXXXXXXXXXXX---XXXXXXXXXXXXXXX---XXXXXXXXXXXXXXX---XXXXXXXXXXXXXXX---XXXXXXXXXX
XXXXXXXXX---XXXXXXXXXXXXXXX---XXXXXXXXXXXXXXX---XXXXXXXXXXXXXXX---XXXXXXXXXXXXXXX---XXXXXXXXXXXXXXX---XXXXXXXXXXXXXXX---XXXXXXXXXXXXXXX---XXXXXXXXXXXXXXX---XXXXXXXXXXXXXXX---XXXXXXXXXXXXXXX---XXXXXXXXXX
