--------------------------------------------------------------------------------------------------------------------------------------------
--------------------------------------------------------------------------------------------------------------------------------------------
--------------------------------------------------------------------------------------------------------------------------------------------
--------------------------------------------------------------------------------------------------------------------------------------------
------------------@-----------------------------------------------@------------------------------------------------------------@------------
--------------------------------------------------------------------------------------------------------------------------------------------
----------------------------SSS!--------@------------------------------@------------------SSS!-----------SSS!-------------------------------
--------------------------------------------------------------------------------------------------------------------------------------------
---------------!--!--!-----------------------------------------!--!---------------------------------------------------------!--!--!----SSS!-
--------------------------------------------------------------------------------------------------------------------------------------------
----------------------C-----------C--!--!--!----SU---------C--------!--!--!----SU--------------------S------C-----SU---------------C--------
--------------------------------------------------------------------------------------------------------------------------------------------
--------------------------------------------------------------------------------------------------------------------------------------------
-M---------------------g-g---------g-g---k------------------g-g---------k------------------------------------g-g--------------------g-g---k-
XXX--XXXXXXXXXX--XXXXXXXXXX--XXXXXXXXXXXXXXXXXXXXXXXXXXXXXXXXXXX--XXXXXXXXXXXXXXXXXXXXXXX--XXXXXXXXXXXXXXXXXXXXXXXXXXXXXXXXX--XXXXXXXXXXXXXX
XXX--XXXXXXXXXX--XXXXXXXXXX--XXXXXXXXXXXXXXXXXXXXXXXXXXXXXXXXXXX--XXXXXXXXXXXXXXXXXXXXXXX--XXXXXXXXXXXXXXXXXXXXXXXXXXXXXXXXX--XXXXXXXXXXXXXX
