----------------------------------------------------------------------------------------------------------------------------
----------------------------------------------------------------------------------------------------------------------------
----------------------------------------------------------------------------------------------------------------------------
----------------------------------------------------------------------------------------------------------------------------
----------------------------------------------------------------------------------------------------------------------------
----------------------------------------------------------------------------------------------------------------------------
---@-----------------------------------------------------------------------SSS!------------@-------------@---------@--------
----------------------------------------------------------------------------------------------------------------------------
------------------------SSS!---------SSS!----------------------------SSS----------------------------------------------------
----------------------------------------------------------------------------------------------------------------------------
!--!--!-----SU-----------------SU----------S-----------S------S-!-----------------------!--!--!----S--!--!--!---!--!--!-SU--
----------------------------------------------------------------------------------------------------------------------------
----------------------------------------------------------------------------------------------------------------------------
-M---k------------------k------------k------------------------------k------------------------k-------------k----------------
XXXXXXXXXXXXXXXXXXXXXXXXXXXXXXXXXXXXXXXXXXXXXXXXXXXXXXXXXXXXXXXXXXXXXXXXXX--XXXXXXXXXXXXXXXXXXXXXXXXXXXXXXXXXXXXXXXXXXXXXXXX
XXXXXXXXXXXXXXXXXXXXXXXXXXXXXXXXXXXXXXXXXXXXXXXXXXXXXXXXXXXXXXXXXXXXXXXXXX--XXXXXXXXXXXXXXXXXXXXXXXXXXXXXXXXXXXXXXXXXXXXXXXX
