-------------------------------------------------------------------------------------------------------------------------------
-------------------------------------------------------------------------------------------------------------------------------
-------------------------------------------------------------------------------------------------------------------------------
-------------------------------------------------------------------------------------------------------------------------------
-------------------------------------------------@-----------------------------------------------------------------------------
-------------------------------------------------------------------------------------------------------------------------------
-----------------------------------SSS!------------------------------SSS!------------------------------------------------------
-------------------------------------------------------------------------------------------------------------------------------
----------------------SSS!----------------!---!--!--!----SSS!-----------------------------------SSS!----------------------SSS!-
-------------------------------------------------------------------------------------------------------------------------------
---S------------SU--------------------C-----------C------------------C----S------------C------------------S------C-------------
-------------------------------------------------------------------------------------------------------------------------------
-------------------------------------------------------------------------------------------------------------------------------
-M--------------------k--k-------------g-g---------g-g---k------------g-g---------------g-g---k-------------------g-g--------k-
XXXXXXXXXXXXXXXXXXXXXXXXXXXXXXX--XXXXXXXXXX--XXXXXXXXXXXXXXXXXXXXXXXXXXXXXXXXXXXXXXXXXXXXXXXXXXXXXXXXXXXXXXXXXXXXXXXXXXXXXXXXXX
XXXXXXXXXXXXXXXXXXXXXXXXXXXXXXX--XXXXXXXXXX--XXXXXXXXXXXXXXXXXXXXXXXXXXXXXXXXXXXXXXXXXXXXXXXXXXXXXXXXXXXXXXXXXXXXXXXXXXXXXXXXXX
