-----------------------------------------------------------------------------------------------------------------------------------------
-----------------------------------------------------------------------------------------------------------------------------------------
-----------------------------------------------------------------------------------------------------------------------------------------
-----------------------------------------------------------------------------------------------------------------------------------------
-------------------------------------@----------------------@------------------@-------------------------------@-------------------------
-----------------------------------------------------------------------------------------------------------------------------------------
-----------------------------------------------------@-------------------------------------------------@---------------------------------
-----------------------------------------------------------------------------------------------------------------------------------------
--------SSS!----------SSS!--------!--!--!----------------!--!--!------------!--!--!-------------------------!--!--!----------------------
-----------------------------------------------------------------------------------------------------------------------------------------
----C---------------------------------C----S--!---!--!--!-------C----S------SU---C----------S-------!--!--!-----C-----SU---C---------SS--
-----------------------------------------------------------------------------------------------------------------------------------------
-----------------------------------------------------------------------------------------------------------------------------------------
-M---g-g---k-------------k-------------g-g---------k-------------g-g--------------g-g--------------------k-------g-g--------g-g-gg-g-g---
XXXXXXXXXXXXXXXXX--XXXXXXXXXXXX--XXXXXXXXXXXXXXXXXXXXXXXX--XXXXXXXXXXXXXXXXXXXXXXXXXXXXXXXXXXXXXXXXXXXXXXXXXXXXXXXXXXXXXXXXXXXXXXXXXXXXXX
XXXXXXXXXXXXXXXXX--XXXXXXXXXXXX--XXXXXXXXXXXXXXXXXXXXXXXX--XXXXXXXXXXXXXXXXXXXXXXXXXXXXXXXXXXXXXXXXXXXXXXXXXXXXXXXXXXXXXXXXXXXXXXXXXXXXXX
