-------------------------------------------------------------------------------------------------------------------------------------------------------------
-------------------------------------------------------------------------------------------------------------------------------------------------------------
-------------------------------------------------------------------------------------------------------------------------------------------------------------
-------------------------------------------------------------------------------------------------------------------------------------------------------------
---------------------------------------------@---------------------------------------------------------------@-----------------------------------------------
-------------------------------------------------------------------------------------------------------------------------------------------------------------
----------------------------------------------------------------------------------------@---------SSS!-------------------------SSS!--------------------------
-------------------------------------------------------------------------------------------------------------------------------------------------------------
------------------------------------------!--!--!---------------------------------------------------------!--!--!---------------------------------------SSS!-
-------------------------------------------------------------------------------------------------------------------------------------------------------------
---S------SU--------S-----------S------SU---------------SU--S------SU--S-------------!--!--!------------------C----S------SU---C----------S------------------
-------------------------------------------------------------------------------------------------------------------------------------------------------------
-------------------------------------------------------------------------------------------------------------------------------------------------------------
-M-----------------------------------------------------------------------------------k-------------------------g-g--------------g-g---------------------k----
XXXXXXXXXXXXXX--XXXXXXXXXX--XXXXXXXXXXXXXXX--XXXXXXXXXXXXXXXXXXXXXXXXXXXXXXXXXXXXXXXXXXXXXXXXXXXX--XXXXXXXXXXXXXXXXXXXXXXXXXXXXXXXXXXXXXXXXXXXXXXXXXXXXXXXXXX
XXXXXXXXXXXXXX--XXXXXXXXXX--XXXXXXXXXXXXXXX--XXXXXXXXXXXXXXXXXXXXXXXXXXXXXXXXXXXXXXXXXXXXXXXXXXXX--XXXXXXXXXXXXXXXXXXXXXXXXXXXXXXXXXXXXXXXXXXXXXXXXXXXXXXXXXX
