-----------------------------------------------------------------------------------------------------------------------------------------
-----------------------------------------------------------------------------------------------------------------------------------------
-----------------------------------------------------------------------------------------------------------------------------------------
-----------------------------------------------------------------------------------------------------------------------------------------
------------@-------------------------------------------------------------@-------@------------------------------------------------------
-----------------------------------------------------------------------------------------------------------------------------------------
----------------------------------------------------SSS!-----------------------------------@--------------------@----------SSS!----------
-----------------------------------------------------------------------------------------------------------------------------------------
---------!--!--!-------SSS!--------------------------------------------!--!--!-!-----SS--------------------------------------------------
-----------------------------------------------------------------------------------------------------------------------------------------
----------------C------------SU---------C----S------C----S------------SU---C------------!--!--!------SU---C--!--!--!---S------C----------
-----------------------------------------------------------------------------------------------------------------------------------------
-----------------------------------------------------------------------------------------------------------------------------------------
-M---------------g-g---k-----------------g-g---------g-g--------------------g-g---------k------------------g-g---k-------------g-g-------
XXXXXXXXX--XXXXXXXXXXXXXXXXXXXXXXXXXXXXXXXXXXXXXXXXXXXXXXXXXXXXXXXXXXXXXXXXXXXXX--XXXXXXXXXXXXXXXXXXXXXXXXXXXXXXXXXXXXXXXXXXXXXXXXXXXXXXX
XXXXXXXXX--XXXXXXXXXXXXXXXXXXXXXXXXXXXXXXXXXXXXXXXXXXXXXXXXXXXXXXXXXXXXXXXXXXXXX--XXXXXXXXXXXXXXXXXXXXXXXXXXXXXXXXXXXXXXXXXXXXXXXXXXXXXXX
