----------------------------------------------------------------------------------------------------------------------------------------------
----------------------------------------------------------------------------------------------------------------------------------------------
----------------------------------------------------------------------------------------------------------------------------------------------
----------------------------------------------------------------------------------------------------------------------------------------------
-----------@----------------------------------------------------------------------------------------------------------------------@-----------
----------------------------------------------------------------------------------------------------------------------------------------------
-------------------------------------------------------------------------------------------------------@--------------------------------------
----------------------------------------------------------------------------------------------------------------------------------------------
--------!--!--!--------------SSS!-------------------------------------SSS!-----------------------SS---------------SSS!---------!--!--!--------
----------------------------------------------------------------------------------------------------------------------------------------------
----C----------------S------------------------SU---C-------------------SS!------------S-------------!--!--!--------------SU--S------C-----SU--
----------------------------------------------------------------------------------------------------------------------------------------------
------------------------------------------------------------------tt--------------------------------------------------------------------------
-M---g-g---------------------k----------------------g-g-----------tt--------------------------------k-------------k------------------g-g------
XXXXXXXXX--XXXXXXXXXXXXXXXXXXXXXXXXXXXX--XXXXXXXXXXXXXXXXXXXXX--XXXXXXXXXXXXXXXX--XXXXXXXXXXXXXXXXXXXXXXXXXXXXXXXXXXXXXXXXXXXXXXXXXXXXXXXXXXXX
XXXXXXXXX--XXXXXXXXXXXXXXXXXXXXXXXXXXXX--XXXXXXXXXXXXXXXXXXXXX--XXXXXXXXXXXXXXXX--XXXXXXXXXXXXXXXXXXXXXXXXXXXXXXXXXXXXXXXXXXXXXXXXXXXXXXXXXXXX
