------------------------------------------------------------------------------------------------------------------------------------------------------
------------------------------------------------------------------------------------------------------------------------------------------------------
------------------------------------------------------------------------------------------------------------------------------------------------------
------------------------------------------------------------------------------------------------------------------------------------------------------
-----------@--------------------------------@---------------------------------------------------------------------------------------------------------
------------------------------------------------------------------------------------------------------------------------------------------------------
---------------------------------------------------SSS!------------------@-------------------------@--------------------------------------------------
------------------------------------------------------------------------------------------------------------------------------------------------------
--------!--!-----------------------------!--!--!---------------------------------------------------------SSS!-----------------------------------------
------------------------------------------------------------------------------------------------------------------------------------------------------
----SU--------S------C----------S------------C----------S------SU-----!--!--!----S-----------S--!--!---------------------S------C----S------------SU--
------------------------------------------------------------------------------------------------------------------------------------------------------
------------------------------------------------------------------------------------------------------------------------------------------------------
-M--------------------g-g---------------------g-g--------------------k-------------------------------k-------k-------------------g-g------------------
XXXXXXXX--XXXXXXXXXXXXXXXX--XXXXXXXXXXXXXXXXXXXXXX--XXXXXXXXXXXXXXXXXXXXXXXXXXXXXXXXXXXXXXXXXXXXXXXXXXXXXXXXXXXXXXX--XXXXXXXXXXXXXXXXXXXXXXXXXXXXXXXXX
XXXXXXXX--XXXXXXXXXXXXXXXX--XXXXXXXXXXXXXXXXXXXXXX--XXXXXXXXXXXXXXXXXXXXXXXXXXXXXXXXXXXXXXXXXXXXXXXXXXXXXXXXXXXXXXX--XXXXXXXXXXXXXXXXXXXXXXXXXXXXXXXXX
