--------------------------------------------------------------------------------------------------------------------------
--------------------------------------------------------------------------------------------------------------------------
--------------------------------------------------------------------------------------------------------------------------
--------------------------------------------------------------------------------------------------------------------------
-----------@-----------------------------------------------------@--------------------------------------------------------
--------------------------------------------------------------------------------------------------------------------------
-----------------------------------@-----------------------------------------------SSS!----------S----@-------------------
--------------------------------------------------------------------------------------------------------------------------
--------!--!--!-------------------------------------------SSS-!--!--!-----------------------------------------------------
--------------------------------------------------------------------------------------------------------------------------
----SU---------C-----------S-!--!--!--!---------SU-----------------C-----S-!----------C-----SU---C-!--!--!----S-----------
--------------------------------------------------------------------------------------------------------------------------
--------------------------------------------------------------------------------------------------------------------------
-M--------------g-g--------------k-------k------------k-------------g-g--------k-------g-g--------g-g---k-----------------
XXXXXXXX--XXXXXXXXXX--XXXXXXXXXXXXXXXXXXXXXXXXXXXXXXXXXXXXXXXXXXXXXXXXXXXXXXXXXXXXXXXXXXXXXXXXXXXXXXXXXXXXXXXXXXXXXXXXXXXX
XXXXXXXX--XXXXXXXXXX--XXXXXXXXXXXXXXXXXXXXXXXXXXXXXXXXXXXXXXXXXXXXXXXXXXXXXXXXXXXXXXXXXXXXXXXXXXXXXXXXXXXXXXXXXXXXXXXXXXXX
