---------------------------------------------------------------------------------------------------------------------------------------------
---------------------------------------------------------------------------------------------------------------------------------------------
---------------------------------------------------------------------------------------------------------------------------------------------
---------------------------------------------------------------------------------------------------------------------------------------------
-----@------------@------------------------------------------------------------@-------------------------------------------------------------
---------------------------------------------------------------------------------------------------------------------------------------------
------------------------------SSS!-------------------------------------------------------------@---------------------------------------------
---------------------------------------------------------------------------------------------------------------------------------------------
--!--!--!------!--!----SSS!-------------------------------------------------!--!-----SSS!-------------------------------------SSS!-----------
---------------------------------------------------------------------------------------------------------------------------------------------
------------------------------------C-----------C----------S-----------S------------C-------!--!--!-----C----------S------C-------------C----
---------------------------------------------------------------------------------------------------------------------------------------------
---------------------------------------------------------------------------------------------------------------------------------------------
-M---------------------k-------------g-g---------g-g---------------------------------g-g---------k-------g-g---------------g-g---k-------g-g-
XXX--XXXXXXXXXX--XXXXXXXXXXXX--XXXXXXXXXX--XXXXXXXXXX--XXXXXXXXXXXXXXXXXXXXXX--XXXXXXXXXXXXXXXXXXXXXXXXXXXXXXXXXXXXXXXXXXXXXXXXXXXXXXXXXXXXXX
XXX--XXXXXXXXXX--XXXXXXXXXXXX--XXXXXXXXXX--XXXXXXXXXX--XXXXXXXXXXXXXXXXXXXXXX--XXXXXXXXXXXXXXXXXXXXXXXXXXXXXXXXXXXXXXXXXXXXXXXXXXXXXXXXXXXXXX
