------------------------------------------------------------------------------------------------------------------------------------------------
------------------------------------------------------------------------------------------------------------------------------------------------
------------------------------------------------------------------------------------------------------------------------------------------------
------------------------------------------------------------------------------------------------------------------------------------------------
-------@------------------------------------------------------------------------------@--------------@------------------------------------------
------------------------------------------------------------------------------------------------------------------------------------------------
-----------------------------------------------------------------------------------------------------------------------------SSS!-----@---------
------------------------------------------------------------------------------------------------------------------------------------------------
----!--!--!-----SSS!--------SSS!---------------------------------------------------!--!--!--------!--!--!---------------------------------------
------------------------------------------------------------------------------------------------------------------------------------------------
----SU---C-@S-------------------------C----S-----------S------C-----SU--------S------------------SU---C-----SU---------------C-----!--!--!------
------------------------------------------------------------------------------------------------------------------------------------------------
------------------------------------------------------------------------------------------------------------------------------------------------
-M--------g-----------------k--k-------g-g---------------------g-g-------------------------------------g-g--------------------g-g---k-----------
XXXXXXXXXXXXXXXXXXX-XXXXXXXXXXXXXXXXXXXXXXXXXXXXX--XXXXXXXXXXXXXXXXXXXXX--XXXXXXXXXX--XXXXXXXXXXXXXXXXXXXXXXXXXX--XXXXXXXXXXXXXXXXXXXXXXXX--XXXX
XXXXXXXXXXXXXXXXXXX-XXXXXXXXXXXXXXXXXXXXXXXXXXXXX--XXXXXXXXXXXXXXXXXXXXX--XXXXXXXXXX--XXXXXXXXXXXXXXXXXXXXXXXXXX--XXXXXXXXXXXXXXXXXXXXXXXX--XXXX
