-----------------------------------------------------------------------------------------------------------------------------------
-----------------------------------------------------------------------------------------------------------------------------------
-----------------------------------------------------------------------------------------------------------------------------------
-----------------------------------------------------------------------------------------------------------------------------------
-----------------------------------------------------------------------------------------@-----------------------@-----------------
-----------------------------------------------------------------------------------------------------------------------------------
---------------------------------------------@------------------------------S----@-------------------------------------------------
-----------------------------------------------------------------------------------------------------------------------------------
-----SSS!-----------------------------------------SS----------------------------------!--!--!----------SSS!---!--!--!--------------
-----------------------------------------------------------------------------------------------------------------------------------
---------------S------------SU---------C--!--!------S------SU--------S------C-!--!--!------------!-----------SU---C----------------
-----------------------------------------------------------------------------------------------------------------------------------
---------------------------------------------------------------------------------------XXXXXX--------------------------------------
-M---k----------------------------------g-g---k------------------------------g-g---k---XXXXXXg--------k------------g-g-------------
XXXXXXX--XXXXXXXXXXXXXXXXXXXXXXX--XXXXXXXXXXXXXXXXXXXXXXXXXXXXX--XXXXXXXXXXXXXXXXXXXXXXXXXXXXXXXXXXXXXXXXXXXXXXXXXXXXXX--XXXXXXXXXX
XXXXXXX--XXXXXXXXXXXXXXXXXXXXXXX--XXXXXXXXXXXXXXXXXXXXXXXXXXXXX--XXXXXXXXXXXXXXXXXXXXXXXXXXXXXXXXXXXXXXXXXXXXXXXXXXXXXX--XXXXXXXXXX
