-------------------------------------------------------------------------------------------------------------------------------------
-------------------------------------------------------------------------------------------------------------------------------------
-------------------------------------------------------------------------------------------------------------------------------------
-------------------------------------------------------------------------------------------------------------------------------------
---------------@------------@---------------------------------------------------------@-------------------@--------------------------
-------------------------------------------------------------------------------------------------------------------------------------
---------@-------------------------------------------------------@------------------------------@--------------------SSS!------------
-------------------------------------------------------------------------------------------------------------------------------------
------------!--!--!------!--!--!-------------SSS!----------------------------------!--!--!-------------!--!--!-----------------------
-------------------------------------------------------------------------------------------------------------------------------------
----S-!--!--!----C-----------C----------S--------------SU--S--!--!--!-----------SU-----------!--!--!----------S------C-----SU---C----
-------------------------------------------------------------------------------------------------------------------------------------
-------------------------------------------------------------------------------------------------------------------------------------
-M--------k-------g-g---------g-g---------------k------------------k------------------------------k-------------------g-g--------g-g-
XXXXXXXXXXXXXXXXXXXXXX--XXXXXXXXXXXXXXXXXXXXXXXXXXXXXXXXXXXXXXXXXXXXXXXXXXXXXXXXXXXX--XXXXXXXXXXXXXXXXXX--XXXXXXXXXXXXXXXXXXXXXXXXXXX
XXXXXXXXXXXXXXXXXXXXXX--XXXXXXXXXXXXXXXXXXXXXXXXXXXXXXXXXXXXXXXXXXXXXXXXXXXXXXXXXXXX--XXXXXXXXXXXXXXXXXX--XXXXXXXXXXXXXXXXXXXXXXXXXXX
