--------------------------------------------------------------------------------------------------------------------------------------
--------------------------------------------------------------------------------------------------------------------------------------
--------------------------------------------------------------------------------------------------------------------------------------
--------------------------------------------------------------------------------------------------------------------------------------
---@----------------------------------------------@-----------------@-----------------------------------------------------------------
--------------------------------------------------------------------------------------------------------------------------------------
--------------------@--------SSS!--------@------------------------------------------------------------------------------------SSS!----
--------------------------------------------------------------------------------------------------------------------------------------
!--!--!----------------------------------------!--!--!-----------!----SSS!---------------------------------------SSS!-----------------
--------------------------------------------------------------------------------------------------------------------------------------
----C----S-------!--!--!-----------C--!--!--!----------------SU-----------------SU---------C----------S-------------------S------C----
--------------------------------------------------------------------------------------------------------------------------------------
--------------------------------------------------------------------------------------------------------------------------------------
-M---g-g--------------k-------------g-g---k------------------------------k------------------g-g---------------------k-------------g-g-
XXXXXXXXXXXXXXXXXXXXXXXXXXXX--XXXXXXXXXXXXXXXXXX--XXXXXXXXXXXXXXX--XXXXXXXXXXXXXXXXXXXXXXXXXXXXXXXXXXXXXXXXX--XXXXXXXXXXXXXXXXXXXXXXXX
XXXXXXXXXXXXXXXXXXXXXXXXXXXX--XXXXXXXXXXXXXXXXXX--XXXXXXXXXXXXXXX--XXXXXXXXXXXXXXXXXXXXXXXXXXXXXXXXXXXXXXXXX--XXXXXXXXXXXXXXXXXXXXXXXX
