-----------------------------------------------------------------------------------------------------------------------------------
-----------------------------------------------------------------------------------------------------------------------------------
-----------------------------------------------------------------------------------------------------------------------------------
-----------------------------------------------------------------------------------------------------------------------------------
-------------------------------------@----------------@---------------------------@----------------------------------@-------------
-----------------------------------------------------------------------------------------------------------------------------------
-----------------------------------------@----@---------------------------------------------SSS!----------------------------@------
-----------------------------------------------------------------------------------------------------------------------------------
-----------SSS!-------------------!----------------!--!--!---------------------!--!--!----------------------------!--!-------------
-----------------------------------------------------------------------------------------------------------------------------------
---S-------------------C--------------!--!-!--!--!-----C-----SU--S------SU---------------------C-----------SU--S------C--!--!--!---
-----------------------------------------------------------------------------------------------------------------------------------
--------------------------------------------------------------------------------XXXXXX---------------------------------------------
-M---------k------------g-g---------------k-------------g-g---------------------XXXXXXg---------g-g--------------------g-g---k-----
XXXXXXXXXXXXXXXX--XXXXXXXXXXXXXXXX--XXXXXXXXXXXXXXXXXXXXXXXXXXXXXXXXXXXXXXXXXXXXXXXXXXXX--XXXXXXXXXX--XXXXXXXXXXXXXXXXXXXXXXXXXXXXX
XXXXXXXXXXXXXXXX--XXXXXXXXXXXXXXXX--XXXXXXXXXXXXXXXXXXXXXXXXXXXXXXXXXXXXXXXXXXXXXXXXXXXX--XXXXXXXXXX--XXXXXXXXXXXXXXXXXXXXXXXXXXXXX
