-----------------------------------------------------------------------------------------------------------------------------------------------------------
-----------------------------------------------------------------------------------------------------------------------------------------------------------
-----------------------------------------------------------------------------------------------------------------------------------------------------------
-----------------------------------------------------------------------------------------------------------------------------------------------------------
-------------------------------------@---------------------------------------------------------------------------------------------------------------------
-----------------------------------------------------------------------------------------------------------------------------------------------------------
----------------------------------------------------------SSS!-----------------------------------------------------------------SSS!--------@---------------
-----------------------------------------------------------------------------------------------------------------------------------------------------------
----------------------------------!--!--!-----------------------------------------------------SSS!------------------SSS!-----------------------------------
-----------------------------------------------------------------------------------------------------------------------------------------------------------
----SU---------C----S------SU--S------C----S------SU---------C-----------SU--S------C----S--------------SU---------------------C----S---!--!--!----SU------
-----------------------------------------------------------------------------------------------------------------------------------------------------------
-----------------------------------------------------------------------------------------------------------------------------------------------------------
-M--------------g-g--------------------g-g--------------------g-g--------------------g-g---------k------------------k-----------g-g---------k------------k-
XXXXXXXX--XXXXXXXXXXXXXXXXXXXXXXXXXXXXXXXXXXXXXXXXXXXXXXXXXXXXXXXX--XXXXXXXXXXXXXXXXXXXXXXXXXXXXXXXXXXXXXXXXXXXXXXXXXX--XXXXXXXXXXXXXXXXXXXXXXXXXXXXXXXXXXX
XXXXXXXX--XXXXXXXXXXXXXXXXXXXXXXXXXXXXXXXXXXXXXXXXXXXXXXXXXXXXXXXX--XXXXXXXXXXXXXXXXXXXXXXXXXXXXXXXXXXXXXXXXXXXXXXXXXX--XXXXXXXXXXXXXXXXXXXXXXXXXXXXXXXXXXX
