---------------------------------------------------------------------------------------------------------------------------------------------
---------------------------------------------------------------------------------------------------------------------------------------------
---------------------------------------------------------------------------------------------------------------------------------------------
---------------------------------------------------------------------------------------------------------------------------------------------
----------------------------@-----------------------------------------------------------------------------------@----------------------------
---------------------------------------------------------------------------------------------------------------------------------------------
-------SSS!-------------------------@--------------------------------------------------------------------------------------------------------
---------------------------------------------------------------------------------------------------------------------------------------------
-------------------------!--!--!----------------------------------------------S---SSS!-----------------------!--!--!--------------------SSS!-
---------------------------------------------------------------------------------------------------------------------------------------------
---S------C-------------------C--!--!--!----------SU---------SU---C-----SU--------------------SU---------------------------------------------
---------------------------------------------------------------------------------------------------------------------------------------------
---------------------------------------------------------------------------------------------------------------------------------------------
-M---------g-g---------k-------g-g---k-----------------------------g-g--------k--k------------------------------------------------------k----
XXXXXXXXXXXXXXXXXXXXXXXXXXXXXXXXXXXXXXXXXXXXXXXXXXXXXXXXXXXXXXXXXXXXXXXXXXXXXXXXXXXXXXXXXXXXXXXXXX--XXXXXXXXXX--XXXXXXXXXX--XXXXXXXXXXXXXXXXX
XXXXXXXXXXXXXXXXXXXXXXXXXXXXXXXXXXXXXXXXXXXXXXXXXXXXXXXXXXXXXXXXXXXXXXXXXXXXXXXXXXXXXXXXXXXXXXXXXX--XXXXXXXXXX--XXXXXXXXXX--XXXXXXXXXXXXXXXXX
