-------------------------------------------------------------------------------------------------------------------
-------------------------------------------------------------------------------------------------------------------
-------------------------------------------------------------------------------------------------------------------
-------------------------------------------------------------------------------------------------------------------
-------------------------------------------@-----------------------------------------------------------------------
-------------------------------------------------------------------------------------------------------------------
--------------------------SSS!-----------------@-----------------------------------------------------------@-------
-------------------------------------------------------------------------------------------------------------------
-----SSS!---------SSS!------------------!-----------------------SSS!---------------SSS!----------------------------
-------------------------------------------------------------------------------------------------------------------
@S----------!-----------SU---C----S---------!--!--!----SU---C--------S--------------------C----S------C-!--!--!----
-------------------------------------------------------------------------------------------------------------------
-------------------------------------------------------------------------------------------------------------------
-----------------k------------g-g---------------k------------g-g---k---------------k-------g-g---------g-g---k-----
XXXXXXXX-XXXXXXXXXXXXXXXXXXXXXXXXXXXXXXX--XXXXXXXXXXXXXXXXXXXXXXXXXXXXXXXXXXXXXXXXXXXXXXXXXXXXXXXXXXXXXXXXXXXXXXXXX
XXXXXXXX-XXXXXXXXXXXXXXXXXXXXXXXXXXXXXXX--XXXXXXXXXXXXXXXXXXXXXXXXXXXXXXXXXXXXXXXXXXXXXXXXXXXXXXXXXXXXXXXXXXXXXXXXX
