----------------------------------------------------------------------------------------------------------------------------------------------
----------------------------------------------------------------------------------------------------------------------------------------------
----------------------------------------------------------------------------------------------------------------------------------------------
----------------------------------------------------------------------------------------------------------------------------------------------
------------------------------------------------------------------@-----------@----------------------------------------@----------------------
----------------------------------------------------------------------------------------------------------------------------------------------
-----------------------------------------------------------------------SSS!--------@-------------SSS!-----------------------------------------
----------------------------------------------------------------------------------------------------------------------------------------------
--SSS!--------------------------------SSS!---------------------!--!-----------!-------------------------------------!--!--!-------------------
----------------------------------------------------------------------------------------------------------------------------------------------
------------SU---------SU--------S-------------S------SU--S------------C--------!--!--!---S------C-----SU--------S------C-----SU---------C----
----------------------------------------------------------------------------------------------------------------------------------------------
----------------------------------------------------------------------------------------------------------------------------------------------
-M---k-----------------------------------k------------------------------g-g---------k-------------g-g--------------------g-g--------------g-g-
XXXXXXXXXXXXXXXX--XXXXXXXXX--XXXXXXXXXXXXXXXXXXXXXXXXXXXXXXXXXXX--XXXXXXXXXX--XXXXXXXXXXXXXXXXXXXXXXXXXXXXXXXXXXXXXXXXXXXXXXXXXXXX--XXXXXXXXXX
XXXXXXXXXXXXXXXX--XXXXXXXXX--XXXXXXXXXXXXXXXXXXXXXXXXXXXXXXXXXXX--XXXXXXXXXX--XXXXXXXXXXXXXXXXXXXXXXXXXXXXXXXXXXXXXXXXXXXXXXXXXXXX--XXXXXXXXXX
