----------------------------------------------------------------------------------------------------------------------------------------------------------
----------------------------------------------------------------------------------------------------------------------------------------------------------
----------------------------------------------------------------------------------------------------------------------------------------------------------
----------------------------------------------------------------------------------------------------------------------------------------------------------
-----@-------------------------------@--------------------------------------------------------------------------------------------------------------------
----------------------------------------------------------------------------------------------------------------------------------------------------------
----------------------@----------------------------SSS!--------SSS!----------------------------------@----------------------------------------------------
----------------------------------------------------------------------------------------------------------------------------------------------------------
--!--!--!-------------------------!--!--!-----------------------------------------------------------------SS----------------------------------------------
----------------------------------------------------------------------------------------------------------------------------------------------------------
---------------S---!--!--!---S-----------S------------C----S------C----------S------------SU--S---!--!-------SU--------S------SU---C----S------------C----
----------------------------------------------------------------------------------------------------------------------------------------------------------
----------------------------------------------------------------------------------------------------------------------------------------------------------
-M---------------------k-------------------------------g-g---------g-g--------------------------------k-----------------------------g-g---------------g-g-
XXX--XXXXXXXXXXXXXXXXXXXXXXXXXXXXXX--XXXXXXXXXX--XXXXXXXXXXXXXXXXXXXXXXXXXXXXXXXXXXXXXXXXXXXXXXXXXXXXXXXXXXXXXXXXXXXXXXXXXXXXXXXXXXXXXXXXXXXXXXXXXXXXXXXXX
XXX--XXXXXXXXXXXXXXXXXXXXXXXXXXXXXX--XXXXXXXXXX--XXXXXXXXXXXXXXXXXXXXXXXXXXXXXXXXXXXXXXXXXXXXXXXXXXXXXXXXXXXXXXXXXXXXXXXXXXXXXXXXXXXXXXXXXXXXXXXXXXXXXXXXX
