-------------------------------------------------------------------------------------------------------------------------------
-------------------------------------------------------------------------------------------------------------------------------
-------------------------------------------------------------------------------------------------------------------------------
-------------------------------------------------------------------------------------------------------------------------------
-------------------------------------------------------------------------------------------------------------------------------
-------------------------------------------------------------------------------------------------------------------------------
----SSS!-----------------------------------------SSS!----SSS!---------------------------------------SSS!-----------------------
-------------------------------------------------------------------------------------------------------------------------------
---------------------------SSS!---------------------------------S---SSS!---------SSS!---------------------------------SSS!-----
-------------------------------------------------------------------------------------------------------------------------------
----C-----SU---------SU-------------S------------------SU---C-------------C----------------------------C-----------------------
-------------------------------------------------------------------------------------------------------------------------------
-------------------------------------------------------------------------------------------------------------------------------
-M---g-g-------------------k--k------------------------------g-g---k-------g-g---k--k-------------------g-g--------------k-----
XXXXXXXXXXXXXX--XXXXXXXXXXXXXXXXXXXXXXXXXXXXXXXX--XXXXXXXXXXXXXXXXXXXXXXXXXXXXXXXXXXXXXXXX--XXXXXXXXXXXXXXXXXXXXXXXXXXXXXXXXXXX
XXXXXXXXXXXXXX--XXXXXXXXXXXXXXXXXXXXXXXXXXXXXXXX--XXXXXXXXXXXXXXXXXXXXXXXXXXXXXXXXXXXXXXXX--XXXXXXXXXXXXXXXXXXXXXXXXXXXXXXXXXXX
