-----------------------------------------------------------------------------------------------------------------
-----------------------------------------------------------------------------------------------------------------
-----------------------------------------------------------------------------------------------------------------
-----------------------------------------------------------------------------------------------------------------
------------------------------------------@---------------------------------------------------------@------------
-----------------------------------------------------------------------------------------------------------------
--------@---------------SSS!-------@-----------------@----@------------SSS!--------------------------------------
-----------------------------------------------------------------------------------------------------------------
---------------------------------------!--!--!----------------------------------------------SSS!-!--!--!---------
-----------------------------------------------------------------------------------------------------------------
-!---!--!--S-----------------S--!--!--!-----C--!--!--!-!--!--!----SU---------------SU---C------------------S-----
-----------------------------------------------------------------------------------------------------------------
--------------------------------------------------------------------------------------------------XXXXXX---------
-M---k-------------------------------k-------g-g---k-------k-----------------------------g-g---k--XXXXXX-g-------
XXXXXXXXXXXXXXXXXXXXXXX--XXXXXXXXXXXXXXXXXXXXXXXXXXXXXXXXXXXXXXXXXXXXX--XXXXXXXXXXXXXXXXXXXXXXXXXXXXXXXXXXXXXXXXX
XXXXXXXXXXXXXXXXXXXXXXX--XXXXXXXXXXXXXXXXXXXXXXXXXXXXXXXXXXXXXXXXXXXXX--XXXXXXXXXXXXXXXXXXXXXXXXXXXXXXXXXXXXXXXXX
