-------------------------------------------------------------------------------------------------------------------------------------------------
-------------------------------------------------------------------------------------------------------------------------------------------------
-------------------------------------------------------------------------------------------------------------------------------------------------
-------------------------------------------------------------------------------------------------------------------------------------------------
------------------------------------------------@-----------------@-------------------------------@----------------------------------------------
-------------------------------------------------------------------------------------------------------------------------------------------------
-------SSS!---------------------------------------------------------------------------------@------------------------SSS!-------------------@----
-------------------------------------------------------------------------------------------------------------------------------------------------
---------------------SS----------------------!--!--!-----------!--!----------------------------!--!--!-------------------------------------------
-------------------------------------------------------------------------------------------------------------------------------------------------
---S------C-------------SU--S-----------S------------C-----SU---------SU---C-----------S-!--!--!----C-----------SU---C----S------------S-!--!--!-
-------------------------------------------------------------------------------------------------------------------------------------------------
-------------------------------------------------------------------------------------------------------------------------------------------------
-M---------g-g---k------------------------------------g-g-------------------g-g--------------k-------g-g--------------g-g--------------------k---
XXXXXXXXXXXXXXXXXXXXXXXXXXXXXXXXXX--XXXXXXXXXX--XXXXXXXXXXXXXXX--XXXXXXXXXXXXXXXXXXXXXXXXXXXXXXXXXXXXXXXX--XXXXXXXXXXXXXXXXXXXXX--XXXXXXXXXXXXX--
XXXXXXXXXXXXXXXXXXXXXXXXXXXXXXXXXX--XXXXXXXXXX--XXXXXXXXXXXXXXX--XXXXXXXXXXXXXXXXXXXXXXXXXXXXXXXXXXXXXXXX--XXXXXXXXXXXXXXXXXXXXX--XXXXXXXXXXXXX--
