--------------------------------------------------------------------------------------------------------------------------
--------------------------------------------------------------------------------------------------------------------------
--------------------------------------------------------------------------------------------------------------------------
--------------------------------------------------------------------------------------------------------------------------
--@---------------------------------------@-------------------------------------------------------------------------------
--------------------------------------------------------------------------------------------------------------------------
-------------------@-----------------------------------------SSS!----------SSS!--------SSS!-------------------------------
--------------------------------------------------------------------------------------------------------------------------
--!--!---------------------SSS!--------!--!--!-----------------------------------------------------------SSS!---SSS!------
--------------------------------------------------------------------------------------------------------------------------
----C-----------!--!--!---------------------C-----------SU---------SU---------C----S------C-----SU----------------S-------
--------------------------------------------------------------------------------------------------------------------------
--------------------------------------------------------------------------------------------------------------------------
-M---g-g---k------------------k-------k------g-g-------------------------------g-g---------g-g--------------k--------gg---
XXXXXXXXXXXXXXXXXXXXXXXXXXXXXXXXXXXXXXXXXXXXXXXXX--XXXXXXXXX--XXXXXXXXXXXXXXXXXXXXXXXXXXXXXXXXXXXXXXXXXXXXXXXXXXXXXXXXXXXX
XXXXXXXXXXXXXXXXXXXXXXXXXXXXXXXXXXXXXXXXXXXXXXXXX--XXXXXXXXX--XXXXXXXXXXXXXXXXXXXXXXXXXXXXXXXXXXXXXXXXXXXXXXXXXXXXXXXXXXXX
