-----------------------------------------------------------------------------------------------------------------------------------------------
-----------------------------------------------------------------------------------------------------------------------------------------------
-----------------------------------------------------------------------------------------------------------------------------------------------
-----------------------------------------------------------------------------------------------------------------------------------------------
---------------------------@-------------@------------------------------------------------------@----------------------------------------------
-----------------------------------------------------------------------------------------------------------------------------------------------
---------------------------------------------------@-----------------------------------@------------------@-------------------SSS!-------------
-----------------------------------------------------------------------------------------------------------------------------------------------
------------------------!--!--!-------!--!--!------------------------------------------------!--!--!------------SSS!---------------------------
-----------------------------------------------------------------------------------------------------------------------------------------------
---------S------C----S------C-----SU---------C--!--!--!----SU--S------------SU--S---!--!--!------------!--!--------C-----SU---------C----S-----
-----------------------------------------------------------------------------------------------------------------------------------------------
-----------------------------------------------------------------------------------------------------------------------------------------------
-M---------------g-g---------g-g--------------g-g---k-----------------------------------k-------------------k-------g-g--------------g-g-------
XXXXXXXXXXXXXXXXXXXXXXXXXXXXXXXXXXXXXX--XXXXXXXXXXXXXXXXXXXXXXXXXXXXXXXXXXXXXXXXXXXXXXXXXXXXXX--XXXXXXXXXXXXXXXXXXXXXXXXXXXXX--XXXXXXXXXXXXXXXX
XXXXXXXXXXXXXXXXXXXXXXXXXXXXXXXXXXXXXX--XXXXXXXXXXXXXXXXXXXXXXXXXXXXXXXXXXXXXXXXXXXXXXXXXXXXXX--XXXXXXXXXXXXXXXXXXXXXXXXXXXXX--XXXXXXXXXXXXXXXX
