------------------------------------------------------------------------------------------------------------------------------------------
------------------------------------------------------------------------------------------------------------------------------------------
------------------------------------------------------------------------------------------------------------------------------------------
------------------------------------------------------------------------------------------------------------------------------------------
-------------------------------------------------------------------@---------------------------------------@-------------------------@----
------------------------------------------------------------------------------------------------------------------------------------------
----@-------------@-----------------------------------------------------------------------SSS!--------------------------------------------
------------------------------------------------------------------------------------------------------------------------------------------
------------------------------------------------SSS!----SSS!----!--!--!---------------------------------!--!--!-------------------!--!--!-
------------------------------------------------------------------------------------------------------------------------------------------
-!--!--!-------!--!--!---S------------C--------------------------------S------C----S-----------------S------C-----------------C-----------
------------------------------------------------------------------------------------------------------------------------------------------
------------------------------------------------------------------------------------------------------------------------------------------
-M---k-------------k-------------------g-g---------k-------k-------------------g-g---------------------------g-g---------------g-g--------
XXXXXXXXXXX--XXXXXXXXXXXXXXXXXX--XXXXXXXXXXXXXXXXXXXXXXXXXXXXXXXX--XXXXXXXXXXXXXXXXXXXXXX--XXXXXXXXXXXXXXXXXXXXXXXXXXXX--XXXXXXXXXX--XXXX-
XXXXXXXXXXX--XXXXXXXXXXXXXXXXXX--XXXXXXXXXXXXXXXXXXXXXXXXXXXXXXXX--XXXXXXXXXXXXXXXXXXXXXX--XXXXXXXXXXXXXXXXXXXXXXXXXXXX--XXXXXXXXXX--XXXX-
