------------------------------------------------------------------------------------------------------------------------------------
------------------------------------------------------------------------------------------------------------------------------------
------------------------------------------------------------------------------------------------------------------------------------
------------------------------------------------------------------------------------------------------------------------------------
-----------------------------------------------------------------------@------------------------------------------------------------
------------------------------------------------------------------------------------------------------------------------------------
------------------------------------@---------------------------------------SSS!----------------------------------------------------
------------------------------------------------------------------------------------------------------------------------------------
------------------------------SS----------------------SS---SSS!-----!--!-------------------SSS!------------------------SSS!----SSS!-
------------------------------------------------------------------------------------------------------------------------------------
----SU---------C-----------------!--!---SU--S-------------------------------C-----------------------S------SU-----------------------
------------------------------------------------------------------------------------------------------------------------------------
------------------------------------------------------------------------------------------------------------------------------------
-M--------------g-g--------------k-----------------------k-------------------g-g--------------k------------------------k-------k----
XXXXXXXXXXXXXXXXXXXX--XXXXXXXXXXXXXXXXXXXXXXXXXXXXXXXXXXXXXXXXXXXXXXX--XXXXXXXXXX--XXXXXXXXXXXXXXXXXXXXXXXXXXXXXXXXXXXXXXXXXXXXXX---
XXXXXXXXXXXXXXXXXXXX--XXXXXXXXXXXXXXXXXXXXXXXXXXXXXXXXXXXXXXXXXXXXXXX--XXXXXXXXXX--XXXXXXXXXXXXXXXXXXXXXXXXXXXXXXXXXXXXXXXXXXXXXX---
