-----------------------------------------------------------------------------------------------------------------------------------------------
-----------------------------------------------------------------------------------------------------------------------------------------------
-----------------------------------------------------------------------------------------------------------------------------------------------
-----------------------------------------------------------------------------------------------------------------------------------------------
-----------@------------------------------@------------------------------------------------@--------------------@-----------------@------------
-----------------------------------------------------------------------------------------------------------------------------------------------
----SSS---------@------------------------------------------------------------------------------------------------------------------------------
-----------------------------------------------------------------------------------------------------------------------------------------------
--------!--!---------------------------!--!--!----------------SSS!----------------------!--!-----------------!--!--!-----------!--!--!----SSS!-
-----------------------------------------------------------------------------------------------------------------------------------------------
----C--------!--!--!----SU---------C-----------------SU-----------------------SU---C----------S-----------S------C-----------------C-----------
-----------------------------------------------------------------------------------------------------------------------------------------------
-----------------------------------------------------------------------------------------------------------------------------------------------
-M---g-g---------k------------------g-g--------------------------k------------------g-g---------------------------g-g---------------g-g---k----
XXXXXXXXX--XXXXXXXXXXXXXXXXXXXXXXXXXXXXX--XXXXXXXXXXXXXXXXXXXXXXXXXXXXXXXXXXXXXXXXXXXXXX--XXXXXXXXXXXXXXXXXXXXXXXXXXXXXXXXXX--XXXXXXXXXXXXXX---
XXXXXXXXX--XXXXXXXXXXXXXXXXXXXXXXXXXXXXX--XXXXXXXXXXXXXXXXXXXXXXXXXXXXXXXXXXXXXXXXXXXXXX--XXXXXXXXXXXXXXXXXXXXXXXXXXXXXXXXXX--XXXXXXXXXXXXXX---
