---------------------------------------------------------------------------------------------------------------------
---------------------------------------------------------------------------------------------------------------------
---------------------------------------------------------------------------------------------------------------------
---------------------------------------------------------------------------------------------------------------------
--------------------------------------------@-------------------------@----------------------------------------------
---------------------------------------------------------------------------------------------------------------------
-------------------------@----------------------------------@--------------SSS!--------SSS!-------@-------------@----
---------------------------------------------------------------------------------------------------------------------
--------------------S--------------------!--!----S---SSS-----------!--!-------------------------------SSS!-----------
---------------------------------------------------------------------------------------------------------------------
----C-----------------!--!--!------S---------------------!--!--!-----------C----S------C-------!--!----------!--!--!-
---------------------------------------------------------------------------------------------------------------------
---------------------------------------------------------------------------------------------------------------------
-M---g-g---------------k-------------------------k------k-------------------g-g---------g-g---------k-------------k--
XXXXXXXXX--XXXXXXXXXXXXXXXXXX--XXXXXXXXXX--XXXXXXXXXXXXXXXXXXXXXXXXX--XXXXXXXXXXXXXXXXXXXXXX--XXXXXXXXXXXXXXXXXXXXXX-
XXXXXXXXX--XXXXXXXXXXXXXXXXXX--XXXXXXXXXX--XXXXXXXXXXXXXXXXXXXXXXXXX--XXXXXXXXXXXXXXXXXXXXXX--XXXXXXXXXXXXXXXXXXXXXX-
