-------------------------------------------------------------------------------------------------------------------------------------
-------------------------------------------------------------------------------------------------------------------------------------
-------------------------------------------------------------------------------------------------------------------------------------
-------------------------------------------------------------------------------------------------------------------------------------
---------@---------------------------------------------------@-----------------------------------------------------------------------
-------------------------------------------------------------------------------------------------------------------------------------
----------------@------------------SSS!-----------@-----------------------SSS!----------------SSS!-----------------------------------
-------------------------------------------------------------------------------------------------------------------------------------
------!--!------------------------------------------------!--!--!-----------------------------------------------------------SSS!-----
-------------------------------------------------------------------------------------------------------------------------------------
----------C--!--!--!---S------SU---C-------!---!--!--!-SU---------SU--S------C-----SU---------C----------------S------SU-------------
-------------------------------------------------------------------------------------------------------------------------------------
-------------------------------------------------------------------------------------------------------------------------------------
-M---------g-g---k------------------g-g---------k-----------------------------g-g--------------g-g--------------------------k--k-----
XXX--XXXXXXXXXXXXXXXXXXXXXXXXXXXXXXXXXXXXXXXXXXXXXXXXXXXXXX--XXXXXXXXXXXXXXXXXXXXXXXXXXXXXXXXXXXXXXXXXXXX--XXXXXXXXXXXXXXXXXXXXXXXXXX
XXX--XXXXXXXXXXXXXXXXXXXXXXXXXXXXXXXXXXXXXXXXXXXXXXXXXXXXXX--XXXXXXXXXXXXXXXXXXXXXXXXXXXXXXXXXXXXXXXXXXXX--XXXXXXXXXXXXXXXXXXXXXXXXXX
