----------------------------------------------------------------------------------------------------------------------------------------------
----------------------------------------------------------------------------------------------------------------------------------------------
----------------------------------------------------------------------------------------------------------------------------------------------
----------------------------------------------------------------------------------------------------------------------------------------------
----------------------------------------------------------------------------------------------------------@-----------------------------------
----------------------------------------------------------------------------------------------------------------------------------------------
----------------------SSS!--------SSS!-----------------------@--------------------------SSS!--------------------------------------------------
----------------------------------------------------------------------------------------------------------------------------------------------
-----------------------------------------SSS!----------------------------------------------------------!--!--!-----------------SSS!-----------
----------------------------------------------------------------------------------------------------------------------------------------------
----C----S------------C----S--------------SS!-------SU----!--!--!------------SU---------C-----------SU---------------C-------------------C----
----------------------------------------------------------------------------------------------------------------------------------------------
-------------------------------------tt-------------------------------------------------------------------------------------------------------
-M---g-g---------------g-g-----------tt-------------------k------------------------------g-g--------------------------g-g---------k-------g-g-
XXXXXXXXXXXXXXXXXXXXXXXXXXXXXXXXX--XXXXXXXXXXXXXXXXXXXXXXXXXXXXXXXXXXX--XXXXXXXXX--XXXXXXXXXXXXXXXXXXXXX--XXXXXXXXXXXXXXXXXXXXXXXXXXXXXXXXXXXX
XXXXXXXXXXXXXXXXXXXXXXXXXXXXXXXXX--XXXXXXXXXXXXXXXXXXXXXXXXXXXXXXXXXXX--XXXXXXXXX--XXXXXXXXXXXXXXXXXXXXX--XXXXXXXXXXXXXXXXXXXXXXXXXXXXXXXXXXXX
