-------------------------------------------------------------------------------------------------------------------------------------------
-------------------------------------------------------------------------------------------------------------------------------------------
-------------------------------------------------------------------------------------------------------------------------------------------
-------------------------------------------------------------------------------------------------------------------------------------------
-----@----------------------------@-------------@--------------@--------@------------------------------------------------------------------
-------------------------------------------------------------------------------------------------------------------------------------------
---------------------------SSS---------------------------------------------------------------------------SSS!------------------------------
-------------------------------------------------------------------------------------------------------------------------------------------
--!--!--!----------------------!--!--!-------!--!-----S-----!--!--!--!--!--!---------------------------------------------------------------
-------------------------------------------------------------------------------------------------------------------------------------------
---------S------------SU---C-----------SU---------C-----!--!--!-C-----------------SU---C----------S------C-----SU--S------------C----------
-------------------------------------------------------------------------------------------------------------------------------------------
-------------------------------------------------------------------------------------------------------------------------------------------
-M--------------------------g-g--------------------g-g---k-------g-g--------------------g-g---------------g-g--------------------g-g-------
XXX--XXXXXXXXXX--XXXXXXXXXXXXXXX--XXXXXXXXX--XXXXXXXXXXXXXXXXXXXXXXXX--XXXXXXXXXXXXXXXXXXXXXXXXXXXXXXXXXXXXXXXXXXXXXXXXXX--XXXXXXXXXXXXXXXX
XXX--XXXXXXXXXX--XXXXXXXXXXXXXXX--XXXXXXXXX--XXXXXXXXXXXXXXXXXXXXXXXX--XXXXXXXXXXXXXXXXXXXXXXXXXXXXXXXXXXXXXXXXXXXXXXXXXX--XXXXXXXXXXXXXXXX
