--------------------------------------------------------------------------------------------------------------------------------------------------
--------------------------------------------------------------------------------------------------------------------------------------------------
--------------------------------------------------------------------------------------------------------------------------------------------------
--------------------------------------------------------------------------------------------------------------------------------------------------
-------------------------------------------------------------------------------------------------------------------------@------------------------
--------------------------------------------------------------------------------------------------------------------------------------------------
--------------------------------------------------S----@----@-------------------------------------------------@-----------------------------------
--------------------------------------------------------------------------------------------------------------------------------------------------
--------------------------------------------SSS---------------------------------------------------------SS------------!--!------------------------
--------------------------------------------------------------------------------------------------------------------------------------------------
----------SU---------SU---------SU------------------!--!-!--!---C----------S-----------S-------------------!--!---SU---------SU---------SU--------
--------------------------------------------------------------------------------------------------------------------------------------------------
--------------------------------------------------------------------------------------------------------------------------------------------------
-M------------------------------------------k------------k-------g-g---------------------------------------k--------------------------------------
XXX--XXXXXXXXXXXXXXXXXXXX--XXXXXXXXX--XXXXXXXXXXX--XXXXXXXXXXXXXXXXXXXXXXXXXXXXXXXXXXXXXXXXXXXXXXXX--XXXXXXXXXXXXXXXXX--XXXXXXXXXXXXXXXXXXXXXXXXXX
XXX--XXXXXXXXXXXXXXXXXXXX--XXXXXXXXX--XXXXXXXXXXX--XXXXXXXXXXXXXXXXXXXXXXXXXXXXXXXXXXXXXXXXXXXXXXXX--XXXXXXXXXXXXXXXXX--XXXXXXXXXXXXXXXXXXXXXXXXXX
