-----------------------------------------------------------------------------------------------------------------
-----------------------------------------------------------------------------------------------------------------
-----------------------------------------------------------------------------------------------------------------
-----------------------------------------------------------------------------------------------------------------
-----------------------------------------------------------------------------------@-----------------------------
-----------------------------------------------------------------------------------------------------------------
----------------------@-------------------------------@----@------SSS!------------------------@------------------
-----------------------------------------------------------------------------------------------------------------
---------------------------SSS!-------------------------------------------------!--!----SS---------SSS!-----SSS!-
-----------------------------------------------------------------------------------------------------------------
---S------C--------!--!---------------SU--S--------!--!-!--!---------C---------------------!--!------------------
-----------------------------------------------------------------------------------------------------------------
-----------------------------------------------------------------------------------------------------------------
-M---------g-g---------k--------------------------------k-------------g-g---------------k--k-------------------k-
XXXXXXXXXXXXXXX--XXXXXXXXXXXXXXXXXXXXXXXXXXXXXXX--XXXXXXXXXXXX--XXXXXXXXXXXXXXXX--XXXXXXXXXXXXXXX--XXXXXXXXXXXXXX
XXXXXXXXXXXXXXX--XXXXXXXXXXXXXXXXXXXXXXXXXXXXXXX--XXXXXXXXXXXX--XXXXXXXXXXXXXXXX--XXXXXXXXXXXXXXX--XXXXXXXXXXXXXX
