------------------------------------------------------------------------------------------------------------------------------------------------
------------------------------------------------------------------------------------------------------------------------------------------------
------------------------------------------------------------------------------------------------------------------------------------------------
------------------------------------------------------------------------------------------------------------------------------------------------
--------------------------------------@---------------------------------------------------------------------------------------------------------
------------------------------------------------------------------------------------------------------------------------------------------------
---------------------------------------------------------------------------------------------------------SSS!--------SSS!----------@------------
------------------------------------------------------------------------------------------------------------------------------------------------
--SSS!-----------------------------!--!--!----------------------------------------------------SSS!----------------------------------------------
------------------------------------------------------------------------------------------------------------------------------------------------
------------SU--S------------SU--S------C----------S------SU---------SU--------------S--!-----------SU---C-----------C----------!--!--!---S-----
------------------------------------------------------------------------------------------------------------------------------------------------
------------------------------------------------------------------------------------------------------------------------------------------------
-M---k-----------------------------------g-g-------------------------------------------------k------------g-g---------g-g---k-------k-----------
XXXXXXXXXXXXXXXXXXXXXXXXXXXXXXXXXXXXXXXXXXXXX--XXXXXXXXXXXXXXXXXXXXXXXXXXXXXXXX--XXXXXXXXXXXXXXXXXXXXXXXXXXXXXXXXXXXXXXXXXXXXXXXXXXXXXXXXXXXXXXX
XXXXXXXXXXXXXXXXXXXXXXXXXXXXXXXXXXXXXXXXXXXXX--XXXXXXXXXXXXXXXXXXXXXXXXXXXXXXXX--XXXXXXXXXXXXXXXXXXXXXXXXXXXXXXXXXXXXXXXXXXXXXXXXXXXXXXXXXXXXXXX
