---------------------------------------------------------------------------------------------------------------------------
---------------------------------------------------------------------------------------------------------------------------
---------------------------------------------------------------------------------------------------------------------------
---------------------------------------------------------------------------------------------------------------------------
---------------------------------------------------@-----------------------------------@-----------------------------------
---------------------------------------------------------------------------------------------------------------------------
----@----------------------@--------@-------@------------@---------@----SSS!-----------------------------------------------
---------------------------------------------------------------------------------------------------------------------------
------------------------------------------------!--!--------------------------------!--!--!--------------------------------
---------------------------------------------------------------------------------------------------------------------------
-!--!--!----SU----------!--!--!--!--!--!-!--!--!----C-!--!--!---!--!--!-C-----SU--------------------S------C-----SU--S-----
---------------------------------------------------------------------------------------------------------------------------
-------------------------------------------------------------------------------------XXXXXX--------------------------------
-M---k-----------------------k-------k-------k-------g-g---k-------------g-g---------XXXXXX-g---------------g-g------------
XXXXXXXXXXXXXXXXXXXXXXXXXXXXXXXXXXXXXXXXXXXXXXXXXXXXXXXXXXXXXXXXXXXXXXXXXXXXXXXXXXXXXXXXXXXXXXXXXXXXXXXXXXXXXXXXXXXXXXXXXXX
XXXXXXXXXXXXXXXXXXXXXXXXXXXXXXXXXXXXXXXXXXXXXXXXXXXXXXXXXXXXXXXXXXXXXXXXXXXXXXXXXXXXXXXXXXXXXXXXXXXXXXXXXXXXXXXXXXXXXXXXXXX
