--------------------------------------------------------------------------------------------------------------------------------
--------------------------------------------------------------------------------------------------------------------------------
--------------------------------------------------------------------------------------------------------------------------------
--------------------------------------------------------------------------------------------------------------------------------
-------------------@-------------@-----------@-----------@----------------------------------------------------------------------
--------------------------------------------------------------------------------------------------------------------------------
------SSS!---------------------------------------@---------------------------------------------------@----@---------------------
--------------------------------------------------------------------------------------------------------------------------------
----------------!--!--!-------!--!--!-----!-----------!--!--!---------------------------SSS!------------------------------------
--------------------------------------------------------------------------------------------------------------------------------
----SU---C-----------C-----SU-----------------!--!--!-----------------C----S----------------------!--!-!--!---C-----SU----------
--------------------------------------------------------------------------------------------------------------------------------
-------------------------------------------------------XXXXXX-------------------------------------------------------------------
-M--------g-g---------g-g--------------------------k---XXXXXXg---------g-g---------k-------------------k-------g-g--------k-----
XXXXXXXXXXXXXX--XXXXXXXXXXXXXXX--XXXXXXXXXX--XXXXXXXXXXXXXXXXXX--XXXXXXXXXXXXXXXXXXXXXXXXXXXXXX--XXXXXXXXXXXXXXXXXXXXXXXXXXXXXXX
XXXXXXXXXXXXXX--XXXXXXXXXXXXXXX--XXXXXXXXXX--XXXXXXXXXXXXXXXXXX--XXXXXXXXXXXXXXXXXXXXXXXXXXXXXX--XXXXXXXXXXXXXXXXXXXXXXXXXXXXXXX
