-----------------------------------------------------------------------------------------------------------------------------------------
-----------------------------------------------------------------------------------------------------------------------------------------
---------------------##------------------------------------------------------------------------------------------------------------------
--------------------###--------------------------------------------------@---------------------------------------------------------------
-------------------####------------------------------------------------------------------------------------------------------------------
------------------#####------------------------------------------------------------------------------------------------------------------
----SSS----------##-----------------------------------------------------------------------------------------------------------------S!!S-
-----------@----###---------------------------------------------------!--!--!------------------------------------------------------------
---------------####----------------------------------------------------------------------------------------------------------------------
--------------#####----------------------------------------------------------------------------------------------------------------------
-------------------------!--------------SSS---S-------#----SSS---S--------------------------------tt------------S----------------------SS
--------!--!--!----------------##--#----------------tt##------------------------------------------tt-------------------------------------
------------------------------###--#----------------tt###-----------------------------------------tt------------------------#------------
-M---------------------------------gg--g------------tt####--------------------------------g-------tt-----g---------tt------##------g-g-g-
XXXXXXXXXXXXXXXXXXXXXXXXXX-XXXXXXXXXXXXXXXXXXXXXXXXXXXXXXXXXXXXXXXX-XXXXXXXX-XXXXXXXXXXXXXXXXXXXXXXXXXXXXXXXXXXXXXXXXXXXXXXXXXXXXXXXXXXXX
XXXXXXXXXXXXXXXXXXXXXXXXXX-XXXXXXXXXXXXXXXXXXXXXXXXXXXXXXXXXXXXXXXX-XXXXXXXX-XXXXXXXXXXXXXXXXXXXXXXXXXXXXXXXXXXXXXXXXXXXXXXXXXXXXXXXXXXXX
