---------------------------------------------------------------------------------------------------------------------------------------------------
---------------------------------------------------------------------------------------------------------------------------------------------------
---------------------------------------------------------------------------------------------------------------------------------------------------
---------------------------------------------------------------------------------------------------------------------------------------------------
---------------------------------------------------------------------------------------------------------------------------------------------------
-----------g---------------------------------------------------------------------------------------------------------------------------------------
------------------------------SSS---S--------------------------------------------------------------------------------------------------------------
---------S@S-------------------------------------------------------------------------------g-------------------------------------------------------
---------------------------------------------------------------------------g-----------------------------------------------------------------------
-----------------------------------------------1-----------------------------------------S@S-------------------------------------------------------
-----tt-----------------SU----------------S-----------#----------##------S@S------!-------------------------S-------#-----------#------C----------!
---g-tt----------------------------------------------##---------###------------------------------------------------##---------tt##-----------------
-----####------------------------#-----------------tt##--------####-----------------#####---###-----tt----------tt-##---------tt###----------------
-M--#####-----------------------##-----------------tt##---g----####-----tt----------k-------####----tt----------tt-##---g-----tt####----g-g--------
XXXXXXXXX-XXXXXXXX-XXXXXXXXXXXXXXXXXXXXXXXXXXXXXXXXXXXXXXXXXXXXXXXXXXXXXXXXXXXXXXXXXXXXXXXX-XXXXXXXXXXXXXXXXXXXXXXXXXXXXXXXXXXXXXXXXXXXXXXXXXXXXXXX
XXXXXXXXX-XXXXXXXX-XXXXXXXXXXXXXXXXXXXXXXXXXXXXXXXXXXXXXXXXXXXXXXXXXXXXXXXXXXXXXXXXXXXXXXXX-XXXXXXXXXXXXXXXXXXXXXXXXXXXXXXXXXXXXXXXXXXXXXXXXXXXXXXX
