------------------------------------------------------------------------------------------------------------------------------------------
------------------------------------------------------------------------------------------------------------------------------------------
------------------------------------------------------------------------------------------------------------------------------------------
------------------------------------------------------------------------------------------------------------------------------------------
------------------------------------------------------------------------------------------------------------------------------------------
------------------------------------------------------------------------------------------------------------------------------------------
--------------------------------------------------------------------------------------S!!S---------------------------SSS---S--------------
-------------------------------------------------------g----------------------------------------------------------------------------------
----------##-----------------------------------------SSSSS-----------------g--------------------------------------------------------------
---------###-----------------#-------------------------------------------SSSSSSSS---------------------------------------------------------
----SS!S####---------#------##----------S-SU-------SS----------SS------------------------------S@-SS!S-------------------SS--------#--#---
--------####---------##----###----------------------------------------------------------------------------------------------------##--##--
--------------###----###--####------------------------------------------###-------------------------------------------------------##--###-
-M------------####---#########-----------------g-g-g-------g-g-g--------####-----------------g----------gg-----------g-g-g--------##--####
XXXXXXXXXXXXX-XXXXXXXXXXX---##XXXXXXXXXXXXXXXXXXXXXXXXXXXXXXXXXXXXXXXXX-XXXXXXXXXXXXXXX--XXXXXXXXXXXXXXXXXXXXXXXXXXXXXXXXXXXXXX--XXXXXXXXX
XXXXXXXXXXXXX-XXXXXXXXXXX--###XXXXXXXXXXXXXXXXXXXXXXXXXXXXXXXXXXXXXXXXX-XXXXXXXXXXXXXXX--XXXXXXXXXXXXXXXXXXXXXXXXXXXXXXXXXXXXXX--XXXXXXXXX
