------------------------------------------------------------------------------------------------------------------------------------------------------
------------------------------------------------------------------------------------------------------------------------------------------------------
------------------------------------------------------------------------------------------------------------------------------------------------------
------------------------------------------------------------------------------------------------------------------------------------------------------
------------------------------------------------------------------------------------------------------------------------------------------------------
------------------------------------------------------------------------------------------------------------------------------------------------------
---------------------------------------SSS------------------------------------------------------------------------------------------------------------
------------------#-----------------------------------------------------------------------------------------------------------tt----------------------
-----------------##-----------------------------------------------------------------------------------------------------g-----tt----------------------
----------------###----------tt---------------1------------------------------------------------S!!S---------------------------tt----------------------
--------S---tt-####----------tt----------------C-------------------S-----------S!!S--------------------S--------------S@S----------------------#------
------------tt#####----------tt------------------------SS!S--------------------------------------------------------------------------------g--t##-----
------------tt-----XXXXX---g-tt----------------------------------------####--------------------------------tt----------------------------SSSSSt###----
-M---------k-------XXXXX-----------g------g-----g-g-------------------#####--------------g--g-g-g----------tt---------------------------------t####---
XXXXXXXXXXXXXXXXXX-XXXXXXXXXXXXXXXXXXXXXXXXXXXXXXXXXXXXXXXXXXXXXXXXXXXXXXXX-XXXXXXXXXXXXXXXXXXXXXXXXXXXXXXXXXXXXXX--XXXXXXXXXXX-XXXXXXXXXXXXXXXXXXXXXX
XXXXXXXXXXXXXXXXXX-XXXXXXXXXXXXXXXXXXXXXXXXXXXXXXXXXXXXXXXXXXXXXXXXXXXXXXXX-XXXXXXXXXXXXXXXXXXXXXXXXXXXXXXXXXXXXXX--XXXXXXXXXXX-XXXXXXXXXXXXXXXXXXXXXX
