-------------------------------------------------------#--------------------------------------------------------------
------------------------------------------------------##--------------------------------------------------------------
-----------------------------------------------------###--------------------------------------------------------------
----------------------------------------------------####--------------------------------------------------------------
--------------##--------------------------------##-#####--------------------------------------------------------------
-------------###-------------------------------###----SS---------g----------------------------------------------------
------------####------------------------------####--------------------------------------------------------------------
-----------#####-----------------------------#####-------------S@S----------------------------------------------------
-----g----##--------------------------------#-----g-g-g----------------------------------##---------------------------
---------###------1-------------------1----##XXXXXXXXXXX--------------------------------###------------1--------------
---S@S--####------------------------------###XXXXXXXXXXX------------------!S--SS!S-----####---C-----------------------
-------#####----------------------g------#####-----------------------------------------####---------------------------
----------####------------------SSS---------####-----------------------------------------####--------------tt-----F---
-M----gg-#####-----------------------------#####-----g-------------------------tt-------#####--g-g---------tt-----#---
XXXXXXXXXXXXXX-XXXXXXXX--XXXXXXXXXXXXXXXXXXXXXXX-XXXXXXXXXXX--X-XXXXXXXXXXXXXXXXXXXXXXXXXXXXX-XXXXXXXXXXXXXXXXXX--XXXX
XXXXXXXXXXXXXX-XXXXXXXX--XXXXXXXXXXXXXXXXXXXXXXX-XXXXXXXXXXX--X-XXXXXXXXXXXXXXXXXXXXXXXXXXXXX-XXXXXXXXXXXXXXXXXX--XXXX
