----------------------------------------------------------------------------------------------------------------------------------------------
----------------------------------------------------------------------------------------------------------------------------------------------
----------------------------------------------------------------------------------------------------------------------------------------------
----------------------------------------------------------------------------------------@-----------------------------------------------------
----------------------------------------------------------------------------------------------------------------------------------------------
----------------------------------------------------------------------------------------------------------------------------------------------
------------------##-------SSS--------------------------------------------@-------------------------------------------------------------------
-----------------###-----------------------------------------------------------------!--!--!--------------------------------------------------
----------------####--------------------------------------------------------------------------------------------------------------------------
----------------####--------------------------------------------1------------SSS---S----------------S!!S------------S!!S----------------------
------------SS-------------------------#-----------!-#-----------SU----!--!-------------SSS-----------------------------------SU-------S------
---------------------------------------##-----------##----------------------------------------------------------------------------------------
--------------------------------###----###----------##----------------------------------------tt-------------------------------------------tt-
-M------g-g-g-----------------g-####---####---------##---g-------------k-------tt---g-g-g-----tt---------gg----------tt-----g--------g-----tt-
XXXXXXXXXXXXXXXXXXXXXXXXXXXXXXX-XXXXXXXXXXXXXXXXXXXXXXXXXXXXXXXXXXXXXXXXXXXXXXXXXXXXXXXXXXXXXXXXXXXXXXXXXXXXXXXXXXXXXXXXXXXXXXXXXXXXXXXXXXXXXX
XXXXXXXXXXXXXXXXXXXXXXXXXXXXXXX-XXXXXXXXXXXXXXXXXXXXXXXXXXXXXXXXXXXXXXXXXXXXXXXXXXXXXXXXXXXXXXXXXXXXXXXXXXXXXXXXXXXXXXXXXXXXXXXXXXXXXXXXXXXXXX
