---------------------------------------------------------------------------------------------------------------------------------------------------------------
---------------------------------------------------------------------------------------------------------------------------------------------------------------
---------------------------------------------------------------------------------------------------------------------------------------------------------------
---------------------------------------------------------------------------------------------------------------------------------------------------------------
---------------------------------------------------------------------------------------------------------------------------------------------------------------
---------------------------------------------------------------------------------------------------------------------------------------------------------------
---------------------------------------------------------------------------------------------------------SSS---S-----------!-----------------------------------
------------------------------------------------------------g--------------------------------------------------------------------------------------------------
-----------------------------------------------------------------##--#-----------------------------------------------------------------------------------------
----------------------------------------------------------------###--#-----------------------------------------------------------------------------------------
--------C----------#-------------------------!-tt------------S@S------------------------------S------!-------------------S@S!--------------S-------------------
------------------##---------------------------tt--------------------------------------------------------------------------------------------------------------
------------------##--------###----------------tt----------------------------###-------------------------------------t-------------------------tt--------------
-M-------g-g----g-##---g----####--------------------g-g-g--k--------------g--####----g------------------g------------tt------gg----------------tt-----------g--
XXXXXXXXXXXXXXXXXXXXXXXXXXX-XXXXXXXXXXXXXXXXXXXXXXXXXXXXXXXXXXXXXX-XXXXXXXXX-XXXXXXXXXXXXXXXXXXXXXXXXXXXXXXXXXXX--XXXXXXXXXXXXXXXXXXXXXX--XXXXXXXXXXXXXXXXXXXXX
XXXXXXXXXXXXXXXXXXXXXXXXXXX-XXXXXXXXXXXXXXXXXXXXXXXXXXXXXXXXXXXXXX-XXXXXXXXX-XXXXXXXXXXXXXXXXXXXXXXXXXXXXXXXXXXX--XXXXXXXXXXXXXXXXXXXXXX--XXXXXXXXXXXXXXXXXXXXX
