-----------------------------------------------------------------------------------------------------------------------------------------------------
-----------------------------------------------------------------------------------------------------------------------------------------------------
-----------------------------------------------------------------------------------------------------------------------------------------------------
-----------------------------------------------------------------------------------------------------------------------------------------------------
-----------------------------------------------------------------------------------------------------------------------------------------------------
-----------------------------------------------------------------------------------------------------------------------------------------------------
--------------------------------------------------------S!!S---------------------SSS---S--------SSS--------------------------------------------------
----------------------------------------------------------------------------------------------------------------------SS!S---------------------------
-----------------------------------------------------------------------------------------------------------------------------------------------------
---------------------------------------------------------------------------##----------------------------------------------------------------##------
----------SU----------------SS-----------C------#------#------------------###----------------S----------##--#--------!----SS----------------###------
-----------------------------------------------##------##----------------####--------------------------###--#---------------------------tt-####------
-----------------------------------------------##---tt-###-----###-------####------tt-----------------####------------------------------tt-####------
-M--------------------g-g-g-g-------------g-g--##---tt-####----####----g-----------tt--------------g-#####----gg------g-g-g---------g---tt-----------
XXXXXXX--XXXXXXXXXXXXXXXXXXXXXXXXXXXXXXXXXXXXXXXXXXXXXXXXXXXXX-XXXXXXXXXXXXXXXXXXXXXXXXXXXXXXXXXXXXXXXXXXX-XXXXXXXXXXXXXXXXXXXXXXXXXXXXXXXXXXXXXXXXXX
XXXXXXX--XXXXXXXXXXXXXXXXXXXXXXXXXXXXXXXXXXXXXXXXXXXXXXXXXXXXX-XXXXXXXXXXXXXXXXXXXXXXXXXXXXXXXXXXXXXXXXXXX-XXXXXXXXXXXXXXXXXXXXXXXXXXXXXXXXXXXXXXXXXX
