---------------------------------------------------------------------------------------------------------------------------------------------
---------------------------------------------------------------------------------------------------------------------------------------------
---------------------------------------------------------------------------------------------------------------------------------------------
---------------------------------------------------------------------------------------------------------------------------------------------
---------------------------------------------------------------------------------------------------------------------------------------------
---------------------------------------------------------------------------------------------------------------------------------------------
----------------------------------!------------------------------------------SS--------------------------------------------------------------
---------------------------------------------------------------------SS!S--------------------------------------------------------------------
---------------------------------------------------------------------------------------------------------------------------------------------
------1----------------------------------------------------------------------------------------------------##-------------------------------1
---------------SSS---S------!---S@S!##-----------------g--------C---------------------------------S-##----###--------------------------------
------------------------------------##--tt-----------SSSSSt-----------------------------------------##---####-----------tt-------------------
------------------------------------##--tt----------------t---------------#------###----------------##---####-----------tt-tt----------SS----
-M--------------------------------####--tt-g----k--------tt-g----g-g-----##----g-####----g----------##----k-------------tt-tt--g-------------
XXXXXXXXXXX--XXXXXXXXXXXXXXXXXXXXXXXXXXXXXXXXXXXXXXXXXXXXXXXXXXXXXXXXXXXXXXXXXXX-XXXXXXXXXXXXXXXXXXXXXXXXXXXXXXXXXXX--XXXXXXXXXXXXXXXXXXXXXXX
XXXXXXXXXXX--XXXXXXXXXXXXXXXXXXXXXXXXXXXXXXXXXXXXXXXXXXXXXXXXXXXXXXXXXXXXXXXXXXX-XXXXXXXXXXXXXXXXXXXXXXXXXXXXXXXXXXX--XXXXXXXXXXXXXXXXXXXXXXX
