-----------------------------------------------------------------------------------------------------------------------------------------
-----------------------------------------------------------------------------------------------------------------------------------------
-----------------------------------------------------------------------------------------------------------------------------------------
------------------------------------------------------@----------------------------------------------------------------------------------
-----------------------------------------------------------------------------------------------------------------------------------------
-----------------------------------------------------------------------------------------------------------------------------------------
--------------------------tt-------------------------------------------------------------------------------------------------------------
------------##--#---------tt-----------------------!--!--!-------------------------------------------------------------------------------
-----------###--#---------tt-------------------------------##----------------------------------------------------------------------------
--------####------------g-tt---------------##---##--------###---------------------------tt-----------------------------------------------
--------####----------------------S-------###--###-------####---------------------------tt-----#--------SSS---S-------------------------!
--------####----SS!S----------------tt---####-####-------####---------------------------tt----##-----------------------------------------
--------####------------------------tt---####-####-----------####----------tt-###-----g-tt----##-----------------tt----------------------
-M--------k-------------------------tt-------gg-tt----------#####----------tt-####----------g-##---g-------------tt---g------------------
XXXXXXXXXXXXXXXXXXXXXXXXXXXXXXXXXXXXXXXXXXXXXXXXXXXXX-XXXXXXXXXXX-XXXXXXXXXXX-XXXXXXXXXXXXXXXXXXXXXXXXXXXXXXXXXXXXXXXXXXXXXXXXXXXXXXXXXXX
XXXXXXXXXXXXXXXXXXXXXXXXXXXXXXXXXXXXXXXXXXXXXXXXXXXXX-XXXXXXXXXXX-XXXXXXXXXXX-XXXXXXXXXXXXXXXXXXXXXXXXXXXXXXXXXXXXXXXXXXXXXXXXXXXXXXXXXXX
