------------------------------------------------------------------------------------------------------------------
------------------------------------------------------------------------------------------------------------------
------------------------------------------------------------------------------------------------------------------
-------------------------------------@----------------------------------------------------------------------------
------------------------------------------------------------------------------------------------------------------
------------------------------------------------------------------------------------------------------------------
--SSS---------------------------------------------------------------------------------------------------S!!S------
------------SS!S----------SS!S----!--!--!-------------------------------------------------------------------------
----------------------------------------------------------------------------##--#---------------------------------
---------------------1-##-----------------------------------------SSS------###--#---------------------------------
-----------------------####-------------------------------------------------------------------#----tt-----------SS
-----------------------####-------------------------------tt---------------------------------##----tt-------------
-------#---------------####----#---tt---------------------tt-tt------------------------------##----tt-------------
-M----##----------------------##---tt-----------g---------tt-tt----------------------------g-##--g-tt-------g-g-g-
XXXXXXXXXXXX-XXXXXXXXXXXXXXXXXXXXXXXXXXXXXXXXXXXXXXXXXXXXXXXXXXXXXXXXXXXXXXXXXXXX--XXXX--XXXXXXXXXXXXXXXXXXXXXXXXX
XXXXXXXXXXXX-XXXXXXXXXXXXXXXXXXXXXXXXXXXXXXXXXXXXXXXXXXXXXXXXXXXXXXXXXXXXXXXXXXXX--XXXX--XXXXXXXXXXXXXXXXXXXXXXXXX
