----------------------------------------------------------------------------------------------------------------------------------------------
----------------------------------------------------------------------------------------------------------------------------------------------
----------------------------------------------------------------------------------------------------------------------------------------------
----------------------------------------------------------------------------------------------------------------------------------------------
----------------------------------------------------------------------------------------------------------------------------------------------
-----------------------------------------------------------------------------------------------------------------------S!!S-------------------
----------------------------------!----------------SSS---S!!S---------------------------------------------------------------------------------
-----------!-------------------------------------------------------------------tt-------------------------------------------------------------
-------------------------------------------------------------------------------tt-------------------------------------------------------------
-------------------------------------------------------------------------------tt----##--------------1------------------####------------------
---SU-----------------------!---S@S!------------SS-----SU--------------------#------###-------#------------##-----------#--------------g----S-
---------S@S!----------------------------------------------------------------##----####-----tt##----------###-----------#------------SSSSS----
------------------------------------------tt--------------------#-###-----tt-###---####-----tt###--------####-----------#---------------------
-M-----------------------------------g----ttg-g-g-----g--------##-####----tt-####----tt-----tt####------g####-------------------k-------------
XXXXXXXXXXXXXXXXXXXXXXXXXXXXXXXXXXXXXXXXXXXXXXXXXXXXXXXXXXXXXXXXX-XXXXXXXXXXXXXXXXXXXXXXXXXXXXXXXXXXXXXXXXXXXXXXXXXXXXXXX-XXXXXXXXXXXXXXXXXXXX
XXXXXXXXXXXXXXXXXXXXXXXXXXXXXXXXXXXXXXXXXXXXXXXXXXXXXXXXXXXXXXXXX-XXXXXXXXXXXXXXXXXXXXXXXXXXXXXXXXXXXXXXXXXXXXXXXXXXXXXXX-XXXXXXXXXXXXXXXXXXXX
