-----------------------------------------------------------------------------------------------------------------------------
-----------------------------------------------------------------------------------------------------------------------------
-----------------------------------------------------------------------------------------------------------------------------
---------------------------------------------------------------------!-------------------------------------------------------
-----------------------------------------------------------------------------------------------------------------------------
-----------------------------------------------------------------------------------------------------------------------------
--------------------------------------------------##---##-------------------------@----SSS---S-------------------------------
-------------------------------------------------###--###----------S@S!------------------------------------------------------
------------------------------------------------####-####------------------------------------------------##--#---------------
------------------------------------------------####-####-----------------------------------------------###--#---------1-----
-------------------#--#------SS!S------------------------------------SS--------!--!--!-----SS---SS!S-----####-C--------------
------------------##--##---------------------------------------------------------------------------------####----------------
------------##--#-##--###-------------------##--#--------------tt----------------------------------------####----------------
-M---g-----###--#-##--####-----------------###--#--------------ttg-g-g------g-g-g------g-g-g--k----------####--g-g---------gg
XXXXXXXXXXXXXXXXXXXXXXXXXXXXXXXXXXXXXXXXXXXXXXXXXXX-XXXXXXXXXXXXXXXXXXXXXXXXXXXXXXXXXXXXXXXXXXXXXXXXXXXXXXXXXXXXXXXXXXXXXXXXX
XXXXXXXXXXXXXXXXXXXXXXXXXXXXXXXXXXXXXXXXXXXXXXXXXXX-XXXXXXXXXXXXXXXXXXXXXXXXXXXXXXXXXXXXXXXXXXXXXXXXXXXXXXXXXXXXXXXXXXXXXXXXX
