-------------------------------------------------------------------------------------------------------------------------------------------------------
-------------------------------------------------------------------------------------------------------------------------------------------------------
-------------------------------------------------------------------------------------------------------------------------------------------------------
---------------------------------------------------------------------------@---------------------------------------------------------------------------
-------------------------------------------------------------------------------------------------------------------------------------------------------
-------------------------------------------------------------------------------------------------------------------------------------------------------
----------------------------------------------------------------------------------------------SSS------------------------------------------------------
-----------------------!------------------------------------------------!--!--!---------------------------------SS!S-----------------------------------
----------g--------------------------------------------------------------------------------------------------------------------------------------------
----------------------------------------------S!!S------------1---------------------------------------------------------------------------------g------
--------S@S-----SU-------------------SS----------------------------------------------!-----------------C-----S----------------!-----S------------------
---------------------S@S!---------------------------------------------------------------tt----------------------------------------------------S@S----tt
-------------------------------------------------------------------------------#--------tt-----------tt----------tt-----#----------------------------tt
-M--k----------------------------g-g-g----------------------------------g-----##--------tt-g---------tt-g-g------tt----##---------------g------------tt
XXXXXXXXXXXXXXXXXXXXXXXXXXXXXXXXXXXXXXXXXXXXXXXXXXXXXXXXXXXXXXXXXXXXXXXXXXXXXXXXXXXXXXXXXXXXXXXXXXXXXXXXXXXXXXXXXXXXXXXXXXXXXXXXXXXXXXXXXXXXXXXXXXXXXXX
XXXXXXXXXXXXXXXXXXXXXXXXXXXXXXXXXXXXXXXXXXXXXXXXXXXXXXXXXXXXXXXXXXXXXXXXXXXXXXXXXXXXXXXXXXXXXXXXXXXXXXXXXXXXXXXXXXXXXXXXXXXXXXXXXXXXXXXXXXXXXXXXXXXXXXX
