-------------------------------------------------------------------------------------------------------------------------------
-------------------------------------------------------------------------------------------------------------------------------
-------------------------------------------------------------------------------------------------------------------------------
-------------------------------------------------------------------------------------------------------------------------------
-------------------------------------------------------------------------------------------------------------------------------
-------------------------------------------------------------------------##-------------#--------------------------------------
------------------------------------------------------------------------###------------##--t-----------------------------------
-----------------------------------------------------------------------####-----------###--------------------------------------
-------------------------------------------------------------------##--####-------------#--------------------------------------
S!!S--------------------------------------------------------------###--#----------------#---F----------------------------------
--------------------S!!S---SU-----------------!C----------S-----------------SU--------------#----------------------SU----------
------------------------------------------------------------------XXXXXXXXXX---------------XXXXX-------------------------------
--------------------------------------------------------------tt--XXXXXXXXXX---------------XXXXX------------tt-----------------
-M--------------------------------g-------------g-g-----------tt-----k----------------------k---------------tt-----------------
XXXXXXXXXXXXXXXXXXXXXXXXXXXXXXXXXXXXXXXXXXXXXXXXXXXXXXXX--XXXXXXXXXXXXXXXXXXXXXXXXXXX--XXXXXXXXXXXXXXXXXXXXXXXXXXXXXXXXXXXXX--X
XXXXXXXXXXXXXXXXXXXXXXXXXXXXXXXXXXXXXXXXXXXXXXXXXXXXXXXX--XXXXXXXXXXXXXXXXXXXXXXXXXXX--XXXXXXXXXXXXXXXXXXXXXXXXXXXXXXXXXXXXX--X
