-------------------------------------------------------------------------------------------------------------------------------------------------------------
-------------------------------------------------------------------------------------------------------------------------------------------------------------
-------------------------------------------------------------------------------------------------------------------------------------------------------------
-------------------------------------------------------------------------------------------------------------------------------------------------------------
-------------------------------------------------------------------------------------------------------------------------------------------------------------
-------------------------------------------------------------------------------------------------------------------------------------------------------------
------------##--------------------------------------------@--------------------------------------------------------------------------------------------------
-----------###-------!---------------------------------------------------------------------------------------------------------------------------------------
----------####-----------------------------------------------------------------------------------------------------------------g-----------------------------
----------####-------------------------------------------------------------------------------------------------------------------------------g---------------
--------------------------C----------S-----------------!--!--!-------tt--------!------------------##----SU----SS!S-----------S@S-----------------------------
-----tt------------S@S!----------------------------------------------tt--------------------##--#-###---------------------------------------S@S---------------
-----tt----------------------------------tt--------------------------tt-------------------###--#####-----------------------------------------------####-----#
-M---tt-g------#-----------g-g-----------tt----------------------g-g-tt---------------------g---####-------------g---tt----k------g-g-------------#####----##
XXXXXXXXXXXXXXXXXXXXXXXXXXXXXXXXXXXXXXXXXXXXXXXX--XXXXXXXXXXXXXXXXXXXXXXXXXXXXXXXXXXXXXXXXXXXXXXXXXXXXXXXXXXXXXXXXXXXXXXXXXXXXXXXXXXXXXXXXXXXXXXXXXXXXX-XXXXX
XXXXXXXXXXXXXXXXXXXXXXXXXXXXXXXXXXXXXXXXXXXXXXXX--XXXXXXXXXXXXXXXXXXXXXXXXXXXXXXXXXXXXXXXXXXXXXXXXXXXXXXXXXXXXXXXXXXXXXXXXXXXXXXXXXXXXXXXXXXXXXXXXXXXXX-XXXXX
