-------------------------------------------------------------------------------------------------------------------------------------------
-------------------------------------------------------------------------------------------------------------------------------------------
-------------------------------------------------------------------------------------------------------------------------------------------
-------------------------------------------------------------------------------------------------------------------------------------------
-------------------------------------------------------------------------------------------------------------------------------------------
-------------------------------------------------------------------------------------------------------------------------------------------
------------------------------------------------------------------------------------------------------------@------------------------------
-------------------------------------------------------------------------------------------------------------------------------------------
----------------g---------------##-----------------------S!!S------------------------------------------------------------------------------
--------------SSSSSSSS---------###-------------------------------------------1-----------------------##-----------------------####---------
----#-------------------------####--------------------------------------------------SS!S------------###-----!------!---C------####------#--
---##-------------------------####-----------------------------------------------------------------####-----------------------####-----##--
---##-------------------------------###-------------------####-------------------------------------####-----------------------####-----##--
-M-##---g---------tt----------------####----g----k-------#####------------------g----tt---gg---------------g------------g-g------------##--
XXXXXXXXXXXXXXX--XXXXXXXXXX--XXXXXX-XXXXXXXXXXXXXXXXXXXXXXXXXX-XXXXXXXXXXXXXXXXXXXXXXXXXXXXXXXXXXXXXXXXXXXXXXXXXXXXXXXXXXXXXXXXXXXXXXXXXXXX
XXXXXXXXXXXXXXX--XXXXXXXXXX--XXXXXX-XXXXXXXXXXXXXXXXXXXXXXXXXX-XXXXXXXXXXXXXXXXXXXXXXXXXXXXXXXXXXXXXXXXXXXXXXXXXXXXXXXXXXXXXXXXXXXXXXXXXXXX
