------------------------------------------------------------------------------------------------------------------------------------------
------------------------------------------------------------------------------------------------------------------------------------------
------------------------------------------------------------------------------------------------------------------------------------------
-----------------------------------------!------------------------------------------------------------------------------------------------
------------------------------------------------------------------------------------------------------------------------------------------
-------------------------------------------------------------@----------------------------------------------------------------------------
S!!S--------------------------------------------------------------------------------------------------------------------------------------
-------------------------tt------SS!---S@S!-----------------------------------------------------------------------------------------------
-------------------------tt---------------------------------------------------------------------------------------------------------------
-------------------------tt-------------------------------!--!------------------------------------------------S!!S-----------tt-----------
---------------------------------------------------------------SS!S----------#-------------------------C---------------------tt-----------
----------------------------------------------------------------------------##-----------------------------------------------tt-----------
--------------------tt---------#---------------###-----------#--------------##--------###------------tt--------------------g-tt-----------
-M------------------tt--------##---------------####----g----#####----gg-----##---g----####----g------tt-g-g--------gg------tt-------------
XXXXXXXXXXXXXXXXXXXXXXXXXXXXXXXXXXXXXXXX-XXXXX-XXXXXXXXXXXXXXXXXX-XXXXXXXXXXXXXXXXXXX-XXXXXXXXXXXXXXXXXXXXXXXXXXXXXXXXXXXXXXXXXXXXX--XXXXX
XXXXXXXXXXXXXXXXXXXXXXXXXXXXXXXXXXXXXXXX-XXXXX-XXXXXXXXXXXXXXXXXX-XXXXXXXXXXXXXXXXXXX-XXXXXXXXXXXXXXXXXXXXXXXXXXXXXXXXXXXXXXXXXXXXX--XXXXX
