--------------------------------------------------------------------------------------------------------------------------------------------------
--------------------------------------------------------------------------------------------------------------------------------------------------
--------------------------------------------------------------------------------------------------------------------------------------------------
--------------------------------------------------------------------------------------------------------------------------------------------------
--------------------------------------------------------------------------------------------------------------------------------------------------
--------------------------------------------------------------------------------------------------------------------------------------------------
-------------------SSS---S--------------------------------------------------------------------------------------------------------SSS-------------
--------------------------------------------------------------------------------SS!S--------------------------------------------------------------
----------------------------------------------------------------------------------------------##-------------------------------------------------#
---------------------------------------------------------------------S-----------------------###-----tt--------------------S!!S-----------------##
---S------------tt----------S----------S--##----C------------------------S!!S-------SS------####-----tt----------------S-----------------------###
----------------tt-----------------------###------------------------------------------------####-----tt---------------------------------------####
-------tt-------tt--------------tt---#######------------------###-------------------------------###g-tt--------------------------------------#####
-M-----tt-----------gg----------tt--########-----g-g----------####--------------g-g-g--k-------#####---------------------------------g---------g--
XXXXXXXXXXXXXXXXXXXXXX-XXXXXXXXXXXXXXXXXX-XXXXXXXXXXXXXXXX--X-XXXXXXXXXXXXXXXXXXXXXXXXXXXXXXXXXXXXXX-XXXXXXXXXXXXXXX--XXXXXXXXXXXXXXXXXXXXXXXXXXXX
XXXXXXXXXXXXXXXXXXXXXX-XXXXXXXXXXXXXXXXXX-XXXXXXXXXXXXXXXX--X-XXXXXXXXXXXXXXXXXXXXXXXXXXXXXXXXXXXXXX-XXXXXXXXXXXXXXX--XXXXXXXXXXXXXXXXXXXXXXXXXXXX
