-------------------------------------------------------------------------------------------------------------------------------------
-------------------------------------------------------------------------------------------------------------------------------------
-------------------------------------------------------------------------------------------------------------------------------------
-------------------------------------------------------------------------------------------------------------------------------------
-------------------------------------------------------------------------------------------------------------------------------------
-------------------------------------------------------------------------------------------------------------------------------------
-----------------------------------------------------------------------------------------------------SSS-----------------------------
----------------------------------------------------SS!S-----------------------------------------------------------------------------
-----------------------------------------##------------------------------------------------------------------------------------------
----------------------------------------###--------------------##----------------S!!------------------------##-----------------------
--------!----------------tt----##------####-------------------###----SS!S----------------S-----------------###-----------------------
------------------##--#--tt---###------####------------------####-----------------------------------------####------------##--#------
----------###----###--#--tt--####----------####-------------#####----------------------------tt-----------####-----------###----####-
-M--------####------------g--####---------#####------------##-------tt-----g-----g-----------tt--------------------------------#####-
XXXXXXXXX-XXXXXXXXXXXXXXXXXXXXXXXXXXXXXXXXXXXXX-XXXXXXXXXXXXXXXXXXXXXXXXXXXXXXXXXXXXXXXXXXXXXXXXXXXXXXXXXXXXXXXXXXXXXXXXXXXXXXXXXXXX-
XXXXXXXXX-XXXXXXXXXXXXXXXXXXXXXXXXXXXXXXXXXXXXX-XXXXXXXXXXXXXXXXXXXXXXXXXXXXXXXXXXXXXXXXXXXXXXXXXXXXXXXXXXXXXXXXXXXXXXXXXXXXXXXXXXXX-
