----------------------------------------------------------------------------------------------------------------------------------------------
----------------------------------------------------------------------------------------------------------------------------------------------
----------------------------------------------------------------------------------------------------------------------------------------------
----------------------------------------------------------------------------------------------------------------------------------------------
----------------------------------------------------------------------------------------------------------------------------------------------
------------------------------------------------------------------------------------------SSS---S---------------------------------------------
----------------------------------------------------------------------------------------------------------------------------------------------
-------------------------------g--------------------------------------------------------------------------------------------------------------
----------------------------------------------------------------------------------------------------------------------------------------------
-----------------------------S@S-----------------------------------------------------##------------------------------------------------1------
-----------------------------------SU----#--------------#--------#--#-----tt--------###-------------------#------------------S--------------SS
-----tt---------------------------------##-------------##-------##--##----tt-------####------##--#-------##---------##------------------------
-----tt-------------------tt--####------##-------------##-------##--###---tt-------####-----###--#-------##--------###-----tt----tt-----------
-M---tt-g------------g----tt-#####------##---g---------##-------##--####g-tt--------------gg-tt----------##----------------tt----tt-----g-g-g-
XXXXXXXXXXXXXXXX--XXXXXXXXXXXXXXXX-XXXXXXXXXXXXXXXXXXXXXXXXXXXXXXXXXXXXX----ggXXXXXXXXXXXXXXXXXXXXXXXX--XXXXXXXXXXXXXXXXXXXXXXXXXXXXXXXXXXXXXX
XXXXXXXXXXXXXXXX--XXXXXXXXXXXXXXXX-XXXXXXXXXXXXXXXXXXXXXXXXXXXXXXXXXXXXX-XXXXXXXXXXXXXXXXXXXXXXXXXXXXX--XXXXXXXXXXXXXXXXXXXXXXXXXXXXXXXXXXXXXX
