---------------------------------------------------------------------------------------------------------------------------------------------------
---------------------------------------------------------------------------------------------------------------------------------------------------
---------------------------------------------------------------------------------------------------------------------------------------------------
---------------------------------------------------------------------------------------------------------------------------------------------------
---------------------------------------------------------------------------------------------------------------------------------------------------
---------------------------------------------------------------------------------------------------------------------------------------------------
--------SSS---S----------------------------------------------------------@-------------------------------------------------------------------------
---------------------------------------------------------------------------------------------------------------------------------------------------
----------------------------------------------------------------g----------------------------------------------------g-----------------------------
-------------------------------------------------------------------------------------------------------------------SSSSSSSS-----------------------1
------------------SS--------------S--#---tt-------------------S@S-----!--!---------------------SSS------------S-----------------!-----S------------
------------------------------------##---tt--------------------------------------SS!S--------------------------------------------------------------
------------------------------------##---tt------------tt-----------------------------------tt----------#------------------------------------------
-M------------g-g-g---g-------------##-----------g-----tt---------gg----g-------------------tt---------##-----------------------------------g------
XXXXXXXXXXXX--XXXXXXXXXXXXX--XXXXXXXXXXXXXXXXXXXXXXXXXXXXXXXXXXXXXXXXXXXXXXXXX--XXXXXXXXXXXXXXXXXXXXXXXXXXXXXXXXXXXXXXXXXXXXXXXXXXXXXXXXXXXXXXXXXXX
XXXXXXXXXXXX--XXXXXXXXXXXXX--XXXXXXXXXXXXXXXXXXXXXXXXXXXXXXXXXXXXXXXXXXXXXXXXX--XXXXXXXXXXXXXXXXXXXXXXXXXXXXXXXXXXXXXXXXXXXXXXXXXXXXXXXXXXXXXXXXXXX
