--------------------------------------------------------------------------------------------------------------------------------------------------------
--------------------------------------------------------------------------------------------------------------------------------------------------------
--------------------------------------------------------------------------------------------------------------------------------------------------------
--------------------------------------------------------------------------------------------------------------------------------------------------------
--------------------------------------------------------------------------------------------------------------------------------------------------------
--------------------------------g-----------------------------------------------------------------------------------------------------------------------
---------------------------------------------SSS--------------------------------------------------------------------------------------------------------
------------------------------S@S-----------------------------------------------------------------------------------------------------------------------
--------------------------------------------------------##--#-------------------------------------------------------------------------------------------
-------------------------------------------------------###--#------------------------------1------------------------------------------------------------
-------SS------------------------------------------##------------SS!S--------------------------------SU---C----------S--#--------------------------!----
-----------tt--------SS!S-------------------------###-----------------------------------------tt-----------------------##-----------------------------tt
-----------tt------------------------------#-----####---------#-----------------tt------------tt-----------------------##-----------------------------tt
-M-g-g-g---tt-g--------------g------------##----g####--------##--------gg--g----tt------------tt-----------g-g---------##---g----------k--------------tt
XXXXXXXXXXXXXXXXXXXXXXXXXXXXXXXXXXXXX--XXXXXXXXXXXXXXXXXXXXXXXXXXXXXXXXXXXXXXXXXXX-XXXXXXXXXXXXXXXXXXXXXXXXXXXXXXXXXXXXXXXXXXXXXXXXXXXXXXXXXXXXXXXXXXXXX
XXXXXXXXXXXXXXXXXXXXXXXXXXXXXXXXXXXXX--XXXXXXXXXXXXXXXXXXXXXXXXXXXXXXXXXXXXXXXXXXX-XXXXXXXXXXXXXXXXXXXXXXXXXXXXXXXXXXXXXXXXXXXXXXXXXXXXXXXXXXXXXXXXXXXXX
