-------------------------------------------------------------------------------------------------------------------------------
-------------------------------------------------------------------------------------------------------------------------------
-------------------------------------------------------------------------------------------------------------------------------
------------------------------------------------------------------------------------------!------------------------------------
-------------------------------------------------------------------------------------------------------------------------------
-------------------------------------------------------------------------------------------------------------------------------
-------S!!S----------------S!!-----------------------------------------------------------------------------------SSS-----------
----------------------------------------------------------------------------------------S--------------------------------------
------------------------------------------------------------SSS---S-------------#--------------------###-----------------------
----------------------g---------tt---------------------------------------------##--------------------###-----------------------
--------!-----------------------tt----------------------!SU----------S--------###--------------------###------S----------------
--------------------S@S---------tt-------------------------------------------####------------##--#---####----------------------
------------------------------g-tt------------------------------####-----tt-#####----tt-----###--#--####------------------XXX--
-M----------------------------------------------g--------------#####-----tt--tt------tt------tt----#####------------g-----XXX--
XXXXXXXXX-XXXXXXXXXXXXXXXXXXXX--XXXXXXXXX--XXXXXXXXXXXXXXXXXXXXXXXXX-XXXXXXXXXXXXXXXXXXXXX--XXXXXXXXXXXX-XXXXXXXXXXXXXXXXX-----
XXXXXXXXX-XXXXXXXXXXXXXXXXXXXX--XXXXXXXXX--XXXXXXXXXXXXXXXXXXXXXXXXX-XXXXXXXXXXXXXXXXXXXXX--XXXXXXXXXXXX-XXXXXXXXXXXXXXXXX-----
