----------------------------------------------------------------------------------------------------------------------------------------
----------------------------------------------------------------------------------------------------------------------------------------
----------------------------------------------------------------------------------------------------------------------------------------
--------------------------------------------------------------------------@-------------------------------------------------------------
----------------------------------------------------------------------------------------------------------------------------------------
----------------------------------------------------------------------------------------------------------------------------------------
---------------------------------------------------SSS---S--------------------------------------------SSS---S-----------------S!!S------
-----------------------g-----------------------------------------------!--!--!----------------------------------------------------------
---------------------SSSSSSSS---S-------------------------------------------------------------------------------------------------------
-------------------------------------------------S!-------------------------------------------------------------------------------------
--------S-----S-----------------------------------------------SS-----!------------------!------tt--C----------------S-SU-------------#--
-------------------##--#-----------------------------------------------------------------------tt-----------------------------------##--
------------------###--#---####-----tt---------------------------------------------------------tt-----------------------------------##--
-M------------g---k-------#####-----tt---g----------------g-g-g---------g------------------g-g-tt---g-g-----------------------------##--
XXXXXXXXXXXXXXXXXXXXXXXXXXXXXXX-XXXXXXXXXXXXXXXXXXXXXXXXXXXXXXXXXXXXXXXXXXXXXXXXXXXXXXXXXXXXXXXXXXXXXXXXX-XXXXXXXXXXXXXXXXXXXXXXXXXXXXXX
XXXXXXXXXXXXXXXXXXXXXXXXXXXXXXX-XXXXXXXXXXXXXXXXXXXXXXXXXXXXXXXXXXXXXXXXXXXXXXXXXXXXXXXXXXXXXXXXXXXXXXXXX-XXXXXXXXXXXXXXXXXXXXXXXXXXXXXX
