---------------------------------------------------------------------------------------------------------------------------------------
---------------------------------------------------------------------------------------------------------------------------------------
---------------------------------------------------------------------------------------------------------------------------------------
---------------------------------------------------------------------------------------------------------------------------------------
---------------------------------------------------------------------------------------------------------------------------------------
--------------------------------!------------------------------------------------------------------------------------------------------
-----------------------------------------------------------------------------------------------!-----------------------------------tt--
----------------------------------------------------------------------SS!S---------------------------------------------------------tt--
-----------------##------------------------------------------------------------SSS---S---------------------------------------------tt--
----------------###-----------S@S!----------------tt-----------##------------S!--------------------------------------------------g-tt--
---SU--SS!S---------------------------------------tt----------###------SS--------------------S@S!------C-----SU--------S-----#---####--
--------------------------------------------------tt---------####----------------------------------------------------------tt##--####--
-------------------------##--#----###-----------g-tt-----tt--####--------------------###-----------------------------------tt###-####--
-M----------------------###--#----####----g----k---------tt-k------g-g-g-----k-------####---------------g-g----------------tt########--
XXXXXXXXXXXXXXXXXXX--XXXXXXXXXXXX-XXXXXXXXXXXXXXXXXXXXXXXXXXXXXXXXXXXXXXXXXXXXXXXXXX-XXXXXXXXXXXXXXXXXXXXXXXXXXXXXXXXXXXXXXXXXXXX------
XXXXXXXXXXXXXXXXXXX--XXXXXXXXXXXX-XXXXXXXXXXXXXXXXXXXXXXXXXXXXXXXXXXXXXXXXXXXXXXXXXX-XXXXXXXXXXXXXXXXXXXXXXXXXXXXXXXXXXXXXXXXXXXX------
