---------------------------------------------------------------------------------------------------------------------------------------------------------------
---------------------------------------------------------------------------------------------------------------------------------------------------------------
---------------------------------------------------------------------------------------------------------------------------------------------------------------
---------------------------------------------------------------------------------------------------------------------------------------------------------------
---------------------------------------------------------------------------------------------------------------------------------------------------------------
---------------------------------------------------------------------------------------g-----------------------------------------------------------------------
---------------------------------------------------------------------------------------------------------------------------------------------------------------
---------------------------------------------------------------------------tt--------S@S-----------------------------------------------------------------------
---------------------------------------------------------------------------tt----------------------------------------------------------------##----------------
---------------------1-----------------------------------------------------tt---------------------------------------------------------------###----------------
-------------SU------------------------S----------------S----------------#-------------------#-----!S------------------------------------SS####----------------
--------------------------SS!S-------------------------------------------##-----------------##----------------------------tt---------------####----------------
-------------------------------------------------tt---------------###----###---------------###----------tt----------------tt-tt--------------####-------###----
-M---------g-------------------------------------tt---------------####---####--------------###----------tt-----------g----tt-tt------g-g-g--#####----gg-####---
XXXXXXXXXXXXXXXXXXXXXXXXXXXXXXXXXXXXXXXXXXXXXXXXXXXXXXXXXXXXXX--X-XXXXXXXXXXXXXXXXXXX-XXXXXXXXXXXXXXXXXXXXXXXXXXXXXXXXXXXXXXXXXXXXXXXXXXXXXXXXXXX-XXXXX-XXXXXXX
XXXXXXXXXXXXXXXXXXXXXXXXXXXXXXXXXXXXXXXXXXXXXXXXXXXXXXXXXXXXXX--X-XXXXXXXXXXXXXXXXXXX-XXXXXXXXXXXXXXXXXXXXXXXXXXXXXXXXXXXXXXXXXXXXXXXXXXXXXXXXXXX-XXXXX-XXXXXXX
