---------------------------------------------------------------------------------------------------------------------------------------------
---------------------------------------------------------------------------------------------------------------------------------------------
---------------------------------------------------------------------------------------------------------------------------------------------
---------------------------------------------------------------------------------------------------------------------------------------------
---------------------------------------------------------------------------------------------------------------------------------------------
------------------------------------------------------------------------------------------------------g--------------------------------------
---------------------------------------------------------------------------------------------------------------------------------------------
--------------------tt------------------------------------------------------------------------------S@S-------g------------------------------
--------------------tt--------------------------------------------------------------------------------------SSSSS------##--#-----------------
--------------------tt------1--------1------------------------------------------------#-------------------------------###--#-####------------
--------------------------------------SU----------------------------------#----------##---------!----------------SS----------####------------
-----------##--#-----------------------------tt--------------------------##---------###--------------------------------------####------------
----------###--#----------------tt-----------tt-----------##--#----------##--------####------------------#-------------------####------------
-M--------k---------------------tt-----------tt----------###--#----------##---g---#####-----------------##---g-g-g------------gg----------g--
XXXXXXXXXXXXXXXXXXXXXXXXXXXXXXXXXXXXXXXXXXXXXXXXXXXXXXXXXXXXXXXXXXXXXX--XXXXXXXXXXXXXXXXXXXXXXXXXXXXXXXXXXXXXXXXXXXXXXXXX--XXXXX-XXXXXXXXXXXX
XXXXXXXXXXXXXXXXXXXXXXXXXXXXXXXXXXXXXXXXXXXXXXXXXXXXXXXXXXXXXXXXXXXXXX--XXXXXXXXXXXXXXXXXXXXXXXXXXXXXXXXXXXXXXXXXXXXXXXXX--XXXXX-XXXXXXXXXXXX
