---------------------------------------------------------------------------------------------------------------------------------------------------------
---------------------------------------------------------------------------------------------------------------------------------------------------------
---------------------------------------------------------------------------------------------------------------------------------------------------------
---------------------------------------------------------------------------------------------------------------------------------------------------------
---------------------------------------------------------------------------------------------------------------------------------------------------------
------------------g-------------------------#------------------------------------------------------------------------------------------------------------
-------------------------------------------##------------------------------------------------------------------------------------------------------------
----------------S@S-----------------------###------------------------------------------------------------------------------------------------------------
-----------------------------------------####-----------------------------##--#--SSS---S------------------------------------##--#----------------S!!S----
----------------------------1-----------#####----------------------------###--#--------------------------------------------###--#------------------------
----------------------------------S-S-----------------#---------------------SS----------------##---SU---------------#---####---------------S-------------
-----------------------------------------------------##--------------------------------------###--------------------##--####-----------------------------
----------------------------------------tt-----#-----##---------------------------#--####---####---------###-----tt-###-####--------------------tt--####-
-M-----g--------------------------------tt----##-----##---g-------------g-g-g----##-#####---####---------####----tt-########--------------------tt-#####-
XXXXXXXXXXXXXX--XXXXXXXXXXXXXXXXXXXXXXXXXXXXXXXXXXX--XXXXXXXXXXXXXXXXXXXXXXXXXXXXXXXXXXXX-XXXXXXXXXXXXXX-XXXXXXXXXXXXXXX------XXXXXXXXXXXXXXXXXXXXXXXXXX-
XXXXXXXXXXXXXX--XXXXXXXXXXXXXXXXXXXXXXXXXXXXXXXXXXX--XXXXXXXXXXXXXXXXXXXXXXXXXXXXXXXXXXXX-XXXXXXXXXXXXXX-XXXXXXXXXXXXXXX------XXXXXXXXXXXXXXXXXXXXXXXXXX-
