--------------------------------------------------------------------------------------------------------------------------------------------
--------------------------------------------------------------------------------------------------------------------------------------------
--------------------------------------------------------------------------------------------------------------------------------------------
--------------------------------------------------------------------------------------------------------------------------------------------
-------------------------------------------------------------------------------------g------------------------------------------------------
----------------------------------SSS---S--------------------------S!!S-------------------------------------------------------------!-------
-----------------------------------------------------------------------------------S@S------------------------------------------------------
--------------------------------------------------------------------------------------------------------------------------------------------
-------------------------------------------------------------------------------------------------------------1------------------------------
-------------------------------------------SS!S--------------------------------------------SS!S-----tt----------------------------S@S!------
-------------------------------------------------------------!--!--!--------------------------------tt-----------------------tt-------------
--------------##--#----------------------------------#----------------------------------#-----------tt-----------------------tt-------------
-------------###--#----------------------##---------##-k-------------------------------##-tt------------gg-------------------tt-g-----------
-M-----------XXXXXXXXXXXXXXXXXXXXXXX--XXXXXXXXXXXXXXXXXXXXXXXXXXXXXXXXXXXXX--XXXXXXXXXXXXXXXXXXXXXXXXXXXXXXXXXXXXXXXXXXX--XXXXXXXXXXXXXXXXXX
XXXXXXXXXXXXXXXXXXXXXXXXXXXXXXXXXXXX--XXXXXXXXXXXXXXXXXXXXXXXXXXXXXXXXXXXXX--XXXXXXXXXXXXXXXXXXXXXXXXXXXXXXXXXXXXXXXXXXX--XXXXXXXXXXXXXXXXXX
XXXXXXXXXXXXXX------------------------------------------------------------------------------------------------------------------------------
