---------------------------------------------------------------------------------------------------------------------------------------------------------
---------------------------------------------------------------------------------------------------------------------------------------------------------
---------------------------------------------------------------------------------------------------------------------------------------------------------
---------------------------------------------------------------------------------------------------------------------------------------------------------
---------------------------------------------------------------------------------------------------------------------------------------------------------
---------------------------------------------------------------------------------------------------------------------------------------------------------
-------------------------------------------------------------------------------------------------------S!!S-----SS--tt-----------------------------------
-----------------------------------------------------------------S--------------------------------------------------tt-----------------------------------
------------------------------------------------------------------SSS---S-------------------------------------------tt-----------------------------------
--------------------------------------------------------------------------------------------#---------------------g-tt---------------------------1-------
-----------#-----tt-----------#------------!-------------------------------------#--#------##--------------------------SU---C----------!-----------------
-----------##----tt----------##-------------------------------------------------##--##----###-----------##--#--------------------------------------------
----###----###---tt----------##-------------------###-----------------####------##--###--####----------###--#-#------------------------------------------
-M--####---####g-tt----------##---g---------------####--------g-g-g--#####------##--#########------k---------##----g---------g-g-------------------------
XXX-XXXXXXXXXXXXXXXXXXXXXX--XXXXXXXXXXXXXXXXXXXXX-XXXXXXXXXXXXXXXXXXXXXXXX-XXX--XXXXXXXX-----XXXXXXXXXXXXXXXXXXXXXXXXXXXXXXXXXXXXXXXXXXXXXXXXXXXXXXXXX--X
XXX-XXXXXXXXXXXXXXXXXXXXXX--XXXXXXXXXXXXXXXXXXXXX-XXXXXXXXXXXXXXXXXXXXXXXX-XXX--XXXXXXXX-----XXXXXXXXXXXXXXXXXXXXXXXXXXXXXXXXXXXXXXXXXXXXXXXXXXXXXXXXX--X
