----------------------------------------------------------------------------------------------------------------------------------------------------
----------------------------------------------------------------------------------------------------------------------------------------------------
----------------------------------------------------------------------------------------------------------------------------------------------------
--------------------------------------------@------------------------@------------------------------------------------------------------------------
----------------------------------------------------------------------------------------------------------------------------------------------------
----------------------------------------------------------------------------------------------------------------------------------------------------
------------------------------------------------------------------------------------------------------------------SSS------------------##-----------
-----------------------------------------!--!---------------------------!------------SS!S---------------------------------------------###-----------
-------------------------------------------------------------------------------------------------------------------------------------####-----------
-----------------####----------------------------------------------------------------------------------------------------------------####-----------
--------S------!-####SU--------!S--------------SS!S----SU----------g------SU---S-------------------------S-C---------------------S------------------
-----------------####--------------------------------------------SSSSS-----------------------tt------------------------------------------------##--#
-----------------####---------------tt-----#---------------------------------------tt-----#--tt---------------------------------------tt------###--#
-M----------------------------------tt----##----k----------------------------------tt----##--tt-g-----------g-g------g----------------tt-------tt---
XXXXXXXXXXXXXXXXXXXXXXXXXXXXXXXXXXXXXXXXXXXXXXXXXXXXXXXXXXXXXXXXXXXX-XXXXXXXXXXXXXXXXXXXXXXXXXXXXXXXXXXXXXXXXXXXXXXXXXXXXXXXXXXXXXXXXXXX-XXXXXXXXXXX
XXXXXXXXXXXXXXXXXXXXXXXXXXXXXXXXXXXXXXXXXXXXXXXXXXXXXXXXXXXXXXXXXXXX-XXXXXXXXXXXXXXXXXXXXXXXXXXXXXXXXXXXXXXXXXXXXXXXXXXXXXXXXXXXXXXXXXXX-XXXXXXXXXXX
