-----------------------------------------------------------------------------------------------------------------------------------------
-----------------------------------------------------------------------------------------------------------------------------------------
-----------------------------------------------------------------------------------------------------------------------------------------
-----------------------------------------------------------------------------------------------------------------------------------------
-----------------------------------------------------------------------------------------------------------------------------------------
-----------------------------------------------------------------------------------------------------------------------------------------
-----------------------------------------##----------------------------------------------------------------S!!S--------------------------
----------------------------------------###-------------------------------------------------tt-------------------------------------------
---------------------------------------####-------------------------------------------------tt-----------------------SS------------------
----------------1----------------------####----------------------------------------##-------tt----SS!S-----------------------------1-----
-----------------S---------------------#XXXXXXXXX-------------------S-------------###----------------------------------------------------
---------------------------------------#XXXXXXXXX--------------------------------####----------------------------------------------------
---------------------tt------------------####------------------------------------####--------------####-----#----------------------------
-M---------gg--------tt--------------g--#####--g-g-----------g-----------------g--k---------------#####----##-----------g-----g----------
XXXXXX--XXXXXXXXXXXXXXXXXXXXXXXXX--XXXXXXXXXX-XXXXXXXXXX--XXXXXXXXXXXXXXXX--XXXXXXXXXXXXXXXX--XXXXXXXXX-XXXXX-XXXXXXXXXXXXXXXXXXXXXXXXXXX
XXXXXX--XXXXXXXXXXXXXXXXXXXXXXXXX--XXXXXXXXXX-XXXXXXXXXX--XXXXXXXXXXXXXXXX--XXXXXXXXXXXXXXXX--XXXXXXXXX-XXXXX-XXXXXXXXXXXXXXXXXXXXXXXXXXX
