---------------------------------------------------------------------------------------------------------------------
---------------------------------------------------------------------------------------##----------------------------
--------------------------------------------------------------------------------------###----------------------------
-------------------------------------------------------------------------------------####----------------------------
-------------------------------------------------------------------------------------####----------------------------
----------------------------------------------------------------------------###--------------------------------------
----------------------------------------------------------------------------###-----!--------------------------------
----------------------------------g--------------------SS!S---------g-------###--------------------------------------
------------------g-------------SSSSS-----------------------------SSSSS-----###----------------g---------------------
-----------------------------------------------------------------------------gg--------X-----------------------------
---S------------S@S-----------SS--------!----##---------------------------XXXXXXXXXXX--X-----S@S-----------------#---
--------------------------------------------###---------------------------XXXXXXXXXXX---------------------------##--S
-------tt----------------------------------####----tt---------------#------------#------------------------------##---
-M-----tt---g--tt---------g-g-g-----------#####----tt--------------##----------g---------g-g--------------------##---
XXXXXXXXXXXXXXXXXXXXXXXXXXXXXXXXXXXXXXXXXXXXXXX-XXXXXXXXXX-XXXXXXXXXXXXXXXXXXXXXXX-XXXXXXXXXXXXXXXXXXXX--XXXXXXXXXXX-
XXXXXXXXXXXXXXXXXXXXXXXXXXXXXXXXXXXXXXXXXXXXXXX-XXXXXXXXXX-XXXXXXXXXXXXXXXXXXXXXXX-XXXXXXXXXXXXXXXXXXXX--XXXXXXXXXXX-
