-----------------------------------------------------------------------------------------------------------------------------------
-----------------------------------------------------------------------------------------------------------------------------------
-----------------------------------------------------------------------------------------------------------------------------------
------------------------------------------------------------------------------------------------------------------------!----------
-----------------------------------------------------------------------------------------------------------------------------------
-----------------------------------------------------------------------------------------------------------------------------------
-------------------------------------------------------------------------------------------------------##--------------------------
-------------------------SS!S--------------------------------------------------------------------------##-------------S@S!---------
-------------------------------------------------------------------------------------------------------##--------------------------
---------------------------------------------------1----------------#---------------------------#------##---------S----------------
------------C----------------------------------------#------#------##-------------#-----tt-----##---------S------------------------
-----tt---------------------------------------------##------##----###-------------##----tt----###----------------------------tt----
-----tt--------------tt-------#-###-----tt----------##---tt-###--####------###----###---tt---####-------------tt---####------tt-tt-
-M---tt-g----g-g-----tt------##-####----tt----------##---tt-####-----------####---####g-tt--#####g-g----------tt--#####------tt-tt-
XXXXXXXXXXXXXXXXXXXXXXXXXXXXXXX-XXXXXXXXXXXXXXXXXXXXXXXXXXXXXXXXXXXXXXXXXX-XXXXXXXXXX-tt----------XXXXXXXXXXXXXXXXXXXXX-XXXXXXXXXXX
XXXXXXXXXXXXXXXXXXXXXXXXXXXXXXX-XXXXXXXXXXXXXXXXXXXXXXXXXXXXXXXXXXXXXXXXXX-XXXXXXXXXXXXXXXX-------XXXXXXXXXXXXXXXXXXXXX-XXXXXXXXXXX
