------------------------------------------------------------------------------------------------------------------------
------------------------------------------------------------------------------------------------------------------------
------------------------------------------------------------------------------------------------------------------------
----------------------------------------------@-------------------------------------------------------------------------
------------------------------------------------------------------------------------------------------------------------
------------------------------------------------------------------------------------------------------------------------
---------------##--------------------------------------------------------------SSS---S----------------------------------
--------------###--------------------------!-------!--------------------------------------------------------------------
-------------####------------------------------------SSS---S------------------------------------------------------------
-------------####-----------1--------------------------------------------tt-----------------------1--SS!S--------SSS---S
-----------#---####----SS-----------------#------------------------tt----tt---------------------------------------------
-----tt----##--####-----------------------##-----S@S!--------------tt----tt---------------------------------------------
-----tt-tt-###-####-------------tt-###----###-----------###--------tt------####--------------tt------####--###----------
-M---tt-tt-########g-g-g--------tt-####---####----------####-----------gg-#####------g-------tt-----#####--####---------
XXXXXXXXXXXXXXX----XXXXXXXXXXXXXXX-XXXXXXXXXXXXXXXXXXXX-XXXXXXXXXXXXXXXXXXXXXXX-XXXXXXXXXXXXXXXXXXXXXXXXX--XXXXXXXXXXXX-
XXXXXXXXXXXXXXX--XXXXXXXXXXXXXXXXX-XXXXXXXXXXXXXXXXXXXX-XXXXXXXXXXXXXXXXXXXXXXX-XXXXXXXXXXXXXXXXXXXXXXXXX--XXXXXXXXXXXX-
