--------------------------------------------------------------------------------------------------------------------------------------------------
--------------------------------------------------------------------------------------------------------------------------------------------------
--------------------------------------------------------------------------------------------------------------------------------------------------
--------------------------------------------------------------------------------------------------------------------------------------------------
----------------------------------------------------------------------------------------------------S!!S------------------------------------------
---------------------------------------------------------------------------------------##-------------------------!--tt---------------------------
--------------------------------------------------------------------------------------###----------------------------tt---------------------------
-------------------------------------------------------------------------------------####----------------------------tt-----tt--------------------
----------------------------------------------------------1-------------------------#####----------####---------------------tt----#---------g-----
------------S!!S--------------------------------SS---------------------!S----------##--------------####---------S@S!--------tt---##-------SSSSS---
---C------------------------------------------------------------------------------###--------------####-------------------g-tt---##--------###----
-----------------------------------------------------tt---------------------tt---####---F----------####----tt--------------------##--------####---
--------------------------------------------g-g-g----tt--------g------------tt--#####---#-----------gg-XXXXXXXXXXXXXXX-XXXXXXXXXXXXXXXXXXX-XXXXXXX
-M--g-g------XXXXXXXXXXXXXXXXXXXXXX--XXXXXXXXXXXXXXXXXXXXXXXXXXXXXXXXXXXXXXXXXXXXXXXXXXXXXXXXXXXXXXXXX-XXXXXXXXXXXXXXX-XXXXXXXXXXXXXXXXXXX-XXXXXXX
XXXXXXXXXXXXXXXXXXXXXXXXXXXXXXXXXXX--XXXXXXXXXXXXXXXXXXXXXXXXXXXXXXXXXXXXXXXXXXXXXXXXXXXXXXXXXXXXXXXXX--------------------------------------------
XXXXXXXXXXXXXXX-----------------------------------------------------------------------------------------------------------------------------------
