---------------------------------------------------------------------------------------------------------------------------------------------
---------------------------------------------------------------------------------------------------------------------------------------------
--------------------------------------------------------------------------------------------##-----------------------------------------------
------------------------------------------------!------------------------------------------###------------g----------------------------------
------------------------------------------------------------------------------------------####----------SSSSS--------------------------------
-----------------------------------------------------------------------------------------#####----------------------1------------------------
------------------------------------------------------------------------------------S---##-------------------#------------!------------------
----------------------------------------------S@S!S------------------------------------###-----------------tt##------------------------------
--------------------------------------------------------------------------------------####-----------------tt###-----------------###---------
------------------------------------------------------tt-----------------------------#####-----------------tt####----------------####----g---
---------------------!S------SU-------##--#-----------tt--------SS!S-----------------------------XXXXXXXXXXXXXXXXXXXXXXXXXXXXXXX-XXXXXXXXXXXX
-SS!S--------------------------------###--#-------XXXXXXX----------------------------------------XXXXXXXXXXXXXXXXXXXXXXXXXXXXXXX-XXXXXXXXXXXX
--------------------------tt------------####------XXXXXXX-----------------------------------#F-----------------------------------------------
-------------g------------tt-----------#####-------------g-g---------------------------g---###-----------------------------------------------
XXXXXXXXXXXXXXXXXXXXXXXXXXXXXXXXXXXXXXXXXXXX-XXX--XXXXXXXXXXXXXXXXXXXXXXXXXX--XXXXXXXXXXXXXXXXXXX--------------------------------------------
XXXXXXXXXXXXXXXXXXXXXXXXXXXXXXXXXXXXXXXXXXXX-XXX--XXXXXXXXXXXXXXXXXXXXXXXXXX--XXXXXXXXXXXXXXXXXXX--------------------------------------------
