----------------------------------------------------g--------------------------------------------------------------------------------------
-------------------------------------------------------------------------------------------------------------------------------------------
--------------##----------------------------------S@S--------------------------------------------------------------------------------------
-------------###----------------------!--!--!----------------------------------------------------------------------------------------------
------------####---------------------------------------------------------------------------------------------------------------------------
-----------#####-------------------------------------------------SSS---S----1--------------------S!!S--------------------------------------
----------##------------------------S@S--------XXXXS-------------------------C----------S------------------------------S------C------------
---------###-----------------------------------XXXX----------##----------------------------------------------------------------------------
--------####-----------------------------------####----tt---###-----------------------------tt-----------tt-----------------tt-------------
-------#####-------------------------------------------tt-----g---k-----------g-g-----------tt-----g-----tt-----------------tt-g-g---------
--------!----------XXXXXXXXXXXXXXXXXXXXX-XXXXXXXXXXXXXXXXXXXXXXXXXXXXXXXXXXXXXXXXXXXXXXXXXXXXXXXXXXXXXXXXXXXXXX--XXXXXXXXXXXXXXXXXXXXXXX--X
-------------------XXXXXXXXXXXXXXXXXXXXX-XXXXXXXXXXXXXXXXXXXXXXXXXXXXXXXXXXXXXXXXXXXXXXXXXXXXXXXXXXXXXXXXXXXXXX--XXXXXXXXXXXXXXXXXXXXXXX--X
---------------F---------------------------------------------------------------------------------------------------------------------------
-M-------------#---------------------------------------------------------------------------------------------------------------------------
XXXXXXXXX-XXXXXXXXX------------------------------------------------------------------------------------------------------------------------
XXXXXXXXX-XXXXXXXXX------------------------------------------------------------------------------------------------------------------------
