------------------------------------------------------------------------------------------------------------------------
------------------------------------------------------------------------------------------------------------------------
---------------------------------------------------------------g--------------------------------------------------------
--------------------------------------------------------------------------------------!---------------------------------
-------------------------------------------------------------S@S---------SS!S-------------------------------------------
-----------------------------g------------------------------------------------------------------------------------------
---------------SSS---S------------S!!S------------------------------------------------------------------------g---------
---------------------------S@S--------------------------###-------------------------S@S!S-------#--#--------------------
-------------------------------------------------------####------------------------------------##--##-------S@S---------
------------------------------------------------------#####--------tt-----------------------tt-##--###-----------------#
---------SU---tt------------SS----------------#--------------------tt----g------------------tt-##--####---------------##
-------------XXXXXX---------------------tt----##----#XXXXXXXXX--XXXXXXXXXXXX-XXXXXXXXXXXXXXXXXXXXXXXXXXXXXXXXXXXXXXXXXXX
---##--#-----XXXXXX----#----------#-----tt-tt-###--##XXXXXXXXX--XXXXXXXXXXXX-XXXXXXXXXXXXXXXXXXXXXXXXXXXXXXXXXXXXXXXXXXX
--###--#--------------##g-g-g----##-----tt-tt-#########-----------------------------------------------------------------
XXXXXXXXXXXXXXXXXXXXXXXXXXXXXXXXXXXXXXXXXXXXXXXXX----SS-----------------------------------------------------------------
XXXXXXXXXXXXXXXXXXXXXXXXXXXXXXXXXXXXXXXXXXXXXXXXX-----------------------------------------------------------------------
