-------------------------------------------------------------------------------------------------------------------------------
-------------------------------------------------------------------------------------------------------------------------------
-------------------------------------------------------------------------------------------------------------------------------
---!------------------------------------------@--------------------------------------------!-----------------------------------
-------------------------------------------------------------------------------------------------------------------------------
-------------------------------------------------------------------------------------------------------------------------------
------------------##---------##------------------------------------------------------------------------------------------------
-S@S!------------###--------###------------!--!--!----@----------------------------------S@S!-----S------S!!-----!-----S------!
----------------####-------####------------------------------------------------------------------------------------------------
----------------####------####-------g-------------------------------------1-----##--------------------------------------------
--------------#---####---##-------------C--------------------------SU-----------###--------SS----------------------------------
--------------##--####--###--------S@S-------------!--!--!---------------------####----------XXXXX---XXXXXXXXXXXXXXXXXXXXXXXXXX
-------###----###-####-####----------------------------------------------------####----------XXXXX---XXXXXXXXXXXXXXXXXXXXXXXXXX
-M-----####---#############--------------g-g-----#-----------------------------------ggg-g-g----gg-----------------------------
XXXXXX-XXXXXXXXXXX-----tt----XXXXXXXXXXXXXXXXXXXXXXXXXXXXXXXXXXX--XXXXXXXXXXXXXXXXXXXXXXXXXXXXXXXXXXX--------------------------
XXXXXX-XXXXXXXXXXX----XXXXXX-XXXXXXXXXXXXXXXXXXXXXXXXXXXXXXXXXXX--XXXXXXXXXXXXXXXXXXXXXXXXXXXXXXXXXXX--------------------------
