-----------------------------------------------------------------------------------------------------------------------------------------------------
-----------------------------------------------------------------------------------------------------------------------------------------------------
-----------------------------------------------------------------------------------------------------------------------------------------------------
---------------------!-------------------------------------------------------------------------------------------------------------------------------
-----------------------------------------------------------------------------------------------------------------------------------------------------
--------------g--------------------------------------------------------------------------------------------------------------------------------------
-------------------------------!---------------------------------------------------------------------------------------------------------------------
------------S@S----S@S!------------------------------------------------------------------------------------------------------------------------------
--------------------------------------------------------------------------------------------------------------------g--------------------------------
---------------------------------------------------------------------------1-----------------------------------------------SSS---S-------------------
---S-------------------------S@S!-#----SS!S-----------!-----------C----------#------------SU----------------------S@S---------------------!C---------
---------------------------------##--------------------------SS!S-----------##---------------------------------------------------------------------tt
-------tt------------------------##-----------tt----------------------------##-----------------------------------------------------tt--------------tt
-M-----tt---------------------g--##-----------tt-------------------g-g------##----------------------------tt-------------k---------tt-------g-g----tt
XXXXXXXXXXXXX--XXXXX-XXXXXXXXXXXXXXXXXXXXXXXXXXXXXXXXXXXXXXXXXXXXXXXXXXXXXXXXXXXXXXXXXXX--XXXXXXXX--XXXXXXXXXXXXXXXXXXXXXXXXXXXXXXXXXXXXXXXXXXXXXXXXX
XXXXXXXXXXXXX--XXXXX-XXXXXXXXXXXXXXXXXXXXXXXXXXXXXXXXXXXXXXXXXXXXXXXXXXXXXXXXXXXXXXXXXXX--XXXXXXXX--XXXXXXXXXXXXXXXXXXXXXXXXXXXXXXXXXXXXXXXXXXXXXXXXX
