--------------------------------------------------------------------------------------------------------------------------------------
--------------------------------------------------------------------------------------------------------------------------------------
--------------------------------------------------------------------------------------------------------------------------------------
-----------------------------------------------------------@-----!--------------------------------------------------------------------
--------------------------------------------------------------------------------------------------------------------------------------
--------------------------------------------------------------------------------------------------------------------------------------
---------------------------------------------------------------------------------------------------------SSS---S-----@----------------
--SS!S--------------------------------------------------!--!---S@S!-------g--------------tt-------------------------------------------
------------------------------------------------------------------------SSS--------------tt-------------------------------------------
------------------------------------------------------------------------------------------g-------------#------------------1----------
----------------------------C----------------S-----------S---------------------------------------------##---------!--!--!---S---------
---------tt-----------------------------------------------------------------------------S@S-----------###-----------------------------
-------#-tt--------------------------------------tt------------#----------#--------------------#-----####-----------------------tt----
-M----##-tt----------g----g--g-g-----------------tt-----------##---------##-------------------##--g-#####----------tt-----------tt----
XXXXXXXXXXXXXXXXXXXXXXXXXXXXXXXXXXXXXXXXXXXXXXXXXXXXXXXXXXXXXXXX-XXXXXXXXXXXXXXXXXXXXXXXXXXXXXXXXXX------XXX-XXXXXXXXXXXXXXXXXXXXXXXXX
XXXXXXXXXXXXXXXXXXXXXXXXXXXXXXXXXXXXXXXXXXXXXXXXXXXXXXXXXXXXXXXX-XXXXXXXXXXXXXXXXXXXXXXXXXXXXXXXXXXXXXXXXXXX-XXXXXXXXXXXXXXXXXXXXXXXXX
