--------------------------------------------------------------------------------------------------------------------------------------------------
--------------------------------------------------------------------------------------------------------------------------------------------------
--------------------------------------------------------------------------------------------------------------------------------------------------
--------------------------------------------------------------------------------------------------------------------------------------------------
--------------------------------------------------------------------------------------------------------------------------------------------------
--------------------------------------------------------------------------------------------------------------------------------------------------
-----------------------------------------------------------------------SSS------------------------------------------------------------------------
--------------------------------------------------------------------------------------S-----------------------------------------------------------
--------------------------------------------------------------------------------------------------------------------------------------------------
---------------------------------------#---------------------------------------S!!S-------S!!S----------------1-----------------------------------
---SU--------!--------------#--#------##-----------------g-----S----------------------------------------------------S---------------##--#---C-----
---------------------------##--##----###---------------SSSSS-----------------------------------------------------------------------###--#---------
---------------###---------##--###--####---------------------------tt-----------------------------------##--------------tt--------####------------
-M-------------####--------##--#########----------k----------------tt-----g--tt-----------##-----------###--------------tt-------#####-------g-g--
XXXXXXXXXXXXXX-XXXXXXXXXXXXXXXXXX----g--XXXXXXXXXXXXXXXXXXXXXXXXXXXXXXXXXXXXXXXXXXXXXXXXXXXXXXXXXXXXXXXXXXXXXXXXXX--XXXXXXXXXXXXXXXXXX-XXXXXXXXXXX
XXXXXXXXXXXXXX-XXXXXXXXXXXXXXXXXXXXXXXXXXXXXXXXXXXXXXXXXXXXXXXXXXXXXXXXXXXXXXXXXXXXXXXXXXXXXXXXXXXXXXXXXXXXXXXXXXX--XXXXXXXXXXXXXXXXXX-XXXXXXXXXXX
