--------------------------------------------------------------------------------------------------------------------------------
--------------------------------------------------------------------------------------------------------------------------------
--------------------------------------------------------------------------------------------------------------------------------
--------------------------------------------------------------------------------------------------------------------------------
--------------------------------------------------------------------------------------------------------------------------------
--------------------g---------------------------------------------------------------------------------------------g-------------
----------SSS-----------#-----tt--------------------------S!!S------------------------------------------------------------------
------------------S-----##----tt-----------------------------------------------tt-------------------------------S@S-------------
------------------------###---tt-----------------------------------------------tt-----------------------------------------------
------------------------####g-tt----##-----------------------------------------tt-----------------------------------------------
-------SS----------C----XXXX-------###---------------------------##---#--#------------------------------S-----------------C-----
------------------------XXXX------####------#----##-------------###---#--##-----------------------------------------------------
----------------------------------####------#---###------#-----####---#--###-----------###--------------------#------tt---------
-M-g-g-g-----g------g-g-----------tt--------##----------##-----####---#--####----------####----g-------------##------tt----g-g--
XXXXXXXXXXXXXXXXX--XXXXXXXXXXXXXXXXXXXXXXXXXXXXXXXXXXXXXXXXXX--XXXXXXXXXXXXXXXXX-XXXXX-XXXXXXXXXXXXXXXXXXXXXXXXXXXXXXXXXXXXXXXXX
XXXXXXXXXXXXXXXXX--XXXXXXXXXXXXXXXXXXXXXXXXXXXXXXXXXXXXXXXXXX--XXXXXXXXXXXXXXXXX-XXXXX-XXXXXXXXXXXXXXXXXXXXXXXXXXXXXXXXXXXXXXXXX
