-----------------------------------------------------------------------------------------------------------------------------------------------------------
-----------------------------------------------------------------------------------------------------------------------------------------------------------
-----------------------------------------------------------------------------------------------------------------------------------------------------------
-----------------------------------------------------------------------------------------------------------------------------------------------------------
-----------------------------------------------------------------------------------------------------------------------------------------------------------
-----------------------------------------------------------------------------------------------------------------------------------------------------------
--------------------------------S!!S-----------------------------------------------------------------------------------------------------------------------
-----------------------------------------------------SS!S-------SS!S---------------------------------------------------------------------------------------
-----------------------------------------------------------------------------------------------------------------------------------------------------------
--------------------------g--------------SS!S----------------------------------------------------------------------------1---------------------------------
--------------S---------------SU----------------------------------------------!C-----------------------S!!S-----tt---------------##------------------------
------------------------S@S-------------------------------------------------------------------------------------tt--------------###------------------------
------------------t--------------------#--####------------------------------------------------------------------tt-------------####-------------------tt---
-M----------------t-------------------##-#####-----g--------------------g-------g-g----------------------------k---------------####-----------tt------tt---
XXXXXXXXXXXXXXXXXXXXXXXXXXXXXXXXXXXXXXXXXXXXXX-XXXXXXXXXX---XXXXXXXXXXXXXXXXXXXXXXXXXXXXX--XXXX--XXXXXXXXXXXXXXXXXXXXXXXXXXXXXXXXXXXXXX-XXXXXXXXXXXXXXXXXXX
XXXXXXXXXXXXXXXXXXXXXXXXXXXXXXXXXXXXXXXXXXXXXX-XXXXXXXXXX---XXXXXXXXXXXXXXXXXXXXXXXXXXXXX--XXXX--XXXXXXXXXXXXXXXXXXXXXXXXXXXXXXXXXXXXXX-XXXXXXXXXXXXXXXXXXX
