--------------------------------------------------------------------------------------------------------------------------------------
--------------------------------------------------------------------------------------------------------------------------------------
--------------------------------------------------------------------------------------------------------------------------------------
-------------------------------------------@---------------------@--------------------------------------------------------------------
--------------------------------------------------------------------------------------------------------------------------------------
---------------------------------------------------------------------------------g----------------------------------------------------
--------------------------------------------------------------------------------------------------------------------------------------
-----------------g----------------------!--!--!---------------!--!--!----------S@S-------------------g--------------------------------
--------------------------------------------------------------------------------------------------------------------------------------
---------------S@S------------------------------##----S!!S---------------#-------------------------S@S--------------------------------
-----------------------#----------SU-------SS--###----------------------###-----------SSS---S!!S-----------#---------------------SU---
--------##-------------##---------------------####---------------------####--------------------------------##-------------------------
-------###--#---###----###--------------------####---------------------####-------------------------###----###--------#---------------
-M--tt----------####---####-----g------g-g-g-----g---tt-------------------g-------g-g-g-------------####---####------##--g------------
XXXXXXXXXXXXXXX-XXXXXXXXXXXXXXXXXXXXXXXXXXXXXXXXXXXXXXXXXXXXXXXX-XXXXXXXXXXXXXXX--XXXXXXXXXXXXXXXXX-XXXXXXXXXXXXXXXXXXXXXXXXXXXXXXXXXX
XXXXXXXXXXXXXXX-XXXXXXXXXXXXXXXXXXXXXXXXXXXXXXXXXXXXXXXXXXXXXXXX-XXXXXXXXXXXXXXX--XXXXXXXXXXXXXXXXX-XXXXXXXXXXXXXXXXXXXXXXXXXXXXXXXXXX
