------------------------------------------------------------------------------------------------------------------------------------------------
------------------------------------------------------------------------------------------------------------------------------------------------
------------------------------------------------------------------------------------------------------------------------------------------------
------------------------------------------------------------------------------------------------------------------------------------------------
------------------------------------------------------------------------------------------------------------------------------------------------
------------------------------------------------------------------------------------------------------------------------------------------------
------------------------------------##-------------------------##----------------tt-------------------------------------------------------------
-----------------------------------###------------------------###----------------tt-------------------------------------------------------------
----------------------------------####-----------------------####----------------tt-------------------------------------------------------------
----------------------1-----------####-----------------------####--------------g-tt------####--------------------------------------SSS---S------
------------------------#-----------SSSU---S---------------------------------tt------XXX-####U--------------------tt-------SS-------------------
------------tt---------##----------------------------------------------------tt------XXX-####----------tt---------tt--------------------------tt
------------tt---------##----------------------tt------------------------tt--tt----------####----------tt---------tt--------------------------tt
-M----------tt-g-------##---g---g-g-g----------tt-----g------------------ttg-tt------k-------------g---tt-------g-tt---g-g-g---------g--------tt
XXXXXXX--XXXXXXXXXXXXXXXXXXXXXXXXXXXXXXXXXXXXXXXXXXXXXXXXXXXX--X-XXXXXXXXX-tt----XXXXXXXXXXXXXXXXXXXXXXXXXXXXXXXXXXXXXXXXXXXX-XXXXXXXXXXXXXXXXXX
XXXXXXX--XXXXXXXXXXXXXXXXXXXXXXXXXXXXXXXXXXXXXXXXXXXXXXXXXXXX--X-XXXXXXXXXXXXXXX-XXXXXXXXXXXXXXXXXXXXXXXXXXXXXXXXXXXXXXXXXXXX-XXXXXXXXXXXXXXXXXX
