--------------------------------------------------------------------------------------------------------------------------------------------
--------------------------------------------------------------------------------------------------------------------------------------------
--------------------------------------------------------------------------------------------------------------------------------------------
--------------------------------------------------------------------------------------------------------------------------------------------
--------------------------------------------------------------------------------------------------------------------------------------------
--------------------------------------------------------------------------------------------------------------------------------------------
----------------------------------##-------------SSS----------------------------------------------------------------------------------------
---------------------------------#----------------------------------------------------------------------------------------------------------
----SSS---S---------------------##----------------------------------------------------------------------------------------------------------
-------------------------------###--------------------------##--------------#----------------S---------------------C------#---tt-------SU---
---------------!--------------##---SS!SU-------------------###------tt-----##-------------------------------##--#--------##---tt------------
-----------------SS!S--------###-----------------------tt-####------tt-----##---tt--------------###--------###--#--------##---tt------------
-----####----------------tt-####--------------tt-------tt-####------tt-----##---tt--------------####------------g---g-g--##-----------------
-M--#####----------------tt-------------------tt----g--tt---XXXXXXXXXXXXXXXXXXXXXXXXXXXXXXXXXXX-XXXXXXXXXXXXXXXXXXXXXXXXXXXXXXXXXXXXXXXXXXXX
XXXXXXXXX-XXXXXXXXXXXXXXXXXXXXXXXXXXXXXXXXXXXXXXXXXXXXXXXXXXXXXXXXXXXXXXXXXXXXXXXXXXXXXXXXXXXXX-XXXXXXXXXXXXXXXXXXXXXXXXXXXXXXXXXXXXXXXXXXXX
XXXXXXXXX-XXXXXXXXXXXXXXXXXXXXXXXXXXXXXXXXXXXXXXXXXXXXXXXXXXXX------------------------------------------------------------------------------
