---------------------------------------------------------------------------------------------------------------------------------------
---------------------------------------------------------------------------------------------------------------------------------------
---------------------------------------------------------------------------------------------------------------------------------------
---------------------------SS!S--------------------------------------------------------------------------------------------------------
---------------------------------------------------------------------------------------------------------------------------------------
---------------------------------------------------------------------------------------------------------------------------------------
--------------------------SU-----------------------------------------------------------------------------------------------------------
---------------------------------------------------------------------------------------------------------------------------------------
----S!!S-------------------------------------------------------------------------------------------------------------------------------
-----------------------------------------------------SSS---S------------------1-------------1------------------------------------------
-----------------SU-------XX-------S----------------!-----------#------#------------------------------------tt----C--------------------
--------------------------XX-----------------------------------##------##-----------------------------------tt-----------------SS!S----
-----####------------------------------tt----tt----------------##---tt-###--------------------###-----------tt-------------------------
-M--#####-------------g-g-g------------tt----tt---------gg-----##---tt-####------g------------####----g----k-------g-g----g------------
XXXXXXXXX-XXXX--XXXXXXXXXXXXXXXX--XXXXXXXXXXXXXXXXXXXXXXXXXXX--XXXXXXXXXXXXXXXXXXXXXXXXXXXXXX-XXXXXXXXXXXXXXXXXXXXXXXXXXXXXXXXX--XXXXXX
XXXXXXXXX-XXXX--XXXXXXXXXXXXXXXX--XXXXXXXXXXXXXXXXXXXXXXXXXXX--XXXXXXXXXXXXXXXXXXXXXXXXXXXXXX-XXXXXXXXXXXXXXXXXXXXXXXXXXXXXXXXX--XXXXXX
