----------------------------------------------------------------------------------------------------------------------------------
----------------------------------------------------------------------------------------------------------------------------------
----------------------------------------------------------------------------------------------------------------------------------
----!-----------------------------------------------------------------------------------------------------------------------------
----------------------------------------------------------------------------------------------------------------------------------
----------------------------------------------------------------------------------------------------------------------------------
----------------------------------------------------------------------------------------------------------------------------------
--S@S!---------------------------------------------------------------------------------g------------------------------------------
--------------------S!!S-------------------##--#---------------------------------------------------------------------------------#
------------------------------------------###--#----------#--------------------------S@S--------------------------####----------##
----------#--------------------------S@S!------#--#------##-----------S!!S----------------------!-----------------####--#-#----###
---------##-----------------------------------##--##----###--------------------------------------------##--#------####-####---####
---------##--------------###-----t-----------###--###--####---------------------------####------------###--#------#########--#####
-M-------##---g----------####----tt---------####--#########-------------------g-g-g--#####-------------tt-------g--------##-------
XXX-XXXXXXXXXXXXXXXXXXXX-XXXXXXXXXXXXXXXXXXXXXXXXXXXXXXXXXXXXXXXXXXXXXXXXXXXXXXXXXXXXXXXXX-XXXXXXXXXXXXXXXXXXXXXXXXXXXXXXXXXXXXXXX
XXX-XXXXXXXXXXXXXXXXXXXX-XXXXXXXXXXXXXXXXXXXXXXXXXXXXXXXXXXXXXXXXXXXXXXXXXXXXXXXXXXXXXXXXX-XXXXXXXXXXXXXXXXXXXXXXXXXXXXXXXXXXXXXXX
