-----------------------------------------------------------------------------------------------------------------------------------------------
-----------------------------------------------------------------------------------------------------------------------------------------------
-----------------------------------------------------------------------------------------------------------------------------------------------
-----------------------------------------------------------------------------------------------------------------------------------------------
-----------------------------------------------------------------------------------------------------------------------------------------------
-------------g---------------------------------------------------------------------------------------------------------------------------------
--------------------------------------------------------------tt-------------------------------------------------------------------------------
-----------S@S------------------------------------------------tt-------------------------------------------------------------------------------
-----------------------------g--------------------------------tt------------##-----------------------------------------------------------------
------------------------------------------------------------g-tt-----#-----###----------------------------------------------------S!!S---------
--------!------------------S@S-------------------------------!------##-----###-----------#-----tt---------------#--#----------#----------------
-------------------------------------------------------------------###-----###-----------##----tt-------tt-----##--##---------#----------------
----------------###-----------------------------------------------####------####--###----###---tt-------tt-----##--###--------#----------------
-M--------------####----g----------------------------------------#####-----#####--####---####g-tt-------tt-----##--####-------####-------------
XXXXXXXXX-XXXXX-XXXXXXXXXXXXXXXXXXXXXXXXXX--XXXXXXXXXXXXXXXXXXXXXXXXXXXXXXXXXXXX--XXXXXXXXX-k------XXXXXXXXXXXXXXXXXXXXXXXXXXXXXXXXXXXXXXXXX--X
XXXXXXXXX-XXXXX-XXXXXXXXXXXXXXXXXXXXXXXXXX--XXXXXXXXXXXXXXXXXXXXXXXXXXXXXXXXXXXX--XXXXXXXXXXXXXXXXXXXXXXXXXXXXXXXXXXXXXXXXXXXXXXXXXXXXXXXXXX--X
