-------------------------------------------------------------------------------------------------------------
-------------------------------------------------------------------------SSS---------------------------------
-------------------------------------------------------------------------------------------------------------
--------@----------------------------------------!-----------------------------------------------------------
-------------------------------------------------------------------------------------------------------------
---------------------------------------------------C-------##---------SS---------------SS--------------------
----------------------------------------------------------###------------------------------tt----------------
-----!--!--!--------------------g--------------S@S!------####------------------------------tt----------------
----------------------------------------------------g-g--####-----g-------------------------g----------------
------------------------------S@S------------------XXXXXXXXXXXXXXXXX-----XXXSSS------------------------------
------------------SU---C------------------##--#----XXXXXXXXXXXXXXXXX-----XXX--------------S@S----------------
-----------------------------------------###--#----------####------------------------------------------tt----
------------#------------------####---------####---------###-###---------------------------------#-----tt----
-M----gg---##-----------g-g---#####--------#####-----k-------####----g----k---------------g-----##-----tt----
XXXXXXXXXXXXXXXXXXXXXXXXXXXXXXXXXXX--XXXXXXXXXXX-XXXXXXXXXXX-XXXXXXXXXXXXXXXXXXXXXXXXXXXXXXXXXXXXXXXXXXXXXXXX
XXXXXXXXXXXXXXXXXXXXXXXXXXXXXXXXXXX--XXXXXXXXXXX-XXXXXXXXXXX-XXXXXXXXXXXXXXXXXXXXXXXXXXXXXXXXXXXXXXXXXXXXXXXX
