---------------------------------------------------------------------------------------------------------------------------------------------------------------
---------------------------------------------------------------------------------------------------------------------------------------------------------------
---------------------------------------------------------------------------------------------------------------------------------------------------------------
---------------------------------------------------------------------------------------------------------------------------------------------------------------
---------------------------------------------------------------------------------------------------------------------------------------------------------------
---------------------------------------------------------------------------------------------------------------------------------------------------------------
----------SSS------------------------------------------------------------------------------------##------------------------------------------------------------
------------------------------------------------------------------------------------------------###------------------------------------------------------------
---------------------S!!S--------------------------------------------------------##--#---------####---------------------------##--#----------------------------
---------------------------------------g----------------------------------------###--#---------####-----------------1--------###--#----------------------------
--------------------------------------------------------S-----------------------------------------------------------------!-------------S------S---------------
-------------------------------------S@S----------------------------------------------------------------------------------------------------------------tt-----
--------------##--#---####-------------------#-----------------------------------------#---tt------------------tt----------------------------------tt---tt-----
-M-----------###--#--#####------------------##-----------------------------g------g---##---tt------------------tt----------------------------------tt---tt-----
XXXXXXXXXXXXXXXXXXXXXXXXXX-XXXXXXXXXXXXXXXXXXXXXXXXXXXXXXXXXXXXXXXXX--XXXXXXXXXXXXXXXXXXXXXXXXXX-XXXXXXXXXXXXXXXXXXXXXXXXXXXXX--XXXXXXXXXXXXXXXXXXXXXXXXXXXXXXX
XXXXXXXXXXXXXXXXXXXXXXXXXX-XXXXXXXXXXXXXXXXXXXXXXXXXXXXXXXXXXXXXXXXX--XXXXXXXXXXXXXXXXXXXXXXXXXX-XXXXXXXXXXXXXXXXXXXXXXXXXXXXX--XXXXXXXXXXXXXXXXXXXXXXXXXXXXXXX
