--------------------------------------------------------------------------------------------------------------------------------
--------------------------------------------------------------------------------------------------------------------------------
--------------------------------------------------------------------------------------------------------------------------------
--------------------------------------------------------------------------------------------------------------------------------
--------------------------------------------------------------------------------------------------------------------------------
-------------------------------------------------------------------------------------------------------------------------------#
-----------------------------------------------------------------------S------------------------------------------------------##
--------------------------------------------------------------------------SS!S-----------------------g-----------------------###
----------------##--#------------------------------------------------------------------------------SSSSSSSS---S-------------####
---------------###--#------------------------------------1-----------------------------tt-----##---------------------------#####
------SS!-----------------------------SS-#--#-----tt------SU--------g------------------tt----###------------------#-----tt--####
----------------------tt----------------##--##----tt--------------SSSSS----------------tt---####------------------##----tt--####
----------------------tt--------tt------##--###---tt------------------------tt----#--g-tt---####-----------###----###---tt--####
-M--------------------tt--------ttg-g-g-##--###----g--------------gg----g---tt---##-k----------g---k-------####---####g-tt--####
XXXXXXXXXXXXXXXXXX--XXXXXXXXXXXXXXXXXXXXXXXXXXXXXXXXXXXXXXXXXXXXXXXXXXXXXXXXXXXXXXXXXXXXXXXXXXXXXXXXXXXXXX-XXXXXXXXXXX----------
XXXXXXXXXXXXXXXXXX--XXXXXXXXXXXXXXXXXXXXXXXXXXXXXXXXXXXXXXXXXXXXXXXXXXXXXXXXXXXXXXXXXXXXXXXXXXXXXXXXXXXXXX-XXXXXXXXXXX----------
