-------------------------------------------------------------------------------------------------------------------------------------------
-------------------------------------------------------------------------------------------------------------------------------------------
-------------------------------------------------------!-----------------------------------------------------------------------------------
-------------------------------------------------------------------------------------------------------------------------------------------
-------------------------------------------------------------------------------------------------------------------------------------------
-------------------------------------------------------------------------------------------------------------------------------------------
---------------------------------------------tt------S@S!S---------------------------------------------------------------------------------
---------------------------------------------tt--------------------------------------------------------------------------------------------
---------------------------------------------tt--------------tt----------------------------------------------------------------------------
------------------1------------#---------------------####----tt----------------1--------------------1---------------tt---------------------
------------------------------##---------------------####XXXXXXX-#--------------SU-----------#----------------------tt------SU--------!----
-----------------------------###---------------------####XXXXXXXt##--------------------------##---------------------tt---------------------
----------------------tt----####--------##--#--------####---#--tt###------------------###----###------###-----tt--g-tt-----------------F---
-M--------------------tt---#####-------###--#----k---------##--tt####-----g-----------####---####-----####----tt-----------------------#---
XXXXXXX--XXXX--XXXXXXXXXXXXXXXXXXXXXXXXXXXXXXXXXXXXXXXXXXXXXXXXXXXXXXXXXXXXXXXXXXXXXX-XXXXXXXXXXXXXXX-XXXXXXXXXXXXXXXXXXXXXXXXXXXXXXXXXXXXX
XXXXXXX--XXXX--XXXXXXXXXXXXXXXXXXXXXXXXXXXXXXXXXXXXXXXXXXXXXXXXXXXXXXXXXXXXXXXXXXXXXX-XXXXXXXXXXXXXXX-XXXXXXXXXXXXXXXXXXXXXXXXXXXXXXXXXXXXX
