------------------------------------------------------------------------------------------------------------------------------------------------------
------------------------------------------------------------------------------------------------------------------------------------------------------
------------------------------------------------------------------------------------------------------------------------------------------------------
-------@----------------------------------------------------------------------------------------------------------------------------------------------
------------------------------------------------------------------------------------------------------------------------------------------------------
----------------------g-------------------------------------------------------------------------------------------------------------------------------
-----------------------------------------------------------------------------------------------------------SSS----------------##----------------------
----!--!------------S@S------------------------------------------------------------------------------------------------------###----------------------
----------------------------SSS---S-----------------------------------------------------------------------------------------####--------#-------------
-------------1---------------------------##-----------------------------------------SSS---S---------------------------------####-------##-------------
----------------------------------------###----SSSU-----------------SSS---S-----------------------------SS-----S----------------------###--C----------
---------------------------------------####--------------------------------------------------tt--------------------------------------####-------------
--------------------------------####---####--------------------------------------------------tt--------------------tt---------------#####-------------
-M---g----------------------g--#####-------g-g-g-----------------------------------g--tt-----tt-g---g-g-g-----g----tt---------------k-------g-g-----gg
XXXXXXXXXXXXXXXXXXXX-XXXXXXXXXXXXXXX-XXXXXXXXXXXXXXXXXXXXXXXXXXXXXXXXXXXXXXXXX--XXXXXXXXXXXXXXXXXXXXXXXXXXXXXXXXXXXXXXXXXX--X-XXXXXXXXXXXXXXXXXXXXXXXX
XXXXXXXXXXXXXXXXXXXX-XXXXXXXXXXXXXXX-XXXXXXXXXXXXXXXXXXXXXXXXXXXXXXXXXXXXXXXXX--XXXXXXXXXXXXXXXXXXXXXXXXXXXXXXXXXXXXXXXXXX--X-XXXXXXXXXXXXXXXXXXXXXXXX
