-----------------------------------------------------------------------------------------------------------------------------------------
-----------------------------------------------------------------------------------------------------------------------------------------
-----------------------------------------------------------------------------------------------------------------------------------------
-----------------------------------------------------------------------------------------------------------------------------------------
-----------------------------------------------------------------------------------------------------------------------------------------
------------------------------------------------------------------------------------g----------------------------------------------------
----------------------------------SSS---S----------------------------------------------------------------------SSS---S-------------------
----------------------------------g-------------@---------------------------------S------------------------------------------------------
-----------------------------------------------------------------------------------------------------------------------------------------
--------------------------------S@S---------------SS!S-----------------------------------------------------------------------------------
--------S--------------#------------------------------------#----------------------C--------------C--------------------SS!S------------SS
----------------------##---------------------!--!----------##-----------------------------------------------------------------SS!S-------
----------------------##---------####-----#-----------####-##---tt-----------------------------------------------------------------------
-M--------------------##---g----#####----##----------#####-##---tt--g---------------g-g---------g--g-g---------------------------------g-
XXXXXXXXXXXXXXXXXXXXXXXXXXXXXXXXXXXXX-XXXXXXXXXXXXXXXXXXXX-XXXXXXXXXXXXX-XXXXXXXX--XXXXXXXXX--XXXXXXXXXXXXX--XXXXX-XXXXXXXXXXXXXXXXXXXXXX
XXXXXXXXXXXXXXXXXXXXXXXXXXXXXXXXXXXXX-XXXXXXXXXXXXXXXXXXXX-XXXXXXXXXXXXX-XXXXXXXX--XXXXXXXXX--XXXXXXXXXXXXX--XXXXX-XXXXXXXXXXXXXXXXXXXXXX
