----------------------------------------------------------------------------------------------------------------------------------------------
----------------------------------------------------------------------------------------------------------------------------------------------
----------------------------------------------------------------------------------------------------------------------------------------------
----------------------------------------------------------------------------@-----------------------------------------------------------------
----------------------------------------------------------------------------------------------------------------------------------------------
----------------------------------------------------------------------------------------------------------------------------------g-----------
---S!!S--------------SSS-------------------tt-------------------------------------------------------------------------------------------------
-------------------------------------------tt----------------------------!--!--!------------------------------------------------S@S--SS!S-----
-------------------------------------------tt-------------------------------------------------------------------------------------------------
--------------S!!S-----------------------g-tt-------------------------------------------------------------1------------####-------------------
-----------------------------------------------------S-C---------------S------------------------#--#-------S-----------####U----------SS------
-----------------------------------------------------------------------------------------------##--##------------------####-------------------
----------g------------------------------tt----#----------------------------------##--#--------##--###---------tt------####-------------------
-M-------------tt-------g----------------tt---##--------g-g----------------------###---gg------##--####--------tt--k--------------g-g-g-------
XXXXXX--XXXXXXXXXXXXXXXXXXXXX--XXXXXXXXXXXXXXXXXXXXXXXXXXXXXXXXX--XXXXXXXXXX--XXXXXXXXXXXXXXXXXXXXXXXXXXXXXXXXXXXXXXXXXXXXXXXXXXXXXXXXXXXXXXXX
XXXXXX--XXXXXXXXXXXXXXXXXXXXX--XXXXXXXXXXXXXXXXXXXXXXXXXXXXXXXXX--XXXXXXXXXX--XXXXXXXXXXXXXXXXXXXXXXXXXXXXXXXXXXXXXXXXXXXXXXXXXXXXXXXXXXXXXXXX
