-------------------------------------------------------------------------------------------------------------------------------------
-------------------------------------------------------------------------------------------------------------------------------------
------------------------------##-----------------------------------------------------------------------------------------------------
-----------------------------###-----------------------------------------------------------------------------------------------------
----------------------------####-----------------------------------------------------------------------------------------------------
---------------------------#####-----------------------------------------------------------------------------------------------------
-------------------####---##-------------------------------------------------------------------------------------------------tt--####
-------------------####--###-------------------------------------------------------------------------------------------------tt--####
-------------------####-####-------------------------------------------------------------------------------------g-----------tt--####
-------------------#########-------------------------------------------1---------------------------------------------------g-tt--####
---------S--------------####----------------#--------------#------------------------SS!S-----##----------!-----S@S-----S-----SS------
------------------------####-----##--#----tt##-------------##----------X--------------------###--------------------------------------
-------------tt---------####----###--#----tt###-----###----###---------X---tt--------------####--------------------------------------
-M-----------tt---------####k-------------tt####----####---####------------tt-k-------tt---####------------k-------------g-g-g-------
XXXXXXXXXXXXXXXXXXXXXXXXXXXXXXXXXXXXXXXXXXXXXXXXXXX-XXXXXXXXXXXXXXXXXXXXXXXXXXXXXXXXXXXXXXXXXXXXXXXXXXXXXXXXXXXXXXXXXXXXXXXXXXX------
XXXXXXXXXXXXXXXXXXXXXXXXXXXXXXXXXXXXXXXXXXXXXXXXXXX-XXXXXXXXXXXXXXXXXXXXXXXXXXXXXXXXXXXXXXXXXXXXXXXXXXXXXXXXXXXXXXXXXXXXXXXXXXX------
