---------------------------------------------------------------------------------------------------------------------------------
---------------------------------------------------------------------------------------------------------------------------------
---------------------------------------------------------------------------------------------------------------------------------
---------------------------------------------------------------------------------------------------------------------------------
---------------------------------------------------------------------------------------------------------------------------------
-------------------------------g---------------------------------------------------------------------------g---------------------
-----------------------------------------------------------------------SSS---S------------------------------------SSS------------
-----------------------------S@S-------------------------------------------------------------------------S@S---------------------
-----------------------------------------------------------------##--#------------------------------------------#----------------
----------------------------------------------------------------###--#-----------------------------------------##----------------
------------------------#---####---C--------tt-SSS---S---C-----------------------tt-----------------------SS--###----------------
-----tt-----------------##--####------------tt-----------------------------------tt------tt------------------####----------------
-----tt------###-----tt-###-####------------tt-----------------------------------tt------tt-tt--------------#####----------------
-M---tt-g----####----tt-##-tt-------g-g------g------------g-g------------------------gg--tt-tt------g-g-g-g---g------g-----------
XXXXXXXXXXXX-XXXXXXXXXXXXXXXXXXXXXXXXXXXXXXXXXXXXXXXXXXXXXXXXXXXXX-XXXXXXXXXXXX--XXXXXXXXXXXXXXXXXXXXXXXXXXXXXXXXXXXXXXXX--XXXXXX
XXXXXXXXXXXX-XXXXXXXXXXXXXXXXXXXXXXXXXXXXXXXXXXXXXXXXXXXXXXXXXXXXX-XXXXXXXXXXXX--XXXXXXXXXXXXXXXXXXXXXXXXXXXXXXXXXXXXXXXX--XXXXXX
