---------------------------------------------------------------------------------------------------------------------------------------
---------------------------------------------------------------------------------------------------------------------------------------
---------------------------------------------------------------------------------------------------------------------------------------
---------------------------------------------------------------------------------------------------------------------------------------
---------------------------------------------------------------------------------------------------------------------------------------
--------------------------------------------------------------------------------------g------------------------------------------------
-----------------------------------------------------------------------------------------------SSS-------------------------------S!!S--
-----------------------------------------------------SS!S---------------------------S@S------------------------------------------------
---------------------------------------------------------------------------------------------------------------------------------------
-------SS!S----------------------------SS!S-----##-----------------------------------------tt----------------1--------1----------------
-----------------#-----------------------------###-------SS--------#---####---C------------tt------SS----------------------------------
-----------------##---------------------------####-----------------##--####----------------tt--------------------------------##--------
----------###----###-----###-----tt--------#######----------###----###-####--------------g-tt-------------------------------###---tt---
-M--tt----####---####----####----tt--g----#####------g-g-g--####---########----g-g-----------ggg-g-g--------------------k---------tt---
XXXXXXXXX-XXXXXXXXXXXXXX-XXXXXXXXXXXXXXXXXXXXXX-XXXXXXXXXXX-XXXXXXXXXXX----XXXXXXXXX-XXXXXXXXXXXXXXXXXXXXXXXXXXXXXXXXXXXXXXXXXXXXXXXXXX
XXXXXXXXX-XXXXXXXXXXXXXX-XXXXXXXXXXXXXXXXXXXXXX-XXXXXXXXXXX-XXXXXXXXXXX----XXXXXXXXX-XXXXXXXXXXXXXXXXXXXXXXXXXXXXXXXXXXXXXXXXXXXXXXXXXX
