---------------------------------------------------------------------------------------------------------------------------------------------
---------------------------------------------------------------------------------------------------------------------------------------------
---------------------------------------------------------------------------------------------------------------------------------------------
-------------------------------!-----------------------------------------------------------------------------------S@S!----------------------
------------------------------------------------------------------------------------------------------------------------------------##--#----
-----------------------------------------------------------------------------------------------------------------------------------###--#----
-------------------------------------------------------------------------------------------------------------------##---C---------SS---------
-----------------------------S@S----------------------------------------------------------------------------------###------------------------
-----------------------------------------------------------------------------------------------------------------####------------------------
--SSS------------------------------------------------------------------------------------S!!S-------------------#####----g-g--g-g-g----------
--------SU-----------#-----tt------------------------------S------------------#------#------------------S----------SSXXXXXXXXXXXXXXXXXXXXXXXX
---------------------##----tt-------##--#-------------------------------------##----##-------------------------------XXXXXXXXXXXXXXXXXXXXXXXX
--------------###----###---tt------###--#--#---------------------------###----###---------------------------tt-------------------------------
-M------------####---####g-tt-------------##-------------------g-------####---####----#####----------g------tt-g-g-g-------------------------
XXXXXXXXXXXXX-XXXXXXXXXXX------XXXXXXXXXXXXXXXXXXXXX--XXXXXXXXXXXXXXXX-XXXXXXXXXXXXXXXXXXXX-XXXXXXXXXXXXXXXXXXXXXXXXX------------------------
XXXXXXXXXXXXX-XXXXXXXXXXX------XXXXXXXXXXXXXXXXXXXXX--XXXXXXXXXXXXXXXX-XXXXXXXXXXXXXXXXXXXX-XXXXXXXXXXXXXXXXXXXXXXXXX------------------------
