------------------------------------------------------------------------------------------------------------------------------------------------------------
------------------------------------------------------------------------------------------------------------------------------------------------------------
------------------------------------------------------------------------------------------------------------------------------------------------------------
-------------------------------------------------------------------------------------------------------------------------------------------@----------------
------------------------------------------------------------------------------------------------------------------------------------------------------------
------------------------------------------------------------------------------------------------------------------------------------------------------------
--------------------------------------------------------------------------------------------SSS-----------------SSS-----------------------------------------
----------------------------------------------------------------------------------------------------------------------------------------!--!--!-------------
------------------------------------------------------------------------------------------------------------------------------------------------------------
------SSS---S----------------------g----------------------------1-----------------1--##---------------------------------------------1-----------------------
-------------------------------------------------------SS!S-----------!-#--#--------###--------------------------------------#-------SU-------------SS------
---------------------g-----------S@S-----------------------------------##--##------####------------------------------------tt##-----------------------------
-------------------SSSSS-----------------tt--###-----t-----------------##--###-----####------------------------------------tt###----------------------------
-M------tt-------------------------------tt--####----tt----------------##--####-----k----------g--------g----------g-------tt####---------------g-g-g-------
XXXXXXXXXXXXXXXXXXXXXXXXXXXXXXXXXXXXXXXXXXXX-XXXXXXXXXXXXXXXXXXXXXXXXXXXXXXXXXXXXXXXXXXXXXXXXXXXXXXXXXXXXXXXXXXXXXXXXXXXXXXXXXXXXXXXXXXXXX-XXXXXXXXXXXXXXXXX
XXXXXXXXXXXXXXXXXXXXXXXXXXXXXXXXXXXXXXXXXXXX-XXXXXXXXXXXXXXXXXXXXXXXXXXXXXXXXXXXXXXXXXXXXXXXXXXXXXXXXXXXXXXXXXXXXXXXXXXXXXXXXXXXXXXXXXXXXX-XXXXXXXXXXXXXXXXX
