-----------------------------------------------------------------#-----------tt--------####----------------------------
----------------------------------------------------------------##--!--------tt--------####----------------------------
---------------------------------------------------------------###-------g-g-tt------#-####-----------#----------------
-------------------------------------------------------------#####-----------####---##--------g-g----##--------tt------
-------------------------------------------------------g-g--#####XXXXXXXXXXXXXXXXXXXXXXXXXXXXXXXXXXXXXXXXXXXXXXXXX-XXXX
----------------------------------------------------------XXXXXXXXXXXXXXXXXXXXXXXXXXXXXXXXXXXXXXXXXXXXXXXXXXXXXXXX-XXXX
------------------------@------------------------------SS-XXXXXXXX-----------------------------------------------------
------!----------------------------------------------------------------------------------------------------------------
-----------------------------------------------------------------------------------------------------------------------
------------------------------------------------------1####------------------------------------------------------------
----C-----------S-------!--!-------#--#----------------####------------------------------------------------------------
----------------------------------##--#-------!--------####------------------------------------------------------------
----------------------------------##--#----------------####----------F-------------------------------------------------
-M---g-----------------------####-##--#------------------------------#-------------------------------------------------
XXXXXXXXXXXX--XXXXXXXXXXXXXXXXXXXXXXXXXXXXXXXXXXXXXXXXXXXXXXXXXXXXXXXXXXX----------------------------------------------
XXXXXXXXXXXX--XXXXXXXXXXXXXXXXXXXXXXXXXXXXXXXXXXXXXXXXXXXXXXXXXXXXXXXXXXX----------------------------------------------
