--------------------------------------------------------------------------------------------------------------------------------------------
---------------------------------------------------------------------------------------------------------g----------------------------------
--------------------------------------------------------------------------------------------------------SSSSSSS-----------------------------
-------------------------------------------------------S-------------------------@----------------------------------------------------------
--------------------------------------------------------------------------------------------------------------------------------------------
------------------SSS!--------------------------------g-------------------------------------------------------------------------------------
--------------------------------------------------------------------------------------------------------------#-----------------------------
----------------------------------------------------S@S---SS!S---------SU--------!--!-------------##------!---#--------------!----------##--
-------------------------------------------------------------------------------------------------###----------#------------------------###--
------------------------SSS!--------------------------------------------------tt----------------####----------#---#-------------------####--
----#--#-----------------------------!-------SS!S--C--S@S!S-------------------tt------------------k-----tt-####--##----------k--------------
---##--#-----------------------t-------------------------------XXXXXXXXXXXXXXXXXXXXXXXXXXXX--XXXXXXXXXXXXXXXXXXXXXX-XXXXXXXXXXXXXXXXXXX-----
---##--#-----------------------t-------------------------------XXXXXXXXXXXXXXXXXXXXXXXXXXXX--XXXXXXXXXXXXXXXXXXXXXX-XXXXXXXXXXXXXXXXXXX-----
-M-##--#-------------##-----k--t-g------k-----------g--g------------------------------------------------------------------------------------
XXXXXXXXXXXXXXXXXXXXXXXXXXXXXXXXXXXXXXXXXXXXXXXXXXXXXXXXXXXXXX------------------------------------------------------------------------------
XXXXXXXXXXXXXXXXXXXXXXXXXXXXXXXXXXXXXXXXXXXXXXXXXXXXXXXXXXXXXX------------------------------------------------------------------------------
