-------------------------------------------------------------------------------------------------------------------------------------------------------
-------------------------------------------------------------------------------------------------------------------------------------------------------
-------------------------------------------------------------------------------------------------------------------------------------------------------
-------------------------------------------------------------------------------------------------------------------------------------------------------
-------------------------------------------------------------------------------------------------------------------------------------------------------
----------------------------------------------------------------------------------------------------------SSS!-----------------------------------------
-----------------------------------------------------------------@-------------------------------------------------------------@-----------------------
-------------------------------------------------------------------------------------------------------------------------------------------------------
-------------------------------------------------------------------------------------------------------------------------------------------------------
-------------------------------------------------------------------------------------------------------------------------------------------------------
-----!-------S---------------#-----SU------------------------#--#!--!-------#-------------------##--------------SS!S-----------!--!---SU---------------
-----------------------##---##--------------------#---------##--#-----------##----#-----t------###-----------------------------------------------------
----------------------###---##------------tt------##-------###--#-----------##----##----t-----#####-------------------------tt-------------------------
-M------k-----tt-----####---##--#---------tt------###-----####--#------gg---##g---###---t-g--#######---------######-----gg--tt--------------------####-
XXXXXXXXXXXXXXXXXXXXXXXXXXXXXXXXXXXXXXXXXXXXX-XXXXXXXXXXXXXXXXXXXXXXXXXXXX--XXXXXXXXXXXXXXXXXXXXXXXXXX-XXXXXXXXXXXXX-XXXXXXXXXXXXXXXXXXXXXXXXXXX--XXXXX
XXXXXXXXXXXXXXXXXXXXXXXXXXXXXXXXXXXXXXXXXXXXX-XXXXXXXXXXXXXXXXXXXXXXXXXXXX--XXXXXXXXXXXXXXXXXXXXXXXXXX-XXXXXXXXXXXXX-XXXXXXXXXXXXXXXXXXXXXXXXXXX--XXXXX
