--------------------------------------------------------------------------------------------------------------------------
--------------------------------------------------------------------------------------------------------------------------
------------------------------------------------------------------------!-------------------------------------------------
--------------------------------------------------------------------------------------------------------------------------
--------------------------------------------------------------------------------------------------------------------------
------------------------------------------------------------------####--####----------------------------------------------
-------------------!-------------------------SS!S--------SU-------XXXXX-####----------------------------------------------
------------------------------------------------------------------XXXXX-####----------------------------------------------
------------------------------------------------------------------------####----------------------------------------------
-------------------####-----------SSS!--------####-------------SSS!----------#--------------------------------------------
-------------------####-----------------------####---------#----------------##----------------SU--------------------------
------SU-----------####-----------------------####--------##---------------###----------------------#---------------------
----------------tt-####-----------------------####-------###--------------####-------tt-------------##--------------------
-M--------------tt-####--------##-----k-----gg####--g-g--####-------------########---tt----------tt-###------gg-----------
XXXXXXXXXXXXXXXXXXXXXXXXXXXXXXXXXXXXXXXXXXXXXXXXXXXXXXXXXXXXXXXXXXXXXXXX--XXXXXXXXXXXXXXXXXXXXXXXXXXXXXXXXXXXXXXXXXXXXXXXX
XXXXXXXXXXXXXXXXXXXXXXXXXXXXXXXXXXXXXXXXXXXXXXXXXXXXXXXXXXXXXXXXXXXXXXXX--XXXXXXXXXXXXXXXXXXXXXXXXXXXXXXXXXXXXXXXXXXXXXXXX
