---------------------------------------------------------------------------------------------------------------------------------------
---------------------------------------------------------------------------------------------------------------------------------------
---------------------------------------------------------------------------------------------------------------------------------------
---------------------------------------------------------------------------------------------------------------------------------------
---------------------------------------------------------------------------------------------------------------------------------------
---------------------------------------------------------------------------------------------------------------------------------------
----------------------------------------S!!-----##-----@-------------------------------------------------------------------------------
---------------------S-------------------------###-------------------------------------------------------------------------------------
----------------------------------------------####-------------------------------------------------------------------------------------
--------------------g----------------------#----####-----------------------------------------------------------------------------------
-----##-----------------------------------##----####------!----------------SU---------##-----S!!S-----##--#----------------------------
----###-----------S@S------t-------------###----####-----------tt-t------------------###-------------###--##---------------------------
---####--------------------t---------tt-####----####-----------tt#t-----------------####------------####--##--tt---tt------------------
-M------k-------------####-t-g--gg---tt#####---gg---tt---------tt-t-g------------------------------#####--##--tt#--tt---------------tt-
XXXXXXXXXXXXXXXXXXXXXXXXXXXXXXXXXX---tt-XXXXXXXXXXXXXXXXXXXXXXXXXXXXXXXXXXXXXXXXXXXXXXXXX--XXXXXXXXXXXXX--XXXXXXXXXXXX-XXXXXXXX--XXXXXX
XXXXXXXXXXXXXXXXXXXXXXXXXXXXXXXXXXXXXXXXXXXXXXXXXXXXXXXXXXXXXXXXXXXXXXXXXXXXXXXXXXXXXXXXX--XXXXXXXXXXXXX--XXXXXXXXXXXX-XXXXXXXX--XXXXXX
