--------------------------------------------------------------------------------------------------------------------------------------
--------------------------------------------------------------------------------------------------------------------------------------
--------------------------------------------------------------------------------------------------------------------------------------
--------------------------------------------------------------------------------------------------------------------------------------
---------------------------------------------------------------------------------------------------------g----------------------------
--------------------------------------------------------------------------------------------------------SSSSSSS---SSS!----------------
--------------------------##----------------------------------------------------------------------------------------------------------
-------------------------###----------------------------------------------------------------------------------------------------------
------------------------####----------------------------------------------------------------------------------------------------------
-------------------------------------#------------------------------------------------------------------------#-----------------------
----------!-------------------------##---------S!!S------------------SU-------##---------------S-----##------##-----!--!--------------
-----------------------------------###-----------------#---------------------###--------------------###-----###--------------t--------
-----tt---------------------------####-----------------##-------------------#####------------------#####---####-------------#t--------
-M---tt------------------gg-------####-gg---tt------k--###-----------------#######---------##g----#######--####------------##t-g------
XXXXXXXXXXXXXXXXXXXX--XXXXXXXXXX--XXXXXXXXXXXXXXXXXXXXXXXXXXXXXXX--XXXXXXXXXXXXXXXXXXXXXX--XXXXXXXXXXXXXXXXXXXXXXXXXXXXXXXXXXXXXXXXXXX
XXXXXXXXXXXXXXXXXXXX--XXXXXXXXXX--XXXXXXXXXXXXXXXXXXXXXXXXXXXXXXX--XXXXXXXXXXXXXXXXXXXXXX--XXXXXXXXXXXXXXXXXXXXXXXXXXXXXXXXXXXXXXXXXXX
