----------------##--#-----k------####-----tt-------------------------------------------------------------------
----------------XXXXXXXXXXXXXXXXXXXXXXXXXXXXXXXXXXXXXXXX####---------------------------------------------------
----------------XXXXXXXXXXXXXXXXXXXXXXXXXXXXXXXXXXXXXXXX####---------------------------------------------------
--------------------------------------------------------####---------------------------------------------------
--------------------------------------------------------####---------------------------------------------------
-----------------------------------------------------------------------tt--------------------------------------
-----------------------------------------------------------SS----------tt----@---------------------------------
-----------------------------------------------------------------------tt--------------------------------------
-----------------------------------------------------g-------------g-g-tt--------------------------------------
-------------------------------------------------------------#-------------------------------------------------
--------------------------SU-----------------------S@S------##-----S@S!S-----!--!-----S---SS!S---------S@S!S---
-----------------------------#----------#------------------###-------------------------------------------------
-------#---------------------##---------##----------------####-------------------------------------------------
-M--gg-##-----------------tt-###--------###--------k---gg-####---gg-g----------------tt-----------------g------
XXXXXXXXXXXXXXXXXXXXX--XXXXXXXXXXXX-XXXXXXXXXXXXXXXXXXXXXXXXXXXXXXXXXXXXXXXXXXXXXXXXXXXXXXXXXXXXXX-XXXXXXXXXXXX
XXXXXXXXXXXXXXXXXXXXX--XXXXXXXXXXXX-XXXXXXXXXXXXXXXXXXXXXXXXXXXXXXXXXXXXXXXXXXXXXXXXXXXXXXXXXXXXXX-XXXXXXXXXXXX
