---------------------------------------------------g-------------------------------------------------------------------------------
--------------------------------------------------SSSSSSS---SSS!-------------------------------------------------------------------
-----------------------------------------------------------------------------------------------------------------------------------
-----------------------------------------------------------------------------------------------------------------------------------
-----------------------------------------------------------------------------------------------------------------------------------
------------------------------------------------------XXXXX####--------------------------------------------------------------------
------------------------------------------------------XXXXX####---------------------------------------------------S----------------
-----------------------------------------------------------####--------------------------------------------------------------------
-----------------------------------------------------------####--------------------------------------------------------------------
------------------------------SSS!---------------g---------------------1-----------------------------------------------------------
------S----------------------------------------------S!!S-------------------------SSS!----------------------#----SS----------------
------------------------t----------------------S@S---------------------------------------SU------#-----t---##----------------------
-----------------tt----#t-----------------------------------------#------------------------------##----t---##----------------------
-M-####----------tt---##t-g----tt--------------------------------##-----####--g------------------###---t-g-##--#---tt--------------
XXXXXXXXXXXXX--XXXXXXXXXXXXXXXXXXXXXXX--XXXXXXXXXXXXXXXXXX-XXXXXXXXXXXXXXXXXXXXXXXXXXXXXXXXXXXXXXXXXXXXXXXXXXXXXXXXXXXXXXXXXXXXXXXX
XXXXXXXXXXXXX--XXXXXXXXXXXXXXXXXXXXXXX--XXXXXXXXXXXXXXXXXX-XXXXXXXXXXXXXXXXXXXXXXXXXXXXXXXXXXXXXXXXXXXXXXXXXXXXXXXXXXXXXXXXXXXXXXXX
