--------------------------------------------------------------------------------------------------------------------------------------------
--------------------------------------------------------------------------------------------------------------------------------------------
--------------------------------------------------------------------------------------------------------------------------------------------
--------------------------------------------------------------------------------------------------------------------------------------------
--------------------------------------------------------------------------------------------------------------------------------------------
--------------tt--------------------------------------------------------------------------SSS!----------------------------------------------
--------------tt----------------------------------------------------------@-----------------------------------------------------------------
--------------tt----------------------------------------------------------------------------------------------------------------------------
----------g-g-tt----------------------------------------------------------------------------------------------------------------------------
----------####------------------------------------------------------------------------------------------------------------------------------
----------####-------------------#--#-------------##--------##---tt-------!-------SU-------SS---!-------------------##--#-------------------
----------####-------#----------##--#------------###-------###---tt------------------------------------------------###--##------------------
---------#####-------##------tt-##--#-----------####------####---tt--------------------------------#------#--tt---####--###------#-------tt-
-M--g-g--####-----k--###-----tt-##--#----------tt--------#####g--------k-------------tt--g-g-------##----##--tt--#####--####----######---tt-
XXXXXXXXXXXXXXXXXXXXXXXXXXXXXXXXXXXXXXXXXX--XXXXXXXXXXXXXXXXXXXXXXXXXXXXXXXXXXXX--XXXXXXXXXXXXXXXXXXXXXXXXXXXXXXXXXXXX--XXXXXXXXXXXXXXXXXXXX
XXXXXXXXXXXXXXXXXXXXXXXXXXXXXXXXXXXXXXXXXX--XXXXXXXXXXXXXXXXXXXXXXXXXXXXXXXXXXXX--XXXXXXXXXXXXXXXXXXXXXXXXXXXXXXXXXXXX--XXXXXXXXXXXXXXXXXXXX
