----------------------------------------------------------------------------------###---------------------------------
---------------------------------------------------------------------------------####---------------------------------
---------------------------------------------------------------------------------####-----C-----SU--------------------
---------------------------------------------------------------------------------XXXX---------------------------------
---------------------------------------------------------------------------------XXXX---------------------------------
-------------------------------------------------------------------------------------------g--------------------------
---@-------------------------------------------------------------------------------------XXXX----SS-----SU------------
------------------------------------------------------------------------t----------------XXXX-------------------------
------------------------------------------------------------------------t---------------------------------------------
-------------------------------------------------------------#---------------1-------------------####-----------------
---!--!------------S!!S----##----------#---------------S----##--------SS-------------#-----!--!--####-----------------
--------------------------###----------##------------------###-----------------------##----------####-----------------
-------------------------#####---------###----------------####--tt-------------------###---------####-------------F---
-M----------------####--#######---gg---####---------------####--tt-------------------####-----------------gg-gg---#---
XXXXXXXX-XXXXXXXXXXXXXXXXXXXXXXXXXXXX--XXXXXXXXXX--XXXXXXXXXXXXXXXX-XXXXXXXXXXXXXXX--XXXXXXXXXXXXXXXXXXXXXXXXXXXXXXXXX
XXXXXXXX-XXXXXXXXXXXXXXXXXXXXXXXXXXXX--XXXXXXXXXX--XXXXXXXXXXXXXXXX-XXXXXXXXXXXXXXX--XXXXXXXXXXXXXXXXXXXXXXXXXXXXXXXXX
