----------------------------------------------------------------------------------------------------------------------
-----------------------------------------------------------------------------------------------------------g----------
------------------------------------------------------------------------------------C---------------#-----------------
------------------------------------------------------------S-------------------SS------------------#----S@S----------
----------------------------------------------------------------------------------------------------#-----------------
-----------------------------------------------------------g-----------tt------------g---------gg---#-----------------
------------------!----------------------------------------------------tt-------###XXXXXXXXX--XXXX--XXXXXXXXXXXXXXXXXX
---------------------------------------------------------S@S-SS!S------tt-------###XXXXXXXXX--XXXX--XXXXXXXXXXXXXXXXXX
-------------------------------------------------------------------g-g-tt-------####----------------------------------
------------------------------------#------------------------------####---------####----------------------------------
-----------------------------------##---------S!!S----####------C--####-------------C---------------------------------
--------------------t-------------###-----------------####---------####------#----------------------------------------
-------------------#t------#--tt-####-----------------####---------####------##----------F----------------------------
-M----------------##t-g---##--tt-####-gg-g------------####-------g-----------###-----g---#----------------------------
XXXXXXXXXXXXXX--XXXXXXXXXXXXXXXXXXXXXXXXXXXXXXXXXXXXXXXXXXXXXXXXXXXXXXXXXXXXXXXXXXXXXXXXXXXXX-------------------------
XXXXXXXXXXXXXX--XXXXXXXXXXXXXXXXXXXXXXXXXXXXXXXXXXXXXXXXXXXXXXXXXXXXXXXXXXXXXXXXXXXXXXXXXXXXX-------------------------
