-----------------------------------------------------------------------------------tt--#######-------
-----------------------------------------------------------------------g-----------tt-########-------
-------------------------------------------------------------------------------g-g-tt-####-----------
---------------------------------------------------------------------S@S----------k---XXXXXXXXX------
-----------------------------------------------------------------------------XXXXXXXX-XXXXXXXXX------
-----------------------------------------------------------------------------XXXXXXXX----------------
------------------------------------##----------------------------####--------------@----------------
-----------------------------------###----------------------------####-------------------------------
----------------------------------####----------------------------####-------------------------------
---------------SSS!----------1---#--------------------------t-----####-------------------------------
--------------------------------##--------------------------t----------C------------!--!-----------##
-------------------------------###-------------S!!S---------t---SU--------------------------------###
------#----#------------------####---#------------------g-g-t---------------F--------------------####
-M---##-gg-##-----tt--gg------####--##--------------------tt------------g---#-------------------#####
XXXXXXXXXXXXXXXXXXXXXXXXXXXXXXXXXXXXXXXXXXXXXXXXXXXXXXXXXXXXXXXXXXXXXXXXXXXXXXXX----XXXXXXXXX--XXXXXX
XXXXXXXXXXXXXXXXXXXXXXXXXXXXXXXXXXXXXXXXXXXXXXXXXXXXXXXXXXXXXXXXXXXXXXXXXXXXXXXX----XXXXXXXXX--XXXXXX
