----------------------------------------------------------------------------------------------------------------------------------------------
----------------------------------------------------------------------------------------------------------------------------------------------
----------------------------------------------------------------------------------------------------------------------------------------------
----------------------------------------------------------------------------------------------------------------------------------------------
----------------------------------------------------------------------------------------------------------------------------------------------
----------------------------------------------------------------------------------------------------------------------------------------------
------------------------------------------------------------------------@---------------------------------------------------------------------
------------------------------------------------------------S!!S------------------------------------------------------------------------------
----------------------------------------------------------------------------------------------------------------------------------------------
-----------tt---------------tt-----SSS!-g-----------------------------------------------------------------------------------------------------
-----------tt---------------tt---------SSSSSSS-----------------C------S-!--!------##----------!-------------------------SS!S----------S@S!S---
---t-------tt--#------------tt----------------------tt---------------------------###----------------------------------------------------------
---t---g-g-tt--##-------g-g-tt----------------------tt#---#---------------------####-----------------------#----------------------------------
-M-t-g------k--###----------------------------------------##----g----------------------------------g----gg-##---------tt------k-----gg-g------
XXXXXXXXXXXXXXXXXXXXXXXXXXXXXXXXXXXXXXXXXXXXXXXXXXXXXXXXXXXXXXXXXX-XXXXXXXXXXXXXXXXXXXXXXXXXXXXXXXXXXXXXXXXXXXXXXXXXXXXXXXXXXXXXXXXXXXXXXXXXXX
XXXXXXXXXXXXXXXXXXXXXXXXXXXXXXXXXXXXXXXXXXXXXXXXXXXXXXXXXXXXXXXXXX-XXXXXXXXXXXXXXXXXXXXXXXXXXXXXXXXXXXXXXXXXXXXXXXXXXXXXXXXXXXXXXXXXXXXXXXXXXX
