---------------------------------------------------------------------------------------------------------------------------------------------
---------------------------------------------------------------------------------------------------------------------------------------------
---------------------------------------------------------------------------------------------------------------------------------------------
---------------------------------------------------------------------------------------------------------------------------------------------
---------------------------------------------------------------------------------------------------------------------------------------------
-----------------------------------------------------SSS!---------------------------------g--------------------------------------------------
-----------------------------------------------------------------------------------------SSSSSSS-------------------------------S-------------
-----------------tt--------------------------------------------------------------------------------------------------------------------------
-----------------tt------------------------------------------------------------------------------------g----------------------g--------------
-----------------tt----------------------tt---------####----------------------------------------------SSSSSSS--------------------------------
-----------------C-----------------------tt---------####-------##------------------------------C----------------------##----------------!----
-----------------------!-----------------tt---------####------###----------#----------------------------------t------###---------------------
---------------------------tt----#---g-g-tt------#--####-----####----------##---------------------------------t-----####---------------------
-M----------------g--------tt---##---------------##------------------------###-----------g-g----g-------------t-g--#####g------gg---------tt-
XXXXXXX--XXXXX--XXXXXXXXXXXXXXXXXXXXXXXXXXXXXXXXXXXXXXXXXXXXXXXXXXXXXXXXX--XXXXXXXXXXX--XXXXXXXXXXXXXXX--XXXXXXXXXXXXXXXXXXXXXXXXXXXXXXXXXXXX
XXXXXXX--XXXXX--XXXXXXXXXXXXXXXXXXXXXXXXXXXXXXXXXXXXXXXXXXXXXXXXXXXXXXXXX--XXXXXXXXXXX--XXXXXXXXXXXXXXX--XXXXXXXXXXXXXXXXXXXXXXXXXXXXXXXXXXXX
