------------------------------------------------------------------------------------------------------------------------------------------------------------
------------------------------------------------------------------------------------------------------------------------------------------------------------
------------------------------------------------------------------------------------------------------------------------------------------------------------
------------------------------------------------------------------------------------------------------------------------------------------------------------
------------------------------------------------------------------------------------------------------------------------------------------------------------
----------------------------------------------------------------------------------------------------------------------SSS!----------------------------------
--------------------------------------------------------------------------------tt------------------------------##------------------------------------------
--------------------------------------------------------------------------------tt-----------------------------###------------------------------------------
--------------------------------------------------------------------------------tt----------------------------####------------------------------------------
---------------------------------------------1--------------------------------####--------------------------------------------------------------------------
--------tt-----SU--------SS!S-----------------------------------------!-------####------------------------------------------------------------------------##
--------tt--------------------------------------------------------------------####----------------SU-----------------------------------------------------###
--------tt----------------------------tt------------tt------------------------####------------------------------#---------#-----------------------------####
-M---------------------------k---g------------------tt#--------------------k----------------------------g-g----##-g-g----##----------------------------#####
XXXXXXXXXXXXXXXXXXXXXXXXXXXXXXXXXXXXXXXXXXXXXXXXXXXXXXXXXXXXX--XXXXX--XXXXXXXXXXXXXXXXXXXX--XXXXXXXXXXXXXXXXXXXXXXXXXXXXXXXXXXXXXXXXXXXXXXXXXXXXXXXXXXXXXXXX
XXXXXXXXXXXXXXXXXXXXXXXXXXXXXXXXXXXXXXXXXXXXXXXXXXXXXXXXXXXXX--XXXXX--XXXXXXXXXXXXXXXXXXXX--XXXXXXXXXXXXXXXXXXXXXXXXXXXXXXXXXXXXXXXXXXXXXXXXXXXXXXXXXXXXXXXX
