-------------------------------------------------------------------------------------------------------------------------------------------------
-------------------------------------------------------------------------------------------------------------------------------------------------
-------------------------------------------------------------------------------------------------------------------------------------------------
-------------------------------------------------------------------------------------------------------------------------------------------------
-------------------------------------------------------------------------------------------------------------------------------------------------
--------------------------------------------------------------SSS!-------------------------------------------------------------------------------
-------@-----------------------------------------------------------------------------------------------------------------------------------------
------------------------------------------------------S------------------------------------------------------------------------------------------
-------------------------------------------------------------------------------------------------------------------g-----------------------------
------#-------------1---------------------------------------------------------------------------------------------SSSSSSS------------------------
-----##!--!-----------------SS!S---!-------S!!S-----------------S!!S----------##---------##-------##-----#---S!!S-----------------tt-------------
----###----------------------------------------------------------------------###--------###------###----##------------------------tt-------------
---####----------------tt-------------------------#-------------------------#####------####-----####----##------------------------tt-------------
-M-####------gg--------tt-------------k---g-g----##-----------####-----k---#######-------------#####g---##--#---tt----------------------------tt-
XXXXXXXXXXXXXXXXXXXXXXXXXXXXXXXXXXXXXXXXXXXXXXXXXXX-XXXXXXXXXXXXXXXXXXXXXXXXXXXXXXXXXXXXXXXXXXXXXXXXXXXXXXXXXXXXXXXXXXXXXXXXXXXXXXXXXXXXX--XXXXXX
XXXXXXXXXXXXXXXXXXXXXXXXXXXXXXXXXXXXXXXXXXXXXXXXXXX-XXXXXXXXXXXXXXXXXXXXXXXXXXXXXXXXXXXXXXXXXXXXXXXXXXXXXXXXXXXXXXXXXXXXXXXXXXXXXXXXXXXXX--XXXXXX
