----------------------------------------------------------------------------------------------------------------------------------------------
----------------------------------------------------------------------------------------------------------------------------------------------
----------------------------------------------------------------------------------------------------------------------------------------------
----------------------------------------------------------------------------------------------------------------------------------------------
----------------------------------------------------------------------------------------------------------------------------------------------
----------------------------------------------------------------------------------------------------------------------------------------------
-----------------------------------------@---------------------S------------------------------------------------------------------@-----------
----------------------------------------------------------------------------------------------------------------------------------------------
----------------------------------------------------------------------------------------------------------------------------------------------
-------1----------------------------tt-----------------------------gg-------------------------------------------------------------------------
----------------------!-------------tt---!--!-----------!---------XXXX---------S!!S-----------SU-------------SS!S-----------------!--!--------
------------------------------------tt----------------------------XXXXtt---------------------------t-----------------SS!S---------------------
----------tt----------------tt--g-g-tt--#-----------------------------tt---------------------------t------#-----------------------------------
-M--------tt----------------tt----tt---##----------------------gg----------------------------------t-g---##-----------------------------------
XXXXXXXXXXXXXXXXXXXXXXXXXXXXXXXXXXXXXXXXXXXXXXXXXXX--XXXXXXXXXXXXXXXXXXXXXXX--XXXXXXXXXXXXXX--XXXXXXXXXXXXXXXXXXXXXXXXXXXXXXXXXXXXXXXXXXXXXX--
XXXXXXXXXXXXXXXXXXXXXXXXXXXXXXXXXXXXXXXXXXXXXXXXXXX--XXXXXXXXXXXXXXXXXXXXXXX--XXXXXXXXXXXXXX--XXXXXXXXXXXXXXXXXXXXXXXXXXXXXXXXXXXXXXXXXXXXXX--
