----------------------------------------------------------------------------------------------------------------------------------------
----------------------------------------------------------------------------------------------------------------------------------------
----------------------------------------------------------------------------------------------------------------------------------------
----------------------------------------------------------------------------------------------------------------------------------------
----------------------------------------------------------------------------------------------------------------------------------------
------------------------------------SSS!------------------------------------------------------------------------------------------------
---------------------------------------------------------------------------------------------------------@----------------@----SS!S@----
----------------------------------------------------------------------------------------------------------------------------------------
----------------------------------------------------------------------------------------------------------------------------------------
-------------------------####-------------------------------------------tt--------------------------------------------------------#-----
----#--#-----------------####--------SS--------!-------SSS---S!!S-------tt------S!!S----------##---------!--!-------------!--!---##!--!-
---##--#-----------------####-------------------------------------------tt-------------------###--------------------------------###-----
---##--#-----------------####---------------------------------------g-g-tt------------------####-------------------------------####-----
-M-##--#-----------------------k---------------------------------------k-----tt-###----g-g-------k--####-------------####------####-----
XXXXXXXXXXXX--XXXXX--XXXXXXXXXXXXXXXXXXXXXXXXXXXXXXXXXXXXXXXXXXXXXXXXXXXXXXXXXXXXXXXXXXXXXXXXXXXXXXXXXXXXXXXXXXXXXX--XXXXXXXXXXXXXXXXXXX
XXXXXXXXXXXX--XXXXX--XXXXXXXXXXXXXXXXXXXXXXXXXXXXXXXXXXXXXXXXXXXXXXXXXXXXXXXXXXXXXXXXXXXXXXXXXXXXXXXXXXXXXXXXXXXXXX--XXXXXXXXXXXXXXXXXXX
