----------------------------------------------------------------------------------------------------------g--------------
---------------------------------------g---------------------------------------------------------------------------------
-------------------------------------SSSSSSSS---SSS!-----------------1------S@S!S-------------!---------S@S------------##
--------------------------------------------------------------SS------------------------------------------------------###
------------------------------------g--------------------------------------------------#-----------------------------####
--------------------------------------------------------------------------gg-g---------##---------------------------#####
----------------------------------S@S-----------------k---gg-g--------XXXXXXXXXXXXXXXXXXXXXXXXXXXXXXXXXXXXXXXXXXXXXXXXXXX
------------SS!S---------------------------------XXXXXXXXXXXXXXXXXXXXXXXXXXXXXXXXXXXXXXXXXXXXXXXXXXXXXXXXXXXXXXXXXXXXXXXX
-------------------------------------------------XXXXXXXXXXXXXXXXXXXXX---------------------------------------------------
-------------------------------####--------------------------------------------------------------------------------------
---------S@S---C-----SSS!---#--####---------S@S!S------------------------------------------------------------------------
---------------------------##--####--------------------------------------------------------------------------------------
---------------------------##--####--------------------------------------------------------------------------------------
-M--------t-g---g----------##--#---tt-###----g---------------------------------------------------------------------------
XXXXXXXXXXXXXXXXXXXXXXXXXXXXXXXXXXXXXXXXXXXXXXXXXXXX---------------------------------------------------------------------
XXXXXXXXXXXXXXXXXXXXXXXXXXXXXXXXXXXXXXXXXXXXXXXXXXXX---------------------------------------------------------------------
