--------------------##----------------------------------------------------------------------####------------
---------------g---###--------------------------------------------------------------------------------------
-------------------------------------------------------!--!-S-!--!-----S----tt-###-------------#---SU-------
-------------S@S--------SS!S-!--!--------!--!---!------------------------XXXXXX###------------##------------
----------------------------------------------------tt-------------------XXXXXX###-----------###------------
----------------------------------------------------tt---------tt-------------####-----------####-g-g-------
--------------------gg-----------------------XXXXXXXXXXXXXXXXXXXXXXXXXXXXXXXXXXXXXXXXXXX-XXXXXXXXXXXXXXXXXXX
------XXXXXXXXXXXXXXXX-------XXXXXXXXXX--XXXXXXXXXXXXXXXXXXXXXXXXXXXXXXXXXXXXXXXXXXXXXXX-XXXXXXXXXXXXXXXXXXX
------XXXXXXXXXXXXXXXX-------XXXXXXXXXX--XXXXX--------------------------------------------------------------
------------------------------------------------------------------------------------------------------------
----------####------------S@S!S-----------------------------------------------------------------------------
----------####------#---------------------------------------------------------------------------------------
----------####------##--------------------------------------------------------------------------------------
-M--------####------###----g--------------------------------------------------------------------------------
XXXXXXXXXXXXXXXXXXXXXXXXXXXXXXXXXX--------------------------------------------------------------------------
XXXXXXXXXXXXXXXXXXXXXXXXXXXXXXXXXX--------------------------------------------------------------------------
