-----------------------------------------------------------------------------------------------------------------------------------------
-----------------------------------------------------------------------------------------------------------------------------------------
-----------------------------------------------------------------------------------------------------------------------------------------
-----------------------------------------------------------------------------------------------------------------------------------------
-----------------------------------------------------------------------------------------------------------------------------------------
-----------------------------------------------------------------------------------------------------------------------------------------
----------------------------------------------------------------------------------------##-----------------------------------------------
---------------------------------------------------------------------------------------###-----------------------------------------------
--------------------------------------------------------------------------------------####-----------------------------------------------
----------------------------------SSS!--------------1------------------------1-----------------------------------------------------------
-----------------##------S!!S--------------------------------##-----------------------SS-------------#--#-----SU--------##---------##----
---#------------###--------------------------SU------t------###----#--------------------------------##--#--------------###--------###----
---##----------####----------------------------------t-----####----##-----------------------tt------##--#-------------####-------####----
-M-###----g-g####----tt------k----------gg-----------t-g--#####g---###----------------------tt----gg##--#-g-g-----tt------------#####g---
XXXXXXXXXXXXXXXXXXXXXXXXXXXXXXXXXXXXXXXXXXXXXXXXXXXXXXXXXXXXXXXXXXXXXXXXXXXXXXXXXXXXXXXXXXXXXXXXXXXXXXXXXXXXXXXXXXXXXXXXXXXXXXXXXXXXXXXXX
XXXXXXXXXXXXXXXXXXXXXXXXXXXXXXXXXXXXXXXXXXXXXXXXXXXXXXXXXXXXXXXXXXXXXXXXXXXXXXXXXXXXXXXXXXXXXXXXXXXXXXXXXXXXXXXXXXXXXXXXXXXXXXXXXXXXXXXXX
