--------------------------------------------------------------------------S!!S--###------------------------------------
-------------------------------------------------------------------------------####------------------------------------
--------------------------####-------------------------------------------------####-----------------------------tt-----
----------------------SU--####-------------------------------------------------XXXX-----------------------------tt-----
--------------------------####-------------------------------------------------XXXX---------t-------------------tt-----
------------------g-------####----------------------------------tt-------------------------#t---------------g-g-tt-----
-------------------------------------gg---------------------gg--tt----gg------------g-----##t-g------g--------------gg-
----------------S@S----SS----XXXXXXXXXXXXXXXXXXXXXXXXXX--XXXXXXXXXXXXXXXXXXXX--XXXXXXXXXXXXXXXXXXXXXXXXXXXXXXXXXXXXXXXX
-----------------------------XXXXXXXXXXXXXXXXXXXXXXXXXX--XXXXXXXXXXXXXXXXXXXX--XXXXXXXXXXXXXXXXXXXXXXXXXXXXXXXXXXXXXXXX
-----------------------------------------------------------------------------------------------------------------------
-------##-----------------S!!S-----------------------------------------------------------------------------------------
------###----SS--------------------------------------------------------------------------------------------------------
-----####--------------------------------------------------------------------------------------------------------------
-M--#####--------------------#-----------------------------------------------------------------------------------------
XXXXXXXXX--XXXXXXXXXXXXXX---##-----------------------------------------------------------------------------------------
XXXXXXXXX--XXXXXXXXXXXXXX--###-----------------------------------------------------------------------------------------
