------------------------------------------------------------------------------------------------------------------------------------
------------------------------------------------------------------------------------------------------------------------------------
------------------------------------------------------------------------------------------------------------------------------------
------------------------------------------------------------------------------------------------------------------------------------
-------------------------------------------------------------------------g----------------------------------------------------------
----------------------------------------------------------SSS!----------SSSSSSS-----------------------------------------------------
-----------------------------------------------------------------------@------------------------------------------SS!S-----------S--
------------------------------------------------------------------------------------------------------------------------------------
-------------------g------------------------------------------------------------------------------------------------------------g---
------------------SSSSSSS----------------------------------#----------------####----------------------------------1####-------------
----------SS!S---------------SU----------SU---------------##-----------!--!-####------C-----------------SU---------####-------S@S---
---------------t-----------------------------------------###----------------####-----------------------------------####-------------
---------------t-------------------------------------tt-####----------------####-------------#---------------------####-------------
-M-------------t-g--------------tt-------------------tt-####---gg-----------------k----g--gg-##------------k-------------g-g-----tt-
XXXXXXXX--XXXXXXXXXXXXXXXXXXXXXXXXX-XXXXXXXXXXXXX--XXXXXXXXXXXXXXXXXX--XXXXX-XXXXXXXXXXXXXXXXXXXXXXXXXXXXXXXXXXXXXXXXXXXXXXXXXXXXXXX
XXXXXXXX--XXXXXXXXXXXXXXXXXXXXXXXXX-XXXXXXXXXXXXX--XXXXXXXXXXXXXXXXXX--XXXXX-XXXXXXXXXXXXXXXXXXXXXXXXXXXXXXXXXXXXXXXXXXXXXXXXXXXXXXX
