-----S------------S---C------!S---------------------
----------------------------------------------------
-----------#-------------#--------------------------
-----------##----------g-##---C-----SU--------------
------XXXXXXXXX-XXXXXXXXXXXXX-----------------------
------XXXXXXXXX-XXXXXXXXXXXXX-----------------------
------------------------@------g-----####-----------
-----------------------------XXXX----####-----------
-----------------------------XXXX----####-----------
-------------------------------------####-----------
---------##-------------!-----S!!S-------C--S@S!S---
--------###-----------------------------------------
-------####---#-------------------------------------
-M----tt------##---g-g--------g-g---------g--g------
XXXXXXXXXXXXXXXXXXXXXXXXXXXXXXXXXXXXXXXXXXXXXXXXXXXX
XXXXXXXXXXXXXXXXXXXXXXXXXXXXXXXXXXXXXXXXXXXXXXXXXXXX
