--C-------------S----!----##----------####---------------------
----------S!!S-----------###----------####--------F------------
------------------------####----------------------#------------
---g-------------------------------------SS-----XXXXXX---------
-XXXXXXXXXXXXXXXXXXXXXXXX-----------------------XXXXXX---------
-XXXXXXXXXXXXXXXXXXXXXXXX--------------------------------------
------------------------g----gg-----SSS!-####------------------
-----------XXXXXXXXXXXXXXXXXXXX----------####------------------
-----------XXXXXXXXXXXXXXXXXXXX----------####------------------
-----------------------------------------####------------------
--------------S!!S----------tt----#----------C-----------------
----------#-----------------tt----#-----------------!----------
---------##-----------------tt----#--------#---------------F---
-M-------####-----------------##--#-------##--g------------#---
XXXXXXXXXXXXXXXXXXXXXXXXXXXXXXXXXXX-XXXXXXXXXXXXXXXXXXXXXXXXXXX
XXXXXXXXXXXXXXXXXXXXXXXXXXXXXXXXXXX-XXXXXXXXXXXXXXXXXXXXXXXXXXX
