----------------------------------------------####------------------------
----------------------------------------------####------------------------
----------------k----------------------------------#----------------------
-----XXXXXXXXXXXXXXXXXXX-XXXXXXXXXXXXXX-----------##-------SS!S-----------
-----XXXXXXXXXXXXXXXXXXX-XXXXXXXXXXXXXX----------###----------------------
------------------------------------------------####----------------------
----------------------------------------SS------####---gg---####----------
------------------------------------------------XXXXXXXXX---####----------
---------------------------------------------F--XXXXXXXXX---####----------
---------------------------------------------#--------------####----------
----!--------tt------------------SS!S------XXXXXXS!!S-----##-----C--------
-------------tt----------------------------XXXXXX--------###--------------
-------------tt-----------------------------------------####----------F---
-M----tt---------------------gg----------gg------g-g---#####g-----g---#---
XXXXXXXXXXXXXXXXXXXXX-XXXXXXXXXXXXXXXXXXXXX-XXXXXXXXXXXXXXXXXXXXXXXXXXXXXX
XXXXXXXXXXXXXXXXXXXXX-XXXXXXXXXXXXXXXXXXXXX-XXXXXXXXXXXXXXXXXXXXXXXXXXXXXX
