--------##--#-------------#-------##--####----------------###---tt-----------------------#----------####-------#---------
--------##--#####--------#####g---###--------####--------####---tt----------------------##----------####---gg-#####g-----
-SU-----XXXXXXXXXXXXXXXXXXXXXXXXXXXXXXXXXXXXXXXXXXXXXXXXXXXXXXXXXXXXXXXXXXXXXXXXXXXX--XXXXXXXXX-XXXXXXXXXXXXXXXXXXXXXXX--
--------XXXXXXXXXXXXXXXXXXXXXXXXXXXXXXXXXXXXXXXXXXXXXXXXXXXXXXXXXXXXXXXXXXXXXXXXXXXX--XXXXXXXXX-XXXXXXXXXXXXXXXXXXXXXXX--
-------------------------------------------------------------------------------------------------------------------------
--------####-------------------------------------------------------------------------------------------------------------
--------####-------------------------------------------------------------------------------------------------------------
--------####-------------------------------------------------------------------------------------------------------------
--------####-------------------------------------------------------------------------------------------------------------
-------------------------------------------------------------------------------------------------------------------------
--------------S@S!S------------------------------------------------------------------------------------------------------
---#---------------------------------------------------------------------------------------------------------------------
---##--------------------------------------------------------------------------------------------------------------------
-M-###------gg-g---------------------------------------------------------------------------------------------------------
XXXXXXXXXXXXXXXXXXXXXX---------------------------------------------------------------------------------------------------
XXXXXXXXXXXXXXXXXXXXXX---------------------------------------------------------------------------------------------------
