-------------------------------------------------------------------------------------------------------------------------------------
-------------------------------------------------------------------------------------------------------------------------------------
-------------------------------------------------------------------------------------------------------------------------------------
-------------------------------------------------------------------------------------------------------------------------------------
-------------------------------------------------------------------------------------------------------------------------------------
-------------------------------------------------------------------------------------------------------------------------------------
----------------------S!!S-------S-----------------------------------------------------------------------------@---------------------
----------------------------------------------------------------------------------------------------------------------tt-------------
--------------------------------g-------------------------------------------------------------------------------------tt#------------
-----------------####-----------------------------------------------------------------------1-----------------1-----####-------------
------------S----####---------S@XXXXX-----------#--------------------#--#---------##---------------------------!--!-####-------------
-----------------####-----------XXXXX-----------##-----------S!!S---##--#--------###----------------#---------------####-------------
-----tt----------####------------------tt-------###-----------------##--#--tt---#####-----------g-g-##--------------####-------------
-M---tt--------------tt--g-g-----------tt--gg---####----------------##--#--tt--#######--------------###------------------------------
XXXXXXXXXXXXXXXXXXXXXXXXXXXXXXXXXXXXXXXXXXXXXX--XXXXXXXXXXX--XXXXXXXXXXXXXXXXXXXXXXXXXXXXXXXXXXXXXXXXXXXXXXXXXXXXXXX---XXXXXXXXXXXX--
XXXXXXXXXXXXXXXXXXXXXXXXXXXXXXXXXXXXXXXXXXXXXX--XXXXXXXXXXX--XXXXXXXXXXXXXXXXXXXXXXXXXXXXXXXXXXXXXXXXXXXXXXXXXXXXXXX--#XXXXXXXXXXXX--
