-------------------------------------------------------------------------------------------------------------------------------------------
-----------------------------------------------------------------g-------------------------------------------------------------------------
-------------------------------------------------------------------------------------------------------------------------------------------
---------------------------------------------------------------S@S-------------------------------------------------------------------------
-------------------------------------------------------------------------------------------------------------------------------------------
-------------------------------------------------------------------------------------------------------------------------------------------
-------@----------------------------------------------------####---------------------------------------------------------------------------
-SU---------------------------------------------------------####---------------------------------------------------------------------------
------------------------------------------------------------####---------------------------------------------------------------------------
-----------------------------------------------------------S####---------------------------------------------------------------------------
----C--!--!-----##--------##--#------#--#-------!-------------------SS!S--------##-----##----------##------------------------------S@S!S---
---------------###-------###--##----##--#------------tt------------------------###----###---------###--------------------------------------
--------------#####-----####--###---##--#------------tt#----------------------####---####--tt----####--------------------------------------
-M---g-------#######---#####--####--##--#---------------g-g----------------##--------------tt-----------tt---------------g-g--------g------
XXXXXXXXXXXXXXXXXXXXXXXXXXXX--XXXXXXXXXXXXXXXXXXXXXXXXXXXXXXX-XXXXXXXXXXXXXXXXXXXXXXXXXXXXXXXXXXXXXXXXXXXXXXXXXX--XXXXXXXXXXXXXXXXXXXXXXXXX
XXXXXXXXXXXXXXXXXXXXXXXXXXXX--XXXXXXXXXXXXXXXXXXXXXXXXXXXXXXX-XXXXXXXXXXXXXXXXXXXXXXXXXXXXXXXXXXXXXXXXXXXXXXXXXX--XXXXXXXXXXXXXXXXXXXXXXXXX
