------------------------------------------------------------------------------------------------------------------------------------------------
------------------------------------------------------------------------------------------------------------------------------------------------
------------------------------------------------------------------------------------------------------------------------------------------------
------------------------------------------------------------------------------------------------------------------------------------------------
------------------------------------------------------------------------------------------------------------------------------------------------
------------------------------------------------------------------------------------------------------------------------------------------------
---------------------------@------------------------------------------!-------------------------------------------------------------------------
------------------------------------------------------------------------------------------------------------------------------------------------
------------------------------------------------------------------------------------------------------------------------------------------------
-------------------------------------------------------------------####--------------------------------------1----------------------------------
----------------##--#-----t!--!------------#--#----##--------------####-----------------##--#--#------------------------------------------------
-----S!!S------###--#-----t-----t---#-----##--#---###----!---------####----------------###-##--#------------------------t-----------------------
--------------####--#-----t-----t---##----##--#--####-----------tt-####-----#---------####-##--#--tt--------------------t-----tt----------------
-M-----------#####--#-g-g-t-----t-g-###---##--#-#####-----------tt----tt----##----------tt-##--#--tt--gg----------------t-g---tt----gg----------
XXXXXXXXXXXXXXXXXX--XXXXXXXXXXXXXXXXXXXXXXXXXXXXXXXXX--XXXXXXXXXXXXXXXXXXXXXXXXXXXXXXXXXXXXXXXXXXXXXXXXXXXXXXXXXXXXXXXXXXXXXXXXXXXXXXXXXXXXXXXXX
XXXXXXXXXXXXXXXXXX--XXXXXXXXXXXXXXXXXXXXXXXXXXXXXXXXX--XXXXXXXXXXXXXXXXXXXXXXXXXXXXXXXXXXXXXXXXXXXXXXXXXXXXXXXXXXXXXXXXXXXXXXXXXXXXXXXXXXXXXXXXX
