----------------------------------####-----------------------------------------------
----------------------------------####------tt---------------------------------------
---------------------------------------tt---tt----tt---------------------------------
-------------------------XXXXXXXXXXXXXXXXXXXXXXXXXXXX-XXXX-SS-XXXXX------------------
-------------------------XXXXXXXXXXXXXXXXXXXXXXXXXXXX-XXXX----XXXXX------------------
-------------------------------------------------------------------------------------
-------------------------------------------------------------C-----SU---S!!S---------
-------------SU----------------------------------------------------------------------
-------------------------------------------------------------------------------------
--------------------------------------------------------------g-------k--------------
-------------C---------------------------------##--------!--XXXX-XXXXXXXX----S@S!S---
---------------------t-------------SU---------###-----------XXXX-XXXXXXXX------------
---------------------t-----------------------#####-----------------------------------
-M--gg--------g----ggt-g--------------------#######-----tt---------g-g-----gg-g------
XXXXXXXXXXXXXXXXXXXXXXXXXXXXXX--XXXXXXXXXXXXXXXXXXXXXXXXXXXXXXXX--XXXXXXXXXXXXXXXXXXX
XXXXXXXXXXXXXXXXXXXXXXXXXXXXXX--XXXXXXXXXXXXXXXXXXXXXXXXXXXXXXXX--XXXXXXXXXXXXXXXXXXX
