-------------------------------------------------------------------------------------------------------------------------------------------------------
-------------------------------------------------------------------------------------------------------------------------------------------------------
-------------------------------------------------------------------------------------------------------------------------------------------------------
-------------------------------------------------------------------------------------------------------------------------------------------------------
-------------------------------------------------------------------------------------------------------------------------------------------------------
----------------------------------------------------------------------tt-------------------------------------------------------------------------------
----------------------------------------------------------@-----------tt--------------------------------------------------------------------------@----
----------------------------------------------------------------------tt-------------------------------------------------------------------------------
------------------------------------------------------------------g-g-tt-------------------------------------------------------------------------------
-------------------------------------------------------------------------------------------------------------------------------------------------------
----------------##----------------------------------------!--!------------------------------------tt---------------##--#-----------------SS!S-----!--!-
---------------###---S!!S--#----------#-----------------------------------#----------------!------tt--------------###--##-----#------------------------
-----tt----#--####---------##---------##---------#-----tt-----------------##-------#--------------tt-------------####--##-----##-----------------#-----
-M---tt---##-#####---------###--------###--------##----tt---------------gg###-----##-------------------------gg-#####--##-----###-----######----##-----
XXXXXXXXXXXXXXXXXX--XXXXXXXXXXXXX-XXXXXXXXXXXXXXXXXXXXXXXXXXXXX--XXXXXXXXXXXXXXXXXXXXXXXXXXXXXXXXXXXXXXXXXXXXXXXXXXXX--XXXXXXXXXXXXXXXXXXXXXX-XXXXXXXXX
XXXXXXXXXXXXXXXXXX--XXXXXXXXXXXXX-XXXXXXXXXXXXXXXXXXXXXXXXXXXXX--XXXXXXXXXXXXXXXXXXXXXXXXXXXXXXXXXXXXXXXXXXXXXXXXXXXX--XXXXXXXXXXXXXXXXXXXXXX-XXXXXXXXX
