--------------------------------------------------------------
------------k-------k-----------------------------------------
-------XXXXXXXXXXXXXXXXXXXXXXXXXXX-C--!--!----SU--------------
-------XXXXXXXXXXXXXXXXXXXXXXXXXXX----------------------------
-------------g------------------------------------------------
------------SSSSSSS-----------------g-------####--------------
---------------------------------@XXXXXXXXX-####--------------
----------------------------------XXXXXXXXX-####--------------
--------------------------------------------####--------------
------------------#-----------------------1-------------------
-----------#--#--##--------SU----!--!---------SS------##------
----------##--#-###----------------------------------###------
----------##--#####---------------------------------####--F---
-M--------##--#####----g-g-------------------------#####--#---
XXXXXXXX--XXXXXXXXXXXXXXXXXXXXXXXXXXXXXXXXXXXXXXXXXXXXXXXXXXXX
XXXXXXXX--XXXXXXXXXXXXXXXXXXXXXXXXXXXXXXXXXXXXXXXXXXXXXXXXXXXX
