------------------------------------------------------------------------------------------------------------------------------------------
------------------------------------------------------------------------------------------------------------------------------------------
------------------------------------------------------------------------------------------------------------------------------------------
------------------------------------------------------------------------------------------------------------------------------------------
------------------------------------------------------------------------------------------------------------------------------------------
--------------------------------------------------------------------------------SU-------------------------------S!!S---------------------
------------------------------------------------------------------------------------------------------------------------------------------
------------------------------------------------------------------------------------------------------------------------------------------
-----------------------------------1-----------SSS!-----------------------------#--------------------------------------------#------------
-----------------------------------------#-------------------------------------##----------##--------S--------SU------------##------#--#S-
---------------------#--#-----------t---##------------------------------------####--------###------------------------------###-----##--#--
-------------t------##--#---tt------t---##----------------------------tt-----######------#####----------------------------####--tt-##--#--
-------------t------##--#---tt#-----t-g-##--#---tt--------------------tt--gg-#######----#######--------------------gg-----####--tt-##--#--
-M-------####-------##--#---tt-XXXXXXXXXXXXXXXXXXXXXXXX---XXXXXXXXXXXXXXXXXXXXXXXXXXXXXXXXXXXXXXXXXXXXXXXXXXXXXXXXXXXXXXXXXXXXXXXXXXXXXX--
XXXXXXX--XXXXXXXXX--XXXXXXXXXXXXXXXXXXXXXXXXXXXXXXXXXXX---XXXXXXXXXXXXXXXXXXXXXXXXXXXXXXXXXXXXXXXXXXXXXXXXXXXXXXXXXXXXXXXXXXXXXXXXXXXXXX--
XXXXXXX--XXXXXXXXX--XXXXXXXXXXX-----------------------------------------------------------------------------------------------------------
