-----------------------------------------------------------------------------------------------------------------------------------------------
-----------------------------------------------------------------------------------------------------------------------------------------------
-----------------------------------------------------------------------------------------------------------------------------------------------
-----------------------------------------------------------------------------------------------------------------------------------------------
-----------------------------------------------------------------------------------------------------------------------------------------------
-------------------------------------------------------------------------------------------SSS!------------------------------------------------
-----------------------------------------------------------------------------------------------------------------------------------------------
------------S----------------------------------------------------------------------------------------------------------------------------------
-----------------------------------------------------------------------------------------------------------------------------------------------
-------------------------------------------------------------------------------------------#---------------------------------------------------
----------------------#----------##------------------------!-----------------------S!!S---##---------##----------------------------------#-----
---------------------##---SU----###---------------#---------------------##-#-------------###--------###-----#----------------------------##----
-----------------#--###--------####---------------##-------------------###-##------------###---#---####--tt-##----------------#----------##----
-M--------------##-####-------#####g------------gg###-----------------####-###----------####--##---------tt-###----gg-g----gg-##---------##g---
XXXXXXX---XXXXXXXXXXXXXXXXXXXXXXXXXXXXXXXXXXXXXXXXXXXXXXXXXXXXXXXXXXXXXXXXXXXXXXXXXXXXXXXXXXXXXXXXXXXXXXXXXXXXXXXXXXXXXXXXXXXXXXXXXXXXX--XXXXXX
XXXXXXX---XXXXXXXXXXXXXXXXXXXXXXXXXXXXXXXXXXXXXXXXXXXXXXXXXXXXXXXXXXXXXXXXXXXXXXXXXXXXXXXXXXXXXXXXXXXXXXXXXXXXXXXXXXXXXXXXXXXXXXXXXXXXX--XXXXXX
