----------------------------------------------------------------------------------------------------------------------------------
----------------------------------------------------------------------------------------------------------------------------------
--------------------------------------------------------------S!!S----------------------------------------------------------------
----------------------------------------------------------------------------------------------------------------------------------
----------------------------------------------------------------------------------------------------------------------------------
-----------------------------------------------------------#----------------------------------------------------------------------
----------------------------------------@------------tt---##---SS-----------------------------------------------------------------
-----------------------------------------------------tt--###----------------------------------------------------------------------
-----------------------------------------------------tt-####----------------------------------------------------------------------
--------------------------------------------------------####----------------------------------------------------------------------
-------##--#--------------SU----------S-!--!-----XXXXXXXXXXX------S!!S-----------#--#----##------S!!S----##-----------------------
------###--##-----S!!S---------------------------XXXXXXXXXXX--------------------##--#---###-------------###-----------------------
-----####--##-------------------------------------------------------------------##--#--####------------#####----------------------
-M--#####--##----------------tt--gg-g---------------g-g--------------------g-g--##--#-#####-----####--#######---------------------
XXXXXXXXX--XXXXXXXXXXXXXXXXXXXXXXXXXXXXXXXXXXXXXXXXXXXXXXXXXXXXXXXXXXXXXXXXXXXXXXXXXXXXXXXXXXXXXXXXXXXXXXXXXXXXXXXXXXX-XXXXXXXXXXX
XXXXXXXXX--XXXXXXXXXXXXXXXXXXXXXXXXXXXXXXXXXXXXXXXXXXXXXXXXXXXXXXXXXXXXXXXXXXXXXXXXXXXXXXXXXXXXXXXXXXXXXXXXXXXXXXXXXXX-XXXXXXXXXXX
