-----------------------------------------------------------------------------------------------------------------------------------
-----------------------------------------------------------------------------------------------------------------------------------
-----------------------------------------------------------------------------------------------------------------------------------
-----------------------------------------------------------------------------------------------------------------------------------
-----------------------------------------------------------------------------------------------------------------------------------
-----------------------------------------------------------------------------------------------------------------------------------
---------------------------------------SS!S-----------------------------------------------------------------------@----------------
-----------------------------------------------------------------------------------------------------------------------------------
-----------------------------------------------------------------------------------------------------------------------------------
----------------------------------------####----------------------------------------1------------####------------------------------
--S!!S----#--#--------------------!-----####-------#-----------------##----------------------tt--####-------------!--!------S!!S---
---------##--##-----------tt------------####-------##--------t------###----------------------tt--####--t---------------------------
---------##--###----------tt------------####-------##-------#t-----#####-----g-g-------------tt--####--t---------------------------
-M----tt-##--####---------tt-----------g-g---------##g-----##t-g--#######--------------------tt--------t-g--------------g-g-----tt-
XXXXXXXXXXXXXXXXXXXXXXXXXXXXXXXXXXXXXXXXXXXXXXXXX--XXXXXXXXXXXXXXXXXXXXXXXXXXXXXXXXXX-XXXXXXXXXXXXXXXXXXXXXXXXXX--XXXXXXXXXXXXXXXXX
XXXXXXXXXXXXXXXXXXXXXXXXXXXXXXXXXXXXXXXXXXXXXXXXX--XXXXXXXXXXXXXXXXXXXXXXXXXXXXXXXXXX-XXXXXXXXXXXXXXXXXXXXXXXXXX--XXXXXXXXXXXXXXXXX
