-----------------------------------------------------------------------------------------------------------------------------------
-----------------------------------------------------------------------------------------------------------------------------------
-------------------------------------------------------------------!---------------------------------------------------------------
------------------------------------------------------------------------S!!S-------------------------------------------------------
--------------------------------------------------------------g--------------------------------------------------------------------
-----------------------------------------------------------------------------------------------------------------------------------
------------------------------------------------------------S@S----SS--------------------------------------------------------------
-----------------------------------------------------------------------------------------------------------------------------------
-----------------------------------------------------------------------------------------------------------------------------------
----------####---------------------1-----------------------#-----------------------------------------------------------------------
----------####------##--#---------------------------#--#--##------------------------------------#--#--------------##---------------
----------####-----###--##-----##---t--------------##--#-###------------S!!S-----t---------t---##--#------##-----###---#-----------
----------####----####--##----###---t------#-------##--#####---#-----------------t---------t---##--#-----###----####---##----------
-M----gg-gg-g----#####--##---####---t-g---##-------##--#####--##-g-g-------------t-g-------t-g-##--#----####-----------###---------
XXXXXXXXXXXXXXXXXXXXXX--XXXXXXXXXXXXXXXXXXXXXXXXX--XXXXXXXXXXXXXXXXXXXXXXXXXXXXXXXXXXXXXXXXXXXXXXXXXXXXXXXXXXXXXXXXXXXXXXXXXXXXXXXX
XXXXXXXXXXXXXXXXXXXXXX--XXXXXXXXXXXXXXXXXXXXXXXXX--XXXXXXXXXXXXXXXXXXXXXXXXXXXXXXXXXXXXXXXXXXXXXXXXXXXXXXXXXXXXXXXXXXXXXXXXXXXXXXXX
