---------------------------------------------------####---------------------##--#------------F---
---------------------------------------------------####-------------#-------##--#-g-g---#g---#---
------------------------------------------------SS-####------------##------XXXXXXXXXX--##-C--XXXX
------------------------------------S-----SU-------####-----------####-----XXXXXXXXXX-###----XXXX
---------------------------------------------------####----------######--------------####--------
-----------------------------SSS-------------------------#----gg-#######-------------####--g-----
---------------@-----------------------XXXXXXXXXXXXXXXXXXXXXXXXXXXXXXXXXXXXXXXXXXXXXXXXXXXXXX----
---------------------------------------XXXXXXXXXXXXXXXXXXXXXXXXXXXXXXXXXXXXXXXXXXXXXXXXXXXXXX----
-------------------------------------------------------------------------------------------------
-----------------------------g-------------------------------------------------------------------
----#--#-----tt-------------SXXXX-XXXXS!!S-------------------------------------------------------
---##--#-----tt--------------XXXX-XXXX-----------------------------------------------------------
---##--#-----tt----------------------------------------------------------------------------------
-M-##--#---------------------------tt----#-------------------------------------------------------
XXXXXXXXXXXXXXXXXXXXXXXXX--XXXXXXXXXXX--##-------------------------------------------------------
XXXXXXXXXXXXXXXXXXXXXXXXX--XXXXXXXXXXX-###-------------------------------------------------------
