--------------------------------------------------------------1--------------------------------------------------1---------------
-------------------------------------------------------tt--------------------------!-----------------#--#----------#--#----------
-------------------------------------------------------tt-----------t--------------------#----------##--#---------##--#----------
-------------------------------------------------------tt-----------t------#-------------##---------##--#---#-----##--#---#------
---------------------------------------------------g-g-tt-----------t-g---##-g-g---------###------gg##--#--##-----##--#--##-g-g--
----------------------------------------------------------XXXXX-XXXXXXXXXXXXXXXXXXXXXXXXXXXXXXXXXXXXXXXXXXXXXXXXXXXXXXXXXXXXXXXXX
-------------------------##-----------@-----SU-----SS-----XXXXX-XXXXXXXXXXXXXXXXXXXXXXXXXXXXXXXXXXXXXXXXXXXXXXXXXXXXXXXXXXXXXXXXX
------------------------###------------------------------------------------------------------------------------------------------
-----------------------####------------------------------------------------------------------------------------------------------
---------------------------------------------------------------------------------------------------------------------------------
--------!-------!---------------------!--!-----------SU---!--!-S@S!S-------------------------------------------------------------
---------------------------------------------------------------------------------------------------------------------------------
---------------------------------------------------------------------------------------------------------------------------------
-M----tt--------####----gg####----------------gg----------------g----------------------------------------------------------------
XXXXXXXXXXXXXXXXXXXXXXXXXXXXXXXXXXXX--XXXXXXXXXX-XXXXXXXXXXXXXXXXXXXXXX----------------------------------------------------------
XXXXXXXXXXXXXXXXXXXXXXXXXXXXXXXXXXXX--XXXXXXXXXX-XXXXXXXXXXXXXXXXXXXXXX----------------------------------------------------------
