----------------------------------------------------------------------------------------------------------------------------
----------------------------------------------------------------------------------------------------------------------------
----------------------------------------------------------SS!S--------------------------------------------------------------
----------------------------------------------------------------------------------------------------------------------------
---------g------------------------------------------------------------------------------------------------------------------
--------SSSSSSS-------------------------------------------------------------------------------------------------------------
-------------------------------------------@------------------------S!!S----------------------------------------------------
----------------------------------------------------------------------------------------------------------------------------
----------------------------------------------------------------------------------------------------------------------------
------------####------------------------------------------------------------------------------------------------------------
--------SSS!####--------SU-----------------!--!--------------------------------------------------SU---S!!S---SU-------------
------------####-------------------------------------------t----------------------------------------------------------------
------------####---------------------#---------------------t---------------tt----#------------------------------------------
-M--#------------tt------k----------######-------g-g-----ggt-g---------gg--tt---######---------g-g----------####------------
XXXXXXXXXXXXXXXXXXXXXXXXXXXXXXXXXXXXXXXXXXXXXXXXXXXXXXXXXXXXXXX-XXXXXXXXXXXXXXXXXXXXXXXXXXX--XXXXXXXXXXXXXXXXXXXX-XXXXXXXXXX
XXXXXXXXXXXXXXXXXXXXXXXXXXXXXXXXXXXXXXXXXXXXXXXXXXXXXXXXXXXXXXX-XXXXXXXXXXXXXXXXXXXXXXXXXXX--XXXXXXXXXXXXXXXXXXXX-XXXXXXXXXX
