----------------------------------------------------------------------------------------------------------------------------------------------------
----------------------------------------------------------------------------------------------------------------------------------------------------
----------------------------------------------------------------------------------------------------------------------------------------------------
----------------------------------------------------------------------------------------------------------------------------------------------------
----------------------------------------------------------------------------------------------------------------------------------------------------
----------------------------------------------------------------------------------------------------------------------------------------------------
----------------------------!-----------------------------------------------------------------------------------------------------------------------
--------------------------------------------------------------------!-------------------------------------------------------------------------------
----------------------------------------------------------------------------------------------------------------------------------------------------
------------------------------#-------------------------g----------------------------1--------------------------------------------------------------
-----------------------!-----##--------------S!!S------SSSSSSS-------------------------------!------##--------------------------SU---------------S--
-------------SS!S-----------###----------------------------------------t---------------------------###------------#---------------------------------
-----tt---#----------------####----------------------------------------t--------------------------#####-------#---##---------------------g-g--------
-M---tt--##-------------k--####-g-g---------####-----------------------t-g--g-g------------------#######---gg-##--###--------------k----------g-g---
XXXXXXXXXXXXXXXXXXXXXXXXXXXXXXXXXXXXXXXXXX--XXXXXXXXX--XXXXXXXXXXX-XXXXXXXXXXXXXXXXXXXXXXXXXXXXXXXXXXXXXXXXXXXXXXXXXXXXXXXXX--XXXXXXXXXXXXXXXXXXXXX-
XXXXXXXXXXXXXXXXXXXXXXXXXXXXXXXXXXXXXXXXXX--XXXXXXXXX--XXXXXXXXXXX-XXXXXXXXXXXXXXXXXXXXXXXXXXXXXXXXXXXXXXXXXXXXXXXXXXXXXXXXX--XXXXXXXXXXXXXXXXXXXXX-
