----------------------------------------------------------------------------------------------------------------------------------
----------------------------------------------------------------------------------------------------------------------------------
---------------------------------------------S------------------------------------------------------------------------------------
----------------------------------------------------------------------------------------------------------------------------------
--------------------------------------------g-------------------------------------------------------------------------------------
----------------------------------------------------------------------------------------------------------------------------------
---@--------------------------------------S@S-------------------------------------------------------------------------------------
----------------------------------------------------------------------------------------------------------------------------------
----------------------------------------------------------------------------------------------------------------------------------
---------------------1-----------SSS--------------------tt------------------------------------------------------------------------
---!--!----------------#--#------------SS---S!!S--------tt------tt-------##----------####----------#--------S------------------!--
----------------------##--#-----------------------------tt------tt------###----------####----------##-----------------t-----------
--------------tt------##--#-------------------------g-g-tt------tt-----####----------####----------###----------------t-----------
-M-------gg---tt#-----##--#--------------tt-####------------g-g-tt---##-----k--------####------g---####------------k--t-g------k--
XXXXXXXXXXXX--C--XXXXXXXXXXXXXX--XXXXXXXXXXXXXXXXXXXXXXXXXXXXXXXXXXXXXXXXXXXXXX-XXXXXXXXXXXXXXXXX--XXXXXXXXXXXXXXXXXXXXXXXXXXXXXXX
XXXXXXXXXXXX-----XXXXXXXXXXXXXX--XXXXXXXXXXXXXXXXXXXXXXXXXXXXXXXXXXXXXXXXXXXXXX-XXXXXXXXXXXXXXXXX--XXXXXXXXXXXXXXXXXXXXXXXXXXXXXXX
