---------------------------------------------------------------------------------------------------------------------
---------------------------------------------------------------------------------------------------------------------
---------------------------------------------------------------------------------------------------------------------
------------------------------------------------------------------g--------------------------------------------------
------------------------------------------------------------tt---SSSSSSS-------------------------------#--------1----
------------------------------------------------------------tt---------------------------!------------##-------------
------------------------------S!!S--------------------------tt-----------#-----t---------------------###t------------
----------------!---------------------------------------g-g-tt-----------##----t--------------------####t------------
-------------------------------------------------------------g-g---------###---t-g--------t-g-------####t-g-------gg-
--------------------------------------------------------SS--XXXXXXXXXXXXXXXXXXXXXXXXXXXXXXXXXXXXXXXXXXXXXXXXXXXXXXXXX
-----------------------#-U-----SS---------------------------XXXXXXXXXXXXXXXXXXXXXXXXXXXXXXXXXXXXXXXXXXXXXXXXXXXXXXXXX
--------------XXXXX----##---------------------g-g--------------------------------------------------------------------
-----tt-------XXXXX----##-------------------------------####---------------------------------------------------------
-M---tt------g-----g---##--------C-----SU-----SS-----S--####------S@S!S----------------------------------------------
XXXXXXXXXXXXXXXXXXXXX--XX-------------------------------####---------------------------------------------------------
XXXXXXXXXXXXXXXXXXXXX--XX-------------------------------####---------------------------------------------------------
