---------------------------------------------------------------------------------------------------------------------------------
---------------------------------------------------------------------------------------------------------------------------------
---------------------------------------------------------------------------------------------------------------------------------
---------------------------------------------------------------------------------------------------------------------------------
-----------------------------------------------------------------------------------------------------------------g---------------
----------------------------------------------------------------------------------------------------------------SSSSSSS----------
---------------------------------------------------------------------------------------------------------------------------------
-----SS!S----------------------------------------------------------------------------tt------------------------------------------
-------------------g------------------------------------------------------g----------tt#-----------------------------------------
------------------SSSSSSS------------------------------------------------SSSSSSS---------------------------------#---------SS---#
------####--------------------------------------##-------#--#-------SU-------------SS----------##----!----------##-------------##
------####-------------------SU------t---------###----tt-#--#---------------------------------###--------------###------------###
------####---------------------------t--------####----tt##--#--------------------------------####-------------####-----------####
-M----####---------------------------t-g------k---------##--#---------------g------------------g-g------------####---gg-g-g--####
XXXXXXXXXXXXXXXXXXXXXXXXXXXXXXXXXXXXXXXXXXXXXXXXXXXXXXXXXXXXXXXXXXXXXXXXXXXXXXXXXXXXXXXXXXXXXXXXXXXXXXXXXXXXXXXXXXXXXXXXXXXXXXXXX
XXXXXXXXXXXXXXXXXXXXXXXXXXXXXXXXXXXXXXXXXXXXXXXXXXXXXXXXXXXXXXXXXXXXXXXXXXXXXXXXXXXXXXXXXXXXXXXXXXXXXXXXXXXXXXXXXXXXXXXXXXXXXXXXX
