-----------------------------------------------------------------------------------------------------------------------------
-----------------------------------------------------------------------------------------------------------------------------
-----------------------------------------------------------------------------------------------------------------------------
-----------------------------------------------------------------------------------------------------------------------------
-----------------------------------------------------------------------------------------------------------------------------
---------------------------------------------------------------------------------------------SSS!----------------------------
------------------------------------------------S!!S---------------------##----------S---------------------------------------
------------------------------------------------------------------------###--------------------------------------------------
-----------------------------------------------------------------------####---------g----------------------------------------
-----------------------------------1----------------------------------#------------------------------------------------------
--------!-------------!---------------SS!SXXXXXXXXXXXXXXXX---S!!S----##-----------S@S----SU-----------------------##---------
------------------------------------------XXXXXXXXXXXXXXXX----------###------------------------------------------###---------
------------------------------------------------------###----------####--------------------------#-----#--------####---#-----
-M----tt---------------------------------------------#####------tt-####---gg--------------------##-----##--##---------##-----
XXXXXXXXXXXXXX-XXXXXXXXXXX-XXXXXXXXXXXXXXXXXXXXXXXXXXXXXXXXXXXXXXXXXXXXXXXXXXXXXXXXXXXXXXXXXXXXXXXXXXXXXXXXXXXXXXXXXXXXXXXXXX
XXXXXXXXXXXXXX-XXXXXXXXXXX-XXXXXXXXXXXXXXXXXXXXXXXXXXXXXXXXXXXXXXXXXXXXXXXXXXXXXXXXXXXXXXXXXXXXXXXXXXXXXXXXXXXXXXXXXXXXXXXXXX
