-------------------------------------------------------------------------------------------------------------------------------------
-------------------------------------------------------------------------------------------------------------------------------------
-------------------------------------------------------------------------------------------------------------------------------------
-------------------------------------------------------------------------------------------------------------------------------------
-------------------------------------------------------------------------------------------------------------------------------------
-------------------------------------------------------------------------------------------------------------------------------------
---------------------------------@--------------------------S-----SS!S---------------------------------------------------------------
-------------------------------------------------------------------------------------------------------------------------------------
----------------------------------------------------------------#--------------------------------------------------------------------
---------------------------------------------------------------##----------------------------SSS!-----------------------------------1
----------------------------SU---!--!---------XXXXXXXXXXXXXXXXXXX------------##----------!------------SS!S--------!------------------
-----------------!----------------------------XXXXXXXXXXXXXXXXXXX-----------###--------------------#---------------------------------
------------------------------------------------------------------------#--#####------------------##---------------------------------
-M-----------------------------------------------------------------gg--##-#######---g-g----------#####g---------####-----------------
XXXXXXXX--XXXXXXXXXXXXXXXXXXXXXXXXXXXX-XXXXXXXXXXXXXXXXXXXXXXXXXXXXXXXXXXXXXXXXXXXXXXXXXXXXXXXXXXXXXXXXXXXXXXX--XXXXXXXXXXX-XXXXXXXXX
XXXXXXXX--XXXXXXXXXXXXXXXXXXXXXXXXXXXX-XXXXXXXXXXXXXXXXXXXXXXXXXXXXXXXXXXXXXXXXXXXXXXXXXXXXXXXXXXXXXXXXXXXXXXX--XXXXXXXXXXX-XXXXXXXXX
