-------------------------------------------------------------------------------------------------------------------------------
-------------------------------------------------------------------------------------------------------------------------------
-------------------------------------------------------##------@---------------------------------------------------------------
------------------------------------------------------###----------------------------------------------------------------------
-----------------------------------------------------####----------------------------------------------------------------------
-------------------------------------------------------------------------------------------------------------------------------
---------------------------------------------------------------!--!------------------------------------------------------------
--------------------------------------------------------------------#--------------------------------------##------@-----------
----------------------------------------------------------------------------------------------------------###------------------
--------------------------------------1---#--------------------------------------------------------------####------------------
---------------#----!--------------------##--SS!S----SU----------------XXX------------------------SSS!---####------------------
--------------##----------------##------###----------------------S!!S--XXX-----#-------------------------####------!--!----SU--
-------------###---------------###-----####------------------#-----------------##----------tt------------####------------------
-M--------gg-####-g-g---------####-----####---tt-t----------##-----------------###----gg---tt#-----------####------------------
XXXXXXX--XXXXXXXXXXXXXXXXXXXXXXXXXXXXXXXXXXXXXXXXXXXXXXXXXXXXXXXXXXXXXXXXXXXX--XXXXXXXXXX-------g---------g--------------------
XXXXXXX--XXXXXXXXXXXXXXXXXXXXXXXXXXXXXXXXXXXXXXXXXXXXXXXXXXXXXXXXXXXXXXXXXXXX--XXXXXXXXXX--XXXXXXXXX-XXXXXXXXX-----XXXXX-------
