----------------------------------------------------------------------------------------------------------------------
----------------------------------------------------------------------------------------------------------------------
----------------------------------------------------------------------------------------------------------------------
----------------------------------------------------------------------------------------------------------------------
----------------------------------------------------------------------------------------------------------------------
---------------------------------------------------------------------SSS!---------------------------------------------
-------------------------------------------------------------SSS!--------------!--------------------------------------
----------------------------------------------------------------------------------------------SS-----S----!-----------
-------------------------------------g--------------------------------------------------------------------------------
-----------1----------1-------------SSSSS-----------------------------####--####--------------------------------------
---------------------------------------------!------------------------####--####-------#----g-g-------g---------------
-----------------------------#-----------------------------------t----####--####-------#t--XXXXXX-----XXXX------------
------#----------------------##----------------------tt----#-----t----####--####-------#t--XXXXXX-----XXXX--#---------
-M---##------g-g-------------###----gg-g--------k----tt---##-----t-g---------------##--#t-g--g-g------------##---g-g--
XXXXXXXXXXXXXXXXXXXXXXXXXXX--XXXXXXXXXXXXXXXXXXXXXXXXXXXXXXX-XXXXXXXXXXXXXXXXXXXXXXXXXXXXXXXXXXXXX-XXXXXXXXXXXXXXXXXXX
XXXXXXXXXXXXXXXXXXXXXXXXXXX--XXXXXXXXXXXXXXXXXXXXXXXXXXXXXXX-XXXXXXXXXXXXXXXXXXXXXXXXXXXXXXXXXXXXX-XXXXXXXXXXXXXXXXXXX
