------------------------------------------------------------------------------------------------------------------------------------------------
------------------------------------------------------------------------------------------------------------------------------------------------
------------------------------------------------------------------------------------------------------------------------------------------------
------------------------------------------------------------------------------------------------------------------------------------------------
-------------------------------------------------------------------------------------------------g----------------------------------------------
------------------------------------------------------------------------------------------------SSSSSSS-----------------------------------------
-------------------------SSS!-----------------------------------------------------@------------@--------------@---------------------------------
------------------------------------------------------------------------------------------------------------------------------------------------
------------------------------------------------------------------g-----------------------------------------------------------------------------
-------------------------------------1---------------------------SSSSSS---SSS!------------SSS!------####--------------------------tt------------
------!-------------------C----------------------S-----!--------------------------!--!---------!--!-####------!--!----------------tt------##--#-
----------------------------------------------------------------------------------------------------####--------------------------tt-----###--##
-----------------------------#-----------g-g--------------------#-----------------------------------####-------------F--------g-g-tt----####--##
-M-------------------------g-##--------------------------------#####g--------####-----------k------------------------#-------------k---#####--##
XXXXXXXXXXXXXXXXX--XXXXXXXXXXXXXXXXXXXXXXXXXXXXXXXXXXXXXXXXXXXXXXXXXXXXXXXXXXXXXXXXXXXXXXXXXXXXXXXXXXXXXXXXXX-XXXXXXXXXXXXXXXXXXXXXXXXXXXXXX--XX
XXXXXXXXXXXXXXXXX--XXXXXXXXXXXXXXXXXXXXXXXXXXXXXXXXXXXXXXXXXXXXXXXXXXXXXXXXXXXXXXXXXXXXXXXXXXXXXXXXXXXXXXXXXX-XXXXXXXXXXXXXXXXXXXXXXXXXXXXXX--XX
