-------------------g---tt-####-gg-####-gg------###-------------------####------k------------t-g-##--#------g-g-------------
---------------------XXXXXXXXXXXXXXXXXXXXXXXXXXXXXXXXXXXXXXXXXXXXXXXXXXXXXXXXXXXXXXXXXXXXXXXXXXXXXXXXXXXXXXXXXXXXXXXXXXXXXX
-------------------SSXXXXXXXXXXXXXXXXXXXXXXXXXXXXXXXXXXXXXXXXXXXXXXXXXXXXXXXXXXXXXXXXXXXXXXXXXXXXXXXXXXXXXXXXXXXXXXXXXXXXXX
---------------------------------------------------------------------------------------------------------------------------
---------------------------------------------------------------------------------------------------------------------------
----------SSS!-----####----------------------------------------------------------------------------------------------------
-------------------####----------------------------------------------------------------------------------------------------
-----SS------------####----------------------------------------------------------------------------------------------------
-------------------####----------------------------------------------------------------------------------------------------
---------####--------------------1-----------------------------------------------------------------------------------------
---------####---------SS------------------S!!S-----------------------------------------------------------------------------
---------####--------------------------------------------------------------------------------------------------------------
---------####--------------------------------------------------------------------------------------------------------------
-M-------------t-g------------------------g--------------------------------------------------------------------------------
XXX-XXXXXXXXXXXXXXXXXXXXXXXXXXXXXXXXXXXXXXXXXXXXX--------------------------------------------------------------------------
XXX-XXXXXXXXXXXXXXXXXXXXXXXXXXXXXXXXXXXXXXXXXXXXX--------------------------------------------------------------------------
