---SS----SU------------------
-----------------------------
-----------------------------
---------C-----SS------------
-XXXXX-----------------------
-XXXXX-----------------------
----------g----####----------
--------XXXX---####----------
--------XXXX---####----------
---------------####----------
--------------------C--------
-----------------------------
------#------------------F---
-M---##--------------g---#---
XXXXXXXXXXX--XXXXXXXXXXXXXXXX
XXXXXXXXXXX--XXXXXXXXXXXXXXXX
