-------------------------------------------------------------------------------------------------g--####--------------------
---------------------------------------------------------------------------------------------------------####---------------
-----------------------------------------------------------------------------------------------S@S----SS-####------!--!-----
---------------------------------------------------------------------------------------------------------####---------------
---------------------------------------------------------------------------------------------------------####---------------
----------------------------------------------------------------------------------------------------------------------------
--------------------------------------------------------------------------------S!!S--------SS---------------------XXXXX----
-------------------------------------------------------------!-----------------------------------------------------XXXXX----
----------------------------------------------------------------------------------------------------------------------------
----------------------------------------------------SSS!---------------------#--------------####----------------------------
------####-------------------------------##---------------------#-----------##-----SU-------####----------------------------
------####------------------------------###-----------XXXXXXXXXX#----------###--------------####---------------#------------
-----#####-----------------------------####----#------XXXXXXXXXX#---------####--------------####---------------##-----------
-M--######----------------------------------gg-##-------k----####------gg-####---------------------g-g---------###----------
XXXXXXXXXXXXXXXXXX--XXXXXXXXXXX--XXXXXXXXXXXXXXXXXXXXXXXXXXXXXXXXXXXXXXXXXXXXXXXXXXXXXXXXXXXXXXXXXXXXXXXXXXXX--XXXXXXXXXXXXX
XXXXXXXXXXXXXXXXXX--XXXXXXXXXXX--XXXXXXXXXXXXXXXXXXXXXXXXXXXXXXXXXXXXXXXXXXXXXXXXXXXXXXXXXXXXXXXXXXXXXXXXXXXX--XXXXXXXXXXXXX
