--------------------------------------------------------------------------------------------------------------
-----------------------SSS!-----------------------------------------------------------------------------------
-----------------------------------------------------------------------------------S--------------------------
--------------------------------------------------------------------------------------------------------------
----------------------------------------------------------------------------------g---------------------------
--------------------------------------------------------------------------------------------------------------
###---------------------SS------##----------!---------------##------------------S-------S---!-----------------
###----------------------------###-------------------------###------------------------------------------------
###---------------------------####------------------------####------------------------------------------------
###-------------1----------####-----####------------------------------------------------------------####------
----C----------------------####-----####------------S!!S----------------------------XXXXXXXXXX------####------
---------------------------####-----####------------------------#-------------------XXXXXXXXXX-#----####------
-------------------tt------####-----####-----------------------###-------#--------------------###---####------
-M---g----gg-------tt----gg------------------gg####------k----#####-----##-------------------#####---------gg-
XXXXXXXXXXXXXXXXXXXXXXXXXXXXXXXXXXXXXXXXXXXXXXXXXXXXXXXXXXXXXXXXXXXXXXXXXXXXXXXXXXXXXXXXXXXXXXXXXXXXXXXXXXXXXX
XXXXXXXXXXXXXXXXXXXXXXXXXXXXXXXXXXXXXXXXXXXXXXXXXXXXXXXXXXXXXXXXXXXXXXXXXXXXXXXXXXXXXXXXXXXXXXXXXXXXXXXXXXXXXX
