----------------------------------------------------------------------------------------------------------------------------------------------
----------------------------------------------------------------------------------------------------------------------------------------------
----------------------------------------------------------------------------------------------------------------------------------------------
----------------------------------------------------------------------------------------------------------------------------------------------
----------------------------------------------------------------------------------------------------------------------------------------------
----------------------------------------------------------------------------------------------------------------------------------------------
----------------------------------------------------------S!!S-----------------------S--------------------------------------------------------
------------------------------------------------------------------------S!!S--------------!---------------------------------------------------
------------------------------------------------------------------------------------g---------------------------------------------------------
------------------------------#--------------------------------------------------------------------------------------------------####---------
-------------#--#------------##-----------S!!S---------------------#--#-----------S@S--------------------------------------------####---------
--------t---##--#-----------####-------------------SU-------------##--#----------------------------------------------------------####---------
-----tt-t---##--#---------#######--------------------------------###--#----------------------------------------------tt----#-----####---------
-M---tt-t-g-##--#--------#########------------------------------####--#---------------------------g------------------tt---##------------------
XXXXXXXXXXXXXXXXXXXXX--XXXXXXXXXXXXXXXXXXXXXXXXXXXXXXXXXX-XXXXXXXXXXXXX-XXXXXXXXXXXXXXXX-XXXXXXXXXXXXXXXXXX--XXXXXXXXXXXXXXXXXXXXXXXXXXXXXXXXX
XXXXXXXXXXXXXXXXXXXXX--XXXXXXXXXXXXXXXXXXXXXXXXXXXXXXXXXX-XXXXXXXXXXXXX-XXXXXXXXXXXXXXXX-XXXXXXXXXXXXXXXXXX--XXXXXXXXXXXXXXXXXXXXXXXXXXXXXXXXX
