---------------------------------------------------------------------------------------------------------------------------------------------
---------------------------------------------------------------------------------------------------------------------------------------------
---------------------------------------------------------------------------------------------------------------------------------------------
---------------------------------------------------------------------------------------------------------------------------------------------
---------------------------------------------------------------------------------------------------------------------------------------------
---------------------------------------------------------------------------------------------------------------------------------------------
---@-------------------------------------##--------------------------------------------------------------@-----------------------------------
-------------S!!S-----------------------###---------------------------------------------------S!!S-------------------------------------------
---------------------------------------####--------------------------------------------------------------------------------------------------
--------------------------------------#-------------tt---------------------tt-----------------------------------------------1----------------
---!--!------------------------------##-------------tt----------!---------------------S!!S---------------!--!-----t----------------#--#------
------------------------#-----------###-------------tt-----t------------------------------------------------------t---------------##--#------
------------------------##------tt-####---------g-g-tt-----t-----------g-g----------------------------------------t------------tt-##--#------
-M----------------------###-----tt-####-----------------k--t-g----tt--------------tt----------------------------------gg-------tt-##--#------
XXXXXXXXXXXXX-XXXXXXXXXXXXXXXXXXXXXXXXXXXXXX--XXXXXXXXXXXXXXXXXXXXXXXXXXXX-XXXXXXXXXXXXXXXXXXXXXX--XXXXXXXXXXXXXXXXXXXXXXXXXXXXXXXXXXXXXXXX--
XXXXXXXXXXXXX-XXXXXXXXXXXXXXXXXXXXXXXXXXXXXX--XXXXXXXXXXXXXXXXXXXXXXXXXXXX-XXXXXXXXXXXXXXXXXXXXXX--XXXXXXXXXXXXXXXXXXXXXXXXXXXXXXXXXXXXXXXX--
