-------------------------------------------------------------------------------------------------------------------------------------------
-------------------------------------------------------------------------------------------------------------------------------------------
-------------------------------------------------------------------------------------------------------------------------------------------
-------------------------------------------------------------------------------------------------------------------------------------------
-------------------------------------------------------------------------------------------------------------------------------------------
-------------------------------------------------------------------------------------------------------------------------------------------
--------------------------------@-------------------------------!--------------------------------------------------------------------------
-------------------------------------------------------------------------------------------------------------------------------------------
-----------------------------------------------------------------------------------------------#----------tt-SSS!--------------------------
---------------------------------------------------------------------------SSS!----------tt---##----------tt---------------tt--------------
----------------------##--#-----!--!---SS!S------------------#X--------------------------tt--###----------tt---------------tt--------------
---------------------###--##------------------S!!S----------##X-----#--------------------tt-####--tt--g-g-tt---------------tt--------------
--------------#-----####--###---------------------------tt-####-----##---------------g------####--tt-----------k-------####------k---------
-M---------gg-##---#####--####--------g-g---------------tt-####-----###---####------g--XXXXXXXXXXXXXXXXXXXXXXXXXXXXXXXXXXXXXXXXXXXXXXXXXXXX
XXXXXXXX--XXXXXXXXXXXXXX--XXXXXXXXXXXXXXXXXXXXXXXXXXXXXXXXXXXXX-XXXXXXXXXXXXXXXXXXXXXXXXXXXXXXXXXXXXXXXXXXXXXXXXXXXXXXXXXXXXXXXXXXXXXXXXXXX
XXXXXXXX--XXXXXXXXXXXXXX--XXXXXXXXXXXXXXXXXXXXXXXXXXXXXXXXXXXXX-XXXXXXXXXXXXXXXXXXXXXXXX---------------------------------------------------
