-----------------###-----------------------------!-------------------------
----------------####-------------tt----------------------------------------
------####------####---tt----gg--tt-####--gg-------------------------------
------XXXXXXXXXXXXXXXXXXXXXXXXXXXXXXXXXXXXXXXXXXXX-C------S-----SU---------
------XXXXXXXXXXXXXXXXXXXXXXXXXXXXXXXXXXXXXXXXXXXX-------------------------
---------------------------------------------------------------------------
----------------------------------------------------g----XXXXX####---------
--------------------------------------------------XXXX---XXXXX####---------
--------------------------------------------------XXXX--------####---------
--------------------------------------------------------------####---------
-----!---------##---------------##----------SU--------------------C--------
--------------###---!----------###--------------t--------------------------
-------------####-------------####--------------t----------------------F---
-M------k---#####------------#####g------gg####-t-g----------------g---#---
XXXXXXXXXXXXXXXXXXXXXXXXXXXXXXXXXXXXXXXXXXXXXXXXXXXXXXXXXXXXXXX--XXXXXXXXXX
XXXXXXXXXXXXXXXXXXXXXXXXXXXXXXXXXXXXXXXXXXXXXXXXXXXXXXXXXXXXXXX--XXXXXXXXXX
