------------------------------------------------------------------------------------------
-------------------####--------------------------S-----SS---SSS!--------------------------
--------------SS!S-####-------------SS!S--------------------------------------------------
-------------------####-------------------------g-----------------------------------------
-------------------####-------------------------------------------------------------------
-----------------C--------------gg------------S@S---!----------C----SS!S------------------
-----------------------------XXXXX--------------------------------------------------------
-----------------------------XXXXX--------------------------------------------------------
------------------g---------------------------------------------g----####-----------------
----------------XXXX---1------SSS!--XXXXXXXXXXXXXXXXXXXX--S!!SXXXX---####-----------------
-------------tt-XXXX-----#----------XXXXXXXXXXXXXXXXXXXX------XXXX---####-----------------
-------------tt---------##------------------###----------------------####-----------------
-------------tt---------##-----------------####-------------####--------------------------
-M-------####-----------##--#-----k---g-g----C---------SS!S-####-------------SS!S-S@S!S---
XXXXXXX--XXXXXXXXXXXXXXXXXXXXXXXXXXXXXXXXXX-----------------####--------------------------
XXXXXXX--XXXXXXXXXXXXXXXXXXXXXXXXXXXXXXXXXX-----------------####--------------------------
