-----------------------------------------------------------------------------------------------------------------------------
-----------------------------------------------------------------------------------------------------------------------------
-----------------------------------------------------------------------------------------------------------------------------
-----------------------------------------------------------------------------------------------------------------------------
----------------------------------------------------------------------------------------g------------------------------------
---------------------------------------------------------------------------------------SSSSSSS-------------------------------
-----------------------------------------------!-----------------------------SU----------------------------------------------
-----------##----------------------------------------------------------------------------------------------------------------
----------###----------------------------------------------------------------------------------------------------------------
---------####------------------------------------------------------------------------------------SSS!------#----1------------
-----------C----------#--#----S--------------------------------S-----------SS-----------------------------##-----------------
---------------------##--#----------------S!!S------------#-------------------------tt-------------------###-----------------
---------------------##--#--------------------------#----##---------------------F---tt------------------####-----------------
-M----------g--------##--#--------gg------------g--##---tt---------gg---##g-----#---tt------gg####------####-----------------
XXXXXXXX--XXXXXXXXX--XXXXXXXXXXXXXXXXXXXXXXXXXXXXXXXXXXXXXXXXXXXXXXXXX--XXXXXXXXXXXXXXXXXXXXXXXXXXXXXXXXXXXXXXXXXXXXXXXXXXXXX
XXXXXXXX--XXXXXXXXX--XXXXXXXXXXXXXXXXXXXXXXXXXXXXXXXXXXXXXXXXXXXXXXXXX--XXXXXXXXXXXXXXXXXXXXXXXXXXXXXXXXXXXXXXXXXXXXXXXXXXXXX
