-------------------------------------------------------------------------------------------------------------------------
-------------------------------------------------------------------------------------------------------------------------
-----------------S-------SS!S--------------------------------------------------------------------------------------------
-------------------------------------------------------------------------------------------------------------------------
----------------g--------------------------------------------------------------------------------------------------------
-------------------------------------------------------------------------------------------------------------------------
--------------S@S---------SS--------------------------------------------------------------------------SS!S----SU---------
-------------------------------------------------------------------------------------------------------------------------
--------------------------------#----------------------------------------------------------------------------------------
---------------------gg--------##-g-------------------------1------------####----------------------------#--XXXXX--------
-----!-------XXXXXXXXXX------XXXXXX------S!!S---S!!S-----------------##--####---------------------------##--XXXXX-XXXXX--
-------------XXXXXXXXXX------XXXXXX---------------------------------###--####--------------------------###--------XXXXX--
-------------tt#------------------------------------------------#--#####-####----------tt-------------####---------------
-M-####--------------tt----gg-g-g-----gg-g-g-------------------##-#######-------####---tt-------------####---------------
XXXXXXXXXXXXXXXXXXXXXXXXXXXXXXXXXXXXXXXXXXXXXXXXXXXXXXXXXXXXXXXXXXXXXXXXXXXXXXXXXXXXXXXXXXXXXXXXXXXXXXXXXX---------------
XXXXXXXXXXXXXXXXXXXXXXXXXXXXXXXXXXXXXXXXXXXXXXXXXXXXXXXXXXXXXXXXXXXXXXXXXXXXXXXXXXXXXXXXXXXXXXXXXXXXXXXXXX---------------
