----------------------------------------------------------------------------------------------------------------------------------------
----------------------------------------------------------------------------------------------------------------------------------------
----------------------------------------------------------------------------------------------------------------------------------------
----------------------------------------------------------------------------------------------------------------------------------------
----------------------------------------------------------------------------------------------------------------------------------------
------------------------------------------------------------------------------------tt--------------------------------------------------
----------------------------!-------------------------------------------------------tt--------------------------------------------------
------------------------------------------------------------------------------------tt--------------------------------------------------
--------------------------------------------------------------------------------g-g-tt--------------------------------------------------
--------------------XXXXXXXXXXX#------------------------------------------------####---------------------------1------------------------
----------#--#----!-XXXXXXXXXXX#------------------------------------------------####-------------------SSS!-------------------S!!S------
---------##--#-----##--#----####----------t--------------------------t----------####-------------------------------SU-------------------
---------##--#-----##--#----####----------t----------tt--------------t----------####----------------------------------------------------
-M-------##--#-----##--#####-----------k--t-g----gg--tt--------------t-g--------------------------------------------------#####g---####-
XXXXXXXXXXXXXXXXXXXXXXXXXXXXXXXXXXXXXXXXXXXXXXXXXXXXXXXXXXXXX--XXXXXXXXXXXXXXX--XXXXXXXXXXXXXXX--XXXXXXXXXXXXXXXXXXXXXXXXXXXXXXXXXXXXXXX
XXXXXXXXXXXXXXXXXXXXXXXXXXXXXXXXXXXXXXXXXXXXXXXXXXXXXXXXXXXXX--XXXXXXXXXXXXXXX--XXXXXXXXXXXXXXX--XXXXXXXXXXXXXXXXXXXXXXXXXXXXXXXXXXXXXXX
