-----------------------------------------------------------------------------------------------------------------------------------------------
-----------------------------------------------------------------------------------------------------------------------------------------------
-----------------------------------------------------------------------------------------------------------------------------------------------
-----------------------------------------------------------------------------------------------------------------------------------------------
-----------------------------------------------------------------------------------------------------------------------------------------------
-----------------------------------------------------------------------------------------------------------------------------------------------
------------------------------------------@------------------------------------------------------------------@-----------------------@---------
-----------------------------------------------------------------------------------------------------------------------------------------------
-----------------------------------------------------------------------------------------------------------------------------------------------
------------------------------------1---------------------------------------####---------------------------------------------------------------
--------!--------------tt-----------------!--!-------#--------------------S!####---------------------------##!--!----------SS!S------!--!------
----------------tt-----tt----------------------------#---tt-----------------####--------------------------###----------------------------------
----------------tt#----tt----------------------------#---tt-----------------####---------------#---------####---------------------tt-----------
-M------k--------------------gg-----------------gg---#---tt------------t-g----tt---------gg-gg-##---------------------------------tt-----------
XXXXXXXXXXXXXXXXXXXXXXXXXXXXXXXXXXXXX-XXXXXXXXXXXXX--XXXXXXX-XXXXXXXXXXXXXXXXXXXXXXXXXXXXXXXXXXXXXXXXXXXXXXXXXXXXXXXXXXXXXXXXXXXXXXXXXXXXXXXXXX
XXXXXXXXXXXXXXXXXXXXXXXXXXXXXXXXXXXXX-XXXXXXXXXXXXX--XXXXXXX-XXXXXXXXXXXXXXXXXXXXXXXXXXXXXXXXXXXXXXXXXXXXXXXXXXXXXXXXXXXXXXXXXXXXXXXXXXXXXXXXXX
