-------------------------------------------------------------------------SU--!--!---------------------------------------##
-----------------------------------------------------------------------------------------------------------------------###
-------------------------------------------------------------------------------------#--------tt-----------#----------####
-----------------------------------@---------------------------SS!S-----------------##--------tt-----------##--------#####
--------------------------------------------------------------------------SS-XXXXXXXXXXXXX--XXXXX-XXXXXXXXXXXXXXXXXXXXXXXX
-----------------------------------------------------------------------------XXXXXXXXXXXXX--XXXXX-XXXXXXXXXXXXXXXXXXXXXXXX
---@------------------------S---------------------------------------------------------------------------------------------
-----------------------------------!--!-----S--------------#----SS----------C---------------------------------------------
---------------------------g------------------------------##--------------------------------------------------------------
---------------------------------------------------------------------------------F----------------------------------------
---!--!----SSS!-----------C-------------------------S@S!S-----#---tt---------g---#----------------------------------------
-----------------------------------XXXXX--------XXXX--------XXXXXXXXXXXXX--XXXXXXXXXX-------------------------------------
-----------------------------------XXXXX--------XXXX--------XXXXXXXXXXXXX--XXXXXXXXXX-------------------------------------
-M------------------g-g----g--------####-------------g--------------------------------------------------------------------
XXXXXXXXXXXXXXXXXXXXXXXXXXXXXXXXXX--XXXXX-XXXXXXXX--XXXXXXXX--------------------------------------------------------------
XXXXXXXXXXXXXXXXXXXXXXXXXXXXXXXXXX--XXXXX-XXXXXXXX--XXXXXXXX--------------------------------------------------------------
