---------------------------------------------------------------------------------------------------------------------------------------------
---------------------------------------------------------------------------------------------------------------------------------------------
---------------------------------------------------------------------------------------------------------------------------------------------
---------------------------------------------------------------------------------------------------------------------------------------------
---------------------------------------------------------------------------------------------------------------------------------------------
---------------------------------------------------------------------------------------------------------------------------------------------
----------------------------------------------------------------------------------@-----------------------------------------------------S----
----------------------------------------tt---------------------------------------------------------------------------------------------------
----------------------------------------tt--------------------------------------------------------------------g------------------------g-----
----------------------------------------tt----------------------------#--------------------1-----------------SSSSSSS--------SSS!-------------
---------------------------------SU-----C--------------SS!S----------##-----------!--!-------------S!!S------------------------------S@S-----
----------tt--------------!-----------------------------------------###----------------------------------------------------------------------
----------tt----#--------------------------------------------------####-------------------------------------#--------------------------------
-M--------tt---######---------------tt---g-g--------------------gg-####---------gg-----------gg-##-----tt--#####g------gg-----k--------------
XXXXXXXXXXXXXXXXXXXXXXXXXXXXXXXXXXXXXXXXXXXXXXXXXXX--XXXXXXXXXXXXXXXXXXXXXXXXXXXXXXXXXXXXXXXXXXXXXXXXXXXXXXXXXXXXXXXXXXXXXXXXXXXXXXXXXXXXXX--
XXXXXXXXXXXXXXXXXXXXXXXXXXXXXXXXXXXXXXXXXXXXXXXXXXX--XXXXXXXXXXXXXXXXXXXXXXXXXXXXXXXXXXXXXXXXXXXXXXXXXXXXXXXXXXXXXXXXXXXXXXXXXXXXXXXXXXXXXX--
