--------------------------------------------------------------------------------------------------------------------------------------------------------------
--------------------------------------------------------------------------------------------------------------------------------------------------------------
--------------------------------------------------------------------------------------------------------------------------------------------------------------
--------------------------------------------------------------------------------------------------------------------------------------------------------------
--------------------------------------------------------------------------------------------------------------------------------------------------------------
--------------------------------------------------------------------------------------------------------------------------------------------------------------
--------------------------------------------------------------------------------------------------------------------------------------------------------------
-----------------------------------------------------------------------------------------------------------------------S!!S-----------------------------------
--------------------------------------------------------------------------------------------------------------------------------------------------------------
---------------------SSS!-----------1--------------------------1----####-------------------------------------------------------------------1------------------
----------------!---------------------------------------------------####-------------------------------!-----##--#-----------------------------------SS!S-----
---#---------------------------------------------------------------#####-------#---------!------------------###--##------------------S!!S---------------------
---##-------------------------------------------------------------######----tt-##--------------------------####--###-----------------------------------------#
-M-###---------------------------------------------------gg------#####g-----tt-###-------------------------------####-------------------------------g-g-----##
XXXXXXXXXXXXXXXXXXXXXXXXXXXXXX--XXXXX-XXXXXXXX--XXXXXXXXXXXXXXXXXXXXXXXXXXXXXXXXXXXXXXXXXXXXXXXXXXXXXXXXXXXXXXX--XXXXXX-XXXXXXXXXXXXXXXXXXXXXXXXX--XXXXXX-XXXX
XXXXXXXXXXXXXXXXXXXXXXXXXXXXXX--XXXXX-XXXXXXXX--XXXXXXXXXXXXXXXXXXXXXXXXXXXXXXXXXXXXXXXXXXXXXXXXXXXXXXXXXXXXXXX--XXXXXX-XXXXXXXXXXXXXXXXXXXXXXXXX--XXXXXX-XXXX
