----------------------------------------------------------------------------------------------------------------
----------------------------------------------------------------------------------------------------------------
----------------------------------------------------------------------------------------------------------------
----------------------------------------------------------------------------------------------------------------
-------------------------------------------------------------g--------------------------------------------------
------------------------------------------------------------SSSSSSS---------------------------------------------
---------------------S---------SS!S----SS-----S-@---------------------------------------------------------------
--------------------------------------------------------------------------#-------------------------------------
----------------------------------------------------------g---------------##------------------------------------
--------------------------------------------------------------------------###-----------------------------------
----------!-----------##--#---------------------!--!-----XXXXXXXX-#--#XXXXXXXXXX--------------##--------S-------
---------------------###--##--------------#----------t---XXXXXXXX##--#XXXXXXXXXX-------------###----------------
--------------------####--##--------------##---------t-----------##--#----------------------####----------------
-M-----------####--#####--##g-----------gg###--------t-g------k--##--#------------------gg-#####g-------------gg
XXXXXXXXXXXXXXXXXXXXXXXX--XXXXXX-XXXXXXXXXXXXXXXXXXXXXXXXXXXXXXXXXXXXXXXXXXXXXXX-XXXXXXXXXXXXXXXXXXXXXXXXXXXXXXX
XXXXXXXXXXXXXXXXXXXXXXXX--XXXXXX-XXXXXXXXXXXXXXXXXXXXXXXXXXXXXXXXXXXXXXXXXXXXXXX-XXXXXXXXXXXXXXXXXXXXXXXXXXXXXXX
