----------------------------------####------------------------------g----------------------g----------------
----------------------@--------S--####------------------##---------SSSSSSS---#--#---------SSSSSSS---!-------
----------------------------------####-----------------###---SU-------------##--#t--------------------------
----------------------------------####----------------####------------------##--#t----------------------#---
------------------------------------------k----------#####------------------##--#t-g--------------------##--
------------------SU--!--!----SS-----XXXXXXXXXXXXX--XXXXXX--XXXXXXXXXXXXXXXXXXXXXXXXXXXXXX--XXXXXXXXXXXXXXXX
-------------------------------------XXXXXXXXXXXXX--XXXXXX--XXXXXXXXXXXXXXXXXXXXXXXXXXXXXX--XXXXXXXXXXXXXXXX
------------------------------------------------------------------------------------------------------------
------------------------------------------------------------------------------------------------------------
-------------------SS-XXXXX------------#--------------------------------------------------------------------
-----------S!!S-------XXXXX-----------##--------------------------------------------------------------------
-------------------------------------###--------------------------------------------------------------------
---------------------tt---------g-g----#--------------------------------------------------------------------
-M-----------XXXXXXXXXXXXXXXX--XXXXX--##--------------------------------------------------------------------
XXXXXXXXXXXXXXXXXXXXXXXXXXXXX--XXXXX-###--------------------------------------------------------------------
XXXXXXXXXXXXX-----------------------####--------------------------------------------------------------------
