---------------------------#--------------------------SSS!-----------------------------#---------------------------------
----------------tt--------##---------------------!------------------##----------------##-------!--!-----##------------SS-
----------------tt-------###-----------t---------------------------###--------SU-----###---------------###---------------
----------------tt---tt-####-----------t---------------------tt---####--------------####--------------#####-----tt-------
------------g-g-tt---tt#####---------ggt-g------g------------tt--#####---gg---------####-------------#######----tt-------
------------------------XXXXXXXX--XXXXXXXXXXXXXXXXXXXXXXXXXXXXXXXXXXXXXXXXXXXXXXXXXXXXXXXXXXX--XXXXXXXXXXXXXXXXXXXX------
----SS!S----SS---XXXXX--XXXXXXXX--XXXXXXXXXXXXXXXXXXXXXXXXXXXXXXXXXXXXXXXXXXXXXXXXXXXXXXXXXXX--XXXXXXXXXXXXXXXXXXXX------
-----------------XXXXX---------------------------------------------------------------------------------------------------
-------------------------------------------------------------------------------------------------------------------------
-------------------------------------------------------------------------------------------------------------------------
-----SS-----------------------S@S!S--------------------------------------------------------------------------------------
-----------#-------------------------------------------------------------------------------------------------------------
-----------##------------------------------------------------------------------------------------------------------------
-M------k--###-----------------g-----------------------------------------------------------------------------------------
XXXXXXXXXXXXXXXXXXXXX--XXXXX--XXXXXXXX-----------------------------------------------------------------------------------
XXXXXXXXXXXXXXXXXXXXX--XXXXX--XXXXXXXX-----------------------------------------------------------------------------------
