----------------------------------------------------------------------------------------------------------------
----------------------------------------------------------------------------------------------------------------
----------------------------------------------------------------------------------------------------------------
----------------------------------------------------------------------------------------g----------g------------
---------------------------------------------------------------------------------------SSSSSSS----SSSSSSS-------
-------------------------------@--------------------------------------------------S-----------------------------
---------------------------tt-----------------------------------------------------------------------------------
----------------------gg---tt#----------------------------------------------------------------------------------
---------------------XXXX####-------------------####-------------------------------#----g-----------####--------
---------------------XXXX####--!--!---------S!!S####------------------------------##-XXXX------XXXXXXXXXXXXXXX--
-------##------S----!----####-------------------####-----------------------t-----###-XXXX------XXXXXXXXXXXXXXX--
------###----------------####-------------------####------------tt----#----t----####----------------------------
-----####--------------------------------------------tt-###-----tt---##------gg-########------------k-----------
-M--#####--##XXXXXXXXXXXXXXXXXXXXXXXXXXXX--XXXXXXXXXXXXXXXXXXXXXXXXXXXXXXXXXXXXXXXXXXXXXXXXXXXXXXXXXXXX---------
XXXXXXXXX--XXXXXXXXXXXXXXXXXXXXXXXXXXXXXX--XXXXXXXXXXXXXXXXXXXXXXXXXXXXXXXXXXXXXXXXXXXXXXXXXXXXXXXXXXXX---------
XXXXXXXXX--XXXXXX-----------------------------------------------------------------------------------------------
