------------------------------------------------------------------------------------------------------------------------------
------------------------------------------------------------------------------------------------------------------------------
------------------------------------------------------------------------------------------------------------------------------
------------------------------------------------------------------------------------------------------------------------------
------------------------------------------------------------------------------------------------------------------------------
--------------------SSS!------------------------------------------------------------------------------------------------------
--------------------------------------------@------------------SSS!-----------------------------------------------------------
-------------------------------------------------------------------------------------------!----------------------------------
------------------------------------------------------------------------------------------------------------------------------
-------------------####-----------------------------#--------------------------------------------------------SSS--------------
---S!!S------------####----------------SS!S-!--!---##-------------S!!S------------------!----------------#----------##--------
--------t----------####---------------------------###t--------------------------##----------------------##---------###--------
--------t----------####-------tt---F-------------####t-------------------------###-----------------#---###--------#####------#
-M------t-g-------------------tt---#-------------####t-g---------g-g----------####-----------------##--####------#######----##
XXXXXXXXXXXXXXXXXXXXXXXXXXXXXXXXXXXXXXXXXXXXXXXXXXXXXXXXXXXXX--XXXXXXXXXXXXXXXXXXXXXXXXXX-XXXXXXXXXXXXXXXXXXXXXXXXXXXXXXXXXXXX
XXXXXXXXXXXXXXXXXXXXXXXXXXXXXXXXXXXXXXXXXXXXXXXXXXXXXXXXXXXXX--XXXXXXXXXXXXXXXXXXXXXXXXXX-XXXXXXXXXXXXXXXXXXXXXXXXXXXXXXXXXXXX
