----------------------------------------------------------------------------------------------------------------------------------------
----------------------------------------------------------------------------------------------------------------------------------------
----------------------------------------------------------------------------------------------------------------------------------------
----------------------------------------------------------------------------------------------------------------------------------------
----------------------------------------------------------------------------------------------------------------------------------------
------------------------------------------@---------------------------------------------------------------------------------------------
-----------------------!-----------------------------------g----------------------------------------------------------------------------
---------------------------------------------------------SSS----------------------------------------1-----------------------------------
----------------------------------------------------------------------------------------------------------------------------------------
----tt----------------------------tt---!--!-------------g-----------------------------------------------------------------------!-------
----tt---------------S@S!S--------tt------------------------------------------------------------SS-------------S-----#------------------
----tt-------!--------------------tt------------------S@S---------------##--#----------------------------------------##-----#-----------
----####--------------------------####------------##-------------------###--##---------------------------------------###---##-----------
-M-#####--------------g----------#####-----------#####tt-----------g-###----------------------g-g---gg------g----gg--###----tt--###-----
XXXXXXXXXXXXXXXXXXXXXXXXXXXXXXXXXXXXXXXXXXXXXXXXXXXXXXXXXXXXXXXXXXXXXXXXXXXXX--XXXXXXXXX--XXXXXXXXXXXXXXXXXXXXXXXXXXXXXXXXXXXXXXXXXXXXXX
XXXXXXXXXXXXXXXXXXXXXXXXXXXXXXXXXXXXXXXXXXXXXXXXXXXXXXXXXXXXXXXXXXXXXXXXXXXXX--XXXXXXXXX--XXXXXXXXXXXXXXXXXXXXXXXXXXXXXXXXXXXXXXXXXXXXXX
