---------------------------------------------------------------------------------------------------------------------------------------------------------------
---------------------------------------------------------------------------------------------------------------------------------------------------------------
---------------------------------------------------------------------------------------------------------------------------------------------------------------
---------------------------------------------------------------------------------------------------------------------------------------------------------------
---------------------------------------------------------------------------------------------------------------------------------------------------------------
---------------------------------------------------------------------------------------------------------------------------------------------------------------
--------------------------------------g------------------------------------------------------------------------------------------------------------------------
--------------------g---------------SSS------------------------------------------------------------------------------------------------------------------------
------------------SSS----------------------#--------SSS!-----------------------------------------------------------------------------------------S!!S----------
-----------------------------------g------##-------------------------------------------------------------S!!S----!-----SSS!------------------------------------
-----------------g-----------------------###-------------S@S!S----------------S@S!S----1----------------------------------------#--!-----#---------------------
---------------------------------S@S----####---tt-------------------------------------------------------------------------------##-------##--------------------
---------------S@S----------tt-----------####--tt--------------------tt--tt-----------------------------------------------------###------###-###-----tt--------
-M--------------------------tt--###-----#####--tt-g-------g-----gg---tt--tt----g----tt-------------------g--------------------k-###------#######XXXXXXXXXXXXXXX
XXXXXXXXXXXXXXXXXXXXXXXXXXXXXXXXXXXXXXXXXXXXXXXXXXXXXXXXXXXXXXXXXXXXXXXXXXXXXXXXXXXXXXXXXXXXXXXXXXXXXXXXXXXXX-XXXXXXXXXXXXXXXXXXXXXXXXXXXXXXXXXXXXXXXXXXXXXXXXX
XXXXXXXXXXXXXXXXXXXXXXXXXXXXXXXXXXXXXXXXXXXXXXXXXXXXXXXXXXXXXXXXXXXXXXXXXXXXXXXXXXXXXXXXXXXXXXXXXXXXXXXXXXXXX-XXXXXXXXXXXXXXXXXXXXXXXXXXXXXXXXXXX--------------
