--------------------------------------------------------------------------------------------------------------------------------------
--------------------------------------------------------------------------------------------------------------------------------------
--------------------------------------------------------------------------------------------------------------------------------------
--------------------------------------------------------------------------------------------------------------------------------------
--------------------------------------------------------------------------------------------------------------------------------------
-----------------------------------------------------------------------------------------------------------@--------------------------
----------------------------------------------------------------------------------t------------#--------------------------------------
-----------------------SU---------------------------------------------------------t-----------##--------------------------------------
----------------------------------------------------##--#-------------------------t----------###--------------------------------------
---------------------------------------------------###--##----------------------g-t---------####--------!--!--------------------------
---------------!---------C-----g--------1---------#####-------SU---------tt---S@S!S---##--#------!------------------------!-----------
-----tt---------------------XXXXX----------------######------------------tt----------###--##------------------------------------------
-----tt---------------------XXXXX---------------#######----------g-------tt-----------------------------------###-------tt------------
-M---tt-g-----------------g-g--------######-----#######-----tt-----------------g--------------gg-----------k--####-gg---tt------------
XXXXXXXXX--XXXXXXXXXXXXXXXXXXXXXXXXXXXXXXXXXXXXXXXXXXXXXXXXXXXXXXXXXXXXXXXXXXXXXXXXXXXXXXX---XXXXXXXXXXXXXXX--XXXXXXXXXXXXXXXXXXXXXXXX
XXXXXXXXX--XXXXXXXXXXXXXXXXXXXXXXXXXXXXXXXXXXXXXXXXXXXXXXXXXXXXXXXXXXXXXXXXXXXXXXXXXXXXXXX---XXXXXXXXXXXXXXX--XXXXXXXXXXXXXXXXXXXXXXXX
