-----------------------------------------------------------------------------------------------------------------
------------------------------------------------------------------------S!!S-------------------------------------
-------------------------------------------------------S@S!S-----------------------------------------------------
------------------------------@----------------!--!--------------------------------------------------------------
-----------------------------------------------------------------------------------------------------------------
--------------------------------------------------------g------gg----------k-----#-------------------------------
------------------------------------------#####XXXXXXXXXXXXXXSXXXXXXXXXXXXXX----##-------------------------------
---------------------------!--!----------######XXXXXXXXXXXXXX-XXXXXXXXXXXXXX---###-------------------------------
--------------------------------#####---#######-------------------------------####-----####------tt--------------
--------------------#----------######---#######---------------------------------------#####-gg---tt---g--gg------
----#--------------##---------#######----------------------SS--------------XXXXXXXXXXXXXXXXXXXXXXXXXXXXXXXXXXXXXX
----##-------##---###---------#######--------------------------------------XXXXXXXXXXXXXXXXXXXXXXXXXXXXXXXXXXXXXX
----###-----###--####----------------------------------tt----------------F---------------------------------------
-M--###----tt--tt-----------g--gg-------------gg--gg---ttg-g--###--------#---------------------------------------
XXXXXXXXXXXXXXXXXXXXXXXXXXXXXXXXXXXXXXXXXXXXXXXXXXXXXXXXXXXXXXXXXXXXXXXXXXXXX------------------------------------
XXXXXXXXXXXXXXXXXXXXXXXXXXXXXXXXXXXXXXXXXXXXXXXXXXXXXXXXXXXXXXXXXXXXXXXXXXXXX------------------------------------
