-----------------SSS---!-----------g----##--------------------------------------------------tt-----------#-----------------------------
----------------------------------S----###------!-----------C------!--!-------------!---------C---------##-------##--#-----------------
----------------g---------------------####-------------------------------------SU----------------------###------###--##-----------SU---
------------------------------------------------------------------------------------------------------####-----------###---------------
--------------S@######------M----------------tt--------------gtt-------------------------------g----tt-----------g---####--------------
----------------XXXXXXXXXXXXXXXXXXXXXXXXXXXXXXXXXXXXXXXXXXXXXXXXXXXXXXXXXXXXXXXXXXXXXXXXXXXXXXXXXXXXXXXXXXXXXXXXXXX--XXXX--XXXXXXXXXXX-
-----------#####XXXXXXXXXXXXXXXXXXXXXXXXXXXXXXXXXXXXXXXXXXXXXXXXXXXXXXXXXXXXXXXXXXXXXXXXXXXXXXXXXXXXXXXXXXXXXXXXXXX--XXXX--XXXXXXXXXXX-
----------######-----------------------------------------------------------------------------------------------------------------------
---------#######-----------------------------------------------------------------------------------------------------------------------
---------#######-----------------------------------------------------------------------------------------------------------------------
----------------C----------------------------------------------------------------------------------------------------------------------
---------------------------------------------------------------------------------------------------------------------------------------
---------------------F-----------------------------------------------------------------------------------------------------------------
-M-###-----------g---#-----------------------------------------------------------------------------------------------------------------
XXXXXXXXXXXXXXXXXXXXXXXXX--------------------------------------------------------------------------------------------------------------
XXXXXXXXXXXXXXXXXXXXXXXXX--------------------------------------------------------------------------------------------------------------
