---------------------------------------------@----------------------------------------------------------------
--------------------------------------------------------------------------------------------------------------
--------------------------------------------------------------------------------------------------------------
---------------------------------------------------------------------------------g----------------------------
---S!!S-----------------------------------!--!---------------------------------SSS----------------------------
-------------------------------------------------------------------------------------------------------SSS----
------------------------------------------------------------------------------g---------###-------------------
---------------------------------tt------------C----------------------------------------###-------C-----------
-#####-------------SSS-----------tt------------------------------SSS---------@S---------###-------------------
######---------------------------tt-------------------------------------S!!S------------###----------###------
######----------------------------------g-------g------SSS!--------------------SS---tt----SS-------g-###------
######-------------------------------XXXXXXXXXXXX-----------------------------------tt-------XXXXXXXXXXXXXXXXX
-------------------------------------XXXXXXXXXXXX---------------------------------XXXXXX-----XXXXXXXXXXXXXXXXX
-M--------M-------g--------M-----gg------tt------------------------------tt--g-g--XXXXXXg-g-------------------
XXXXXXXXXXXXXXXXXXXXXXXXXXXXXXXXXXXXXXXXXXXXXXXXXXXXXXXXXXXXXXXXXXXXXXXXXXXXXXXXXXXXXXXXXXXXXXXXXX------------
XXXXXXXXXXXXXXXXXXXXXXXXXXXXXXXXXXXXXXXXXXXXXXXXXXXXXXXXXXXXXXXXXXXXXXXXXXXXXXXXXXXXXXXXXXXXXXXXXX------------
