-----------------------------------------------------------------------------------------------------------------------
-----------------------------------------------------------------------------------------------------------------------
-----------------------------------------------------------------------------------------------------------------------
-----------------------------------------------------------------------------------------------------------------------
-----------------------------------------------------------------------------------------------------------------------
-----------------------------------------------------------------------------------------------------------------------
--S!!S----!---------@------------------------------------------------------------@-------------------------------------
-------------------------------------------------S-----------1------------SU-------------------------------------------
-----------------------------------------------------------------------------------------------------------------------
--------------------------------SSS!-----------------------------------------------------------------------------------
-----------------!--!--SS--------------------------------g--g---------SSS-----!--!-------------------------------------
----------##--#------------#--------------------XXXXXXXXXXXXXX----------------------------------------------------SS!S-
---------###--##-----------##------------####---XX--###--------------------------------tt------------------tt----------
-M--gg-----------k---------##-----------#####g-g----####-------gg---------gg-----tt----tt--tt---------gg---tt----------
XXXXXXXXXXXXXXXXXXXXXXXXXXXXXXXXXXXXXXXXXXXXXXXXXX--XXXXXXXXXXXXXXXXXXXXXXXXXXXXXXXXXXXXXXXXXXXXXXXXXXXXXXXXXXXXXXXX---
XXXXXXXXXXXXXXXXXXXXXXXXXXXXXXXXXXXXXXXXXXXXXXXXXX--XXXXXXXXXXXXXXXXXXXXXXXXXXXXXXXXXXXXXXXXXXXXXXXXXXXXXXXXXXXXXXXX---
