----------------------------------------------------------------------------------------------------------------------------------------------
----------------------------------------------------------------------------------------------------------------------------------------------
----------------------------------------------------------------------------------------------------------------------------------------------
----------------------------------------------------------------------------g-----------------------------------------------g-----------------
--------------------------------------------------------------------------SSS---------------------------------------------SSS-----------------
----@-----------------------------------------------------------------------------------------------------------------------------------------
-------------------------------------------------------------------------g-----------------------------------------------g--------------------
---------------------------------------------------------------------------------------------------tt-----------------------------------------
-------------------------------------------------------------------S!--S@S--------##--#------------tt------------------S@S--------------------
-!--!----------------------------------------------------------------------------###--#------------tt-----!-----------------------------------
----------------------------------------------------------------------------C-!--------------------SS----------!-----S----------k-------------
---------------------------------------------------------------------------------------------------------------------------XXXXXXXXXX---------
-------------------------------tt------------------------------------------------------------------------------------------XXXXXXXXXX---------
-M-------#--------#------------tt--#-----M---------#------------g------------g------gg-#---------g-g----------------------tt--------######----
XXXXXXXXXXXXXXXXXXXXXXX--XXXXXXXXXXXXXXXXXXXXXXXXXXXXXXXXXXXXXXXXXXXXXXXXXXXXXXXXXXXXXXXXXXXXXXXXXXXXXXXXXXX---XXXXXXXXXXXXXXXXXXXXXXXXXXXXXXX
XXXXXXXXXXXXXXXXXXXXXXX--XXXXXXXXXXXXXXXXXXXXXXXXXXXXXXXXXXXXXXXXXXXXXXXXXXXXXXXXXXXXXXXXXXXXXXXXXXXXXXXXXXX---XXXXXXXXXXXXXXXXXXXXXXXXXXXXXXX
