--------------------------------------------------------------------------------------------------------------------------------------
--------------------------------------------------------------------------------------------------------------------------------------
--------------------------------------------------------------------------------------------------------------------------------------
--------------------------------------------------------------------------------------------------------------------------------------
-------------------S!!----------------------------------------------------------------------------------------------------------------
--------------------------------------------------------------------------------------------------------------------------------------
--------------------------------------------------------------------------------------------------------------------------------------
-----------------------------------------------------------------------##------------g------------------------------------------------
------------#####--------!--------------------------------------------###--SSS-----SSS------------------------------------------------
---SSS-----######----------------------------------SSS!--------------####-------------------------------------------------------------
----------#######---------------------S-------------------##--S@S!S--S------------g--------##-------------#---!------tt------SS-------
----------#######----------------------------------------###------------------------------###------------##----------tt-----------tt--
---------------####------tt--###------------------------####--------------------S@S------####-----------###----------tt-----------tt--
-M------------#####-gg---tt--####---------------------k######--g--------------------------------------#####--------g-tt----g-g----tt-g
XXXXXXXX--XXXXXXXXXXXXXXXXX--XXXXXXXXXXXXXX--XXXXXXXXXXXXXXXXXXXXXXXXXXXXXXXXXXXXXXXXXXXXXXXXXXXXXXXXXXXXXXXXXXXXXXXXXXXXXXXXXXXXXXXXX
XXXXXXXX--XXXXXXXXXXXXXXXXX--XXXXXXXXXXXXXX--XXXXXXXXXXXXXXXXXXXXXXXXXXXXXXXXXXXXXXXXXXXXXXXXXXXXXXXXXXXXXXXXXXXXXXXXXXXXXXXXXXXXXXXXX
