-----------------------------------------------------------------------------------------------------------------------------------------------
-----------------------------------------------------------------------------------------------------------------------------------------------
-----------------------------------------------------------------------------------------------------------------------------------------------
-----------------------------------------------------------------------------------------------------------------------------------------------
-----------------------------------------------------------------------------------------------------------------------------------------------
-----------------------------------------------------------------------------------------------------------------------------------------------
---------------------------!-------------------------------------------------------------------------------------------------------------------
------S-----------------------------------------------------------------------------------tt---------------------------------------------------
----------------------------------------------SSS!----------------------------------------tt---------------------------------------------------
-----g----------------tt------------------------------------------------------------------tt-------------SSS-------##--------------#####-------
-----------tt---------tt----------------------------------SU----------S!!-----S-------------C---------------------###-------------######-------
---S@S-----tt---------tt----------tt-----------------------------------------------------------------------------####-----tt-----#######-------
-----------tt-------g-tt----------tt--------tt-####-----------------------------------------------------------------------tt-----#######-------
-M------k-g----M----###------gg---tt-g-gg---tt#####----tt------------------------------------g----#-----------------------tt-g----tt---####----
XXXXXXXXXXXXXXXXXXXXXXXXXXXXXXXXXXXXXXXXXXXXXXXXXXXXXXXXXXXXXXXXXXXXXXXXXXXXXXXXXXXXXXXXXXXXXXXXXXXXXXXXXXXXXXXXXXXXXXXXXXXXXXXXXXXXXXXXXXXXX--
XXXXXXXXXXXXXXXXXXXXXXXXXXXXXXXXXXXXXXXXXXXXXXXXXXXXXXXXXXXXXXXXXXXXXXXXXXXXXXXXXXXXXXXXXXXXXXXXXXXXXXXXXXXXXXXXXXXXXXXXXXXXXXXXXXXXXXXXXXXXX--
