------------------------------------------------------------------------------------------------------------------------------------------
------------------------------------------------------------------------------------------------------------------------------------------
------------------------------------------------------------------------------------------------------------------------------------------
------------------------------------------------------------------------------------------------------------------------------------------
------------------------------------------------------------------------------------------------------------------------------------------
------------------------------------------------------------------------------------------------------------------------------------------
---------------------------S!!S-------------------------------------------#-----#--------!------------------------------------------------
-------------------------------------------------------------------------##----##---------------------------------------------------------
---------------------------------------------------------------------t--###---###------------------------------------SU-------------------
---1-------------------------------------tt--------------------------t-####--####--------------tt--!--------------------------------------
-------------S@S!--------S@S!S-----------tt----1-------#-------------tt-------SS--------S------tt-----------------------------------------
--------------------##-------------------tt------------##----------g-tt------------tt----------tt-----------------------------------------
-------------------###------------tt---g-tt------------###----------####-----------tt--------------------M----#-------------------gg-#----
-M------------g-----------g-------tt---g---------------####--------#####-gg-g-g----tt-g------------XXXXXXXXXXXXXXXXXXXXXX---XXXXXXXXXXXXXX
XXXXXXXXX---XXXXXXXXXXXXXXXXXXX-XXXXXXXXXXXXXXXXXXXXXXXXXXXXXXXXXXXXXXXXXXXXXXXXXXXXXXXXXXXXXXXXXX-XXXXXXXXXXXXXXXXXXXXXX---XXXXXXXXXXXXXX
XXXXXXXXX---XXXXXXXXXXXXXXXXXXX-XXXXXXXXXXXXXXXXXXXXXXXXXXXXXXXXXXXXXXXXXXXXXXXXXXXXXXXXXXXXXXXXXX----------------------------------------
