------------------------------------------------------------------------------------------------------------------
------------------------------------------------------------------------------------------------------------------
----------------------------------------------------------------------------######-----#--------------------------
----------------------------------------------------------------------------XXXXXX----##--------------------------
----------------------------------------------------------------------------XXXXXX---#----------------------------
------------------------------------------------------------g-----------------------##----------------------------
-----------S----------------------------------------------SSS---------------------####----------------------------
---------------------------------------------------------------------------------#####----------------------------
-----------------------S!!S------------------------------g----------------------######--S!------------------------
-----SS!-------1------------------------------------------------------------1---######--------SU------------------
-------------------------------------------------------S@S---------------------------S----------------##--#-------
-------------------------------------------1---------------------------------------------------------###--##------
------------------###-----------#---tt-------------------------tt--------tt----###-------####--###--------###-----
-M-----------gg---####---------##---tt---------#------g--------tt--------tt-g--####g-g--#####--####-------####----
XXXXXXXXX---XXXX--XXXXXXXXX---###---tt--XXXXXXXXXXXXXXXXXXX--XXXXXXXXXXXXXXXX--XXXXXXXXXXXXXX--XXXXXXXXX--XXXXXXXX
XXXXXXXXX---XXXX--XXXXXXXXX--####-g-tt--XXXXXXXXXXXXXXXXXXX--XXXXXXXXXXXXXXXX--XXXXXXXXXXXXXX--XXXXXXXXX--XXXXXXXX
