------------------------------------------------------------------------------------------------------------------------------
------------------------------------------------------------------------------------------------------------------------------
------------------------------------------------------------------------------------------------------------------------------
------------------@-----------------------------------------------------------------------------------------------------------
------------------------------------------------------------------------------------------------------------------------------
------------------------------------------------------------------------------------------------------------------------------
-------------------------------------------------------------------------------SSS!-------------------------------------------
---------------!--!-----------------------------1-----------------------------------------------------------------------------
----------------------------------------------------------------------#-------------------------------------------------------
----------------------------------tt--------------------------#------##-----------------------!-----------------------S!!S----
----S---------------C-!-----------tt--S------#####------##--#-#-----###---------------1--------------------SU-----------------
-----------tt---------------------tt--------######-----###--###----####-------------------------------------------------------
-----------tt------------------------------#######-------#-####---------------------------####--------------------------------
-M---------tt-g------g-----#---------------#######-------####-----k-------M-----gg-###########---------k######----------------
XXXXXXXXXXXXXXXXXXXXXXXXXXXXXXXXXXXXXXXXXXXXXXXXXXXXXXX--XXXXXXXXXXXXXXXXXXXXXXXXXXXXXXXXXXXXXXXXXXXXXXXXXXXXXXXXXXXXXXXXXXXXX
XXXXXXXXXXXXXXXXXXXXXXXXXXXXXXXXXXXXXXXXXXXXXXXXXXXXXXX--XXXXXXXXXXXXXXXXXXXXXXXXXXXXXXXXXXXXXXXXXXXXXXXXXXXXXXXXXXXXXXXXXXXXX
