-----------------------------------------------------------------------------------------------------------------------
-----------------------------------------------------------------------------------------------------------------------
-----------------------------------------------------------------------------------------------------------------------
---------------------------------------------------------------@-------------------------------------------------------
----------------------------------------#------------------------------------------------------------------------------
---------------------------------------##------------------------------------------------------------------------------
--------------------------------------###------------------------------------------------------------------------------
-------------------------------------####-------------------!--!---------SU----S@S!S-----------------------------------
-SSS--------SSS!----------------!--#####----SSS!------SSS--------------------------------------------------------------
----------------------------------######--------------------------------------------------------------!----------------
--------------------------tt-----#######-------------------------C--S@S!S-------g--------------------------------------
--------------------------tt-----#######--------------------------------------XXXXXXX--XXXXXXXX------------------------
--------------------tt----tt-----####-------------------###------------------------XX--X-####--###-----------------####
-M------------------tt--g-tt----#####-----------######--####------g--g----gg------------#####--####---------------#####
XXXXXXXXX---XXXXXXXXXXXXXXXXXXXXXXXXXXXXXXXXXXXXXXXXXX--XXXXXXXXXXXXXXXXXXXXXXXX---XXXXXXXXXX--XXXXXXXXXXXXXXXXXXXXXXXX
XXXXXXXXX---XXXXXXXXXXXXXXXXXXXXXXXXXXXXXXXXXXXXXXXXXX--XXXXXXXXXXXXXXXXXXXXXXXX---XXXXXXXXXX--XXXXXXXXXXXXXXXXXXXXXXXX
