----------------------------------------------------------------------------------------------------------------------------------------
----------------------------------------------------------------------------------------------------------------------------------------
----------------------------------------------------------------------------------------------------------------------------------------
----------------------------------------------------------------------------------------------------------------------------------------
----------------------------------------------------------------------------------------------------------------------------------------
----------------------------------------------------@-----------------------------------------------------------------------------------
---------------------------------------------------------------------g--------------------------SSS-------------------------------------
------------------------------------1------------------------------SSS------------------------------------------------------------------
----------------------------------------------------------------------------------------------------------------------------------------
----##-------------------------------------------!--!-------------g-------SU------------------------------------------------------------
---###--------------------SU------S--------------------------------------------##--------tt---------S@S!S-----------------SS------------
--####------------------------------------SU--------------------S@S-----------###--------tt--------------------##--#--------------------
------------------------------------------------tt---------------------------####--------tt-----XXX-----------###--##-------------------
-M-------#--------#----tt-----------------------tt-----------tt---------------g---#----g-tt-----XXX--g---------k###-----g-g--#----------
XXXXXXXXXXXXXXXXXXXXXXXXXXXXXXXXXXXXXXXXXXXXXXXXXXXXXXXXXX---XXXXXXXXXXXXXXXXXXXXXXXXXXXXXXXXXXXXXXXXXXXXXXXXXXXXXXXXXXXXXXXXXXXXX--XXXX
XXXXXXXXXXXXXXXXXXXXXXXXXXXXXXXXXXXXXXXXXXXXXXXXXXXXXXXXXX---XXXXXXXXXXXXXXXXXXXXXXXXXXXXXXXXXXXXXXXXXXXXXXXXXXXXXXXXXXXXXXXXXXXXX--XXXX
