------------------------------------------------------------------------------------------------------------------------------------------
------------------------------------------------------------------------------------------------------------------------------------------
------------------------------------------------------------------------------------------------------------------------------------------
-----------------------------------------------------------------@------------------------------------------------------------------------
------------------------------------------------------------------------------------------------------------------------------------------
------------------------------------------------------------------------------------------------------------------------------------------
---------------------------g-------SSS----------------------------------------------------------------------------------------------------
-------------------------SSS----------------------------------!--!------------------------------------------------------------------------
-------------------------------------------------------------------------------------------------##---------------------------------------
------------------------g--------------------------------------------------------------##-------###---------------------------------------
----#---------------------------!-----------##-----------!---------C-----------!---#--###---------SS------------------S!!S--#-------------
----##----------------S@S------------------###-------tt----------------------------#-####--------------##--#----------------##------------
----###----------tt-----------------------####-------tt----------------------------###-####-----------###--##---------------###-------###-
-M--###-----gg---tt-------------------gg----------k--tt-g-----------g-----###------########---g-g-g--tt---------------------###-------####
XXXXXXXXXXXXXXXXXXXXXXXXXXXXXXXXXXXXXXXXXXXXXXXXXXXXXXXXXXXXXXXXXXXXXXXXXXXXXXXXXXXXXXXXXXXXXXXXXXXXXXXXXXXXXXXXXXXXXXXXXXXXXXXXXXXX--XXXX
XXXXXXXXXXXXXXXXXXXXXXXXXXXXXXXXXXXXXXXXXXXXXXXXXXXXXXXXXXXXXXXXXXXXXXXXXXXXXXXXXXXXXXXXXXXXXXXXXXXXXXXXXXXXXXXXXXXXXXXXXXXXXXXXXXXX--XXXX
