----------------------------------------------------------------------------------------------------------------------------------------------
----------------------------------------------------------------------------------------------------------------------------------------------
----------------------------------------------------------------------------------------------------------------------------------------------
----------------------------------------------------------------------------------------------------------------------------------------------
----------------------------------------------------------------------------------------------------------------------------------------------
-----------------------------------------------------------------g-----------@----------------------------------------------------------------
----SSS--------------------------------------------------------SSS----------------------------!------------------------tt---------------------
-----------------------------------------------------------------------------------------------------------------------tt---------------------
--------------------------------------------------------------g---------------------------------------------SSS!-------tt---------------------
----------------------------##--------------------------------------------!--!---------------------------------------g-tt---------------------
----S----------------------###----------------tt------------S@S-----------------------------S@S!S----##--S------------SS----------------------
--------------##--#-------####-------##--#----tt----------------------------------------------------###---------------------------------------
-------------##-------------####----###--#----tt--------------------tt-----------------------------####---------###---------------------------
-M------------k------------#####tt-------------------#--------tt----tt--g-g--------------g---g---------k--------####g-g---gg-###--------------
XXXXXXXXXXXXXXXXXXXXX--XXXXXXXXXXXXXXXXXXXXXXXXXXXXXXXXXXXXXXXXXXXXXXXXXXXXXXXXXXXX---XXXXXXXXXXXXXXXXXXXXXXXX--XXXXXXXXXXXXXXXXXXXXXXXXXXX---
XXXXXXXXXXXXXXXXXXXXX--XXXXXXXXXXXXXXXXXXXXXXXXXXXXXXXXXXXXXXXXXXXXXXXXXXXXXXXXXXXX---XXXXXXXXXXXXXXXXXXXXXXXX--XXXXXXXXXXXXXXXXXXXXXXXXXXX---
