-------------------------------------------------------------------------------------------------------------------------------
--------------------------g----------------------------------------------------------------------------------------------------
------------------------SSS----------------------------------------------------------------------------------------------------
--------------------------------------------------------------------------------------------------@----------------------------
-----------------------g-------------------------------------------------------------------------------------------------------
-------------------------------------------------------------------------------------------------------------------------------
---------------------S@S------------------------------------------------------@--------##--#-----------------------------------
-------------###--------------#----tt-------------------------------------------------###--##--!--!----------------------------
--------S!!--####----tt------##----tt---------------------------------------------#####----------------------------------------
-------------XXXXXXXXXXXX---###----tt----------##-------------SS!S---------------######----------------------------------------
-------------XXXXXXXXXXXX-S@S!S------C--#--!--###--------------------SS!S-------#######-------------C--#---------#-------------
----------------------------------------##---####-------------------------------#######----------------##--------##------------
----------------------------------------###-------###-------####------------tt---###-------------------###-------###-------####
-M----------------------g--g----------g-###-------####---g-#####tt----------tt---###---------g-------g-###-------###-M----#####
XXX--XXXXXXXXXX---XXXXXXXXXXXXXXXXXXXXXXXXXXXXXX--XXXXXXXXXXXXXXXXXXXXXXXXXXXXXXXXXXXXXXXXXXXXXXXXXXXXXXXX--XXXXXXXXXXXXXXXXXXX
XXX--XXXXXXXXXX---XXXXXXXXXXXXXXXXXXXXXXXXXXXXXX--XXXXXXXXXXXXXXXXXXXXXXXXXXXXXXXXXXXXXXXXXXXXXXXXXXXXXXXX--XXXXXXXXXXXXXXXXXXX
