-------------------------------------------------------------------------------------------------------------------------------------------------------------
-------------------------------------------------------------------------------------------------------------------------------------------------------------
-------------------------------------------------------------------------------------------------------------------------------------------------------------
-------------------------------------------------------------------------------------------------------------------------------------------------------------
-------------------------------------------------------------------------------------------------------------------------------------------------------------
-------------------------------------------------------------------------------------------------------------------------------------------------g-----------
----------------------------!--------------------------------------------------------------------------------SSS!--------g---------------------SSS-----------
-----------------------------------------------------------------------------------------------------------------------SSS-----------------------------------
-----------------------------------tt---------------------------------------------------------------------------------------------------------g--------------
-----------------------------------tt---------------------------------------------------------------------------------g--------------------------------------
----##--#-------!--------------C---tt----------------#-------SU--------------------------------------#--------------------------------------S@S-----------SS-
---###--##-----------------------g-tt----------------##-------------tt-------------------##--#-------##-------------S@S------tt------------------------------
----------------------------------####---------------###------------tt--------------tt--###--#-------###---------------------tt------------------------------
-M----------tt-------#----------g#####------------g--###tt----------tt-g######-gg---tt###------M-----###------gg-tt----------tt-g---------#-------------g-g--
XXXXXXXXXXXXXXXXXXXXXXXXXXXXXXXXXXXXXXXXXXXXXXXXXXXXXXXXXXXXXXXXXXXXXXXXXXXXXXXXXXXXXXXXXXXXXXXXXXXXXXXXXXXXXXXXXXXXXXXXXXXXXXXXXXXXXXX---XXXXXXXXXXX---XXXXX
XXXXXXXXXXXXXXXXXXXXXXXXXXXXXXXXXXXXXXXXXXXXXXXXXXXXXXXXXXXXXXXXXXXXXXXXXXXXXXXXXXXXXXXXXXXXXXXXXXXXXXXXXXXXXXXXXXXXXXXXXXXXXXXXXXXXXXX---XXXXXXXXXXX---XXXXX
