------------------------------------------------------------------------------------------------------
-------------------------------------------------------------g----------------------------------------
-----------------------------------------------------------SSS----------------------------------------
-----------------------------######-gg---------#####--------------------------------------------------
-----------------------------XXXXXXXXXXXXXX---######------g-------------------------------------------
-----------------------------XXXXXXXXXXXXXX--#######--------------------------------------------------
---------------------------------------------#######----S@S-------------------------------------------
-------------------------g----------------------------------------------------------------------------
-----------------------SSS---!-------------------------###---------!----------SSS---------------------
---##-----------------------------------------XXXXXX---XXXXXXXX#--------------------------------------
--###-----------------g------------SU---------XXXXXX---XXXXXXXX----------------------S----------------
-####-----------------------------------------##--#---------------------------------------------------
--------------------S@S----------------------###--##----------------------------####--------------F---
-M---------------------------------k-----######----------g----g-g---------M----#####------#-------#---
XXXXXXXXX---XXXXXXXXXXXXXXXXXXXXXXXXXXXXXXXXXXXXXXXXXXXXXXXXXXXXXXXXXXXXXXXXXXXXXXXXXXXXXXXXXXXXXXXXXX
XXXXXXXXX---XXXXXXXXXXXXXXXXXXXXXXXXXXXXXXXXXXXXXXXXXXXXXXXXXXXXXXXXXXXXXXXXXXXXXXXXXXXXXXXXXXXXXXXXXX
