---------------------------------------------------------------------------------------------------------------------------------------------------
---------------------------------------------------------------------------------------------------------------------------------------------------
---------------------------------------------------------------------------------------------------------------------------------------------------
---------------------------------------------------------------------------------------------------------------------------------------------------
---------------------------------------------------------------------------------------------------------------------------------------------------
----------------SSS--------------------------------------------------------------------------------------------------------------------------------
--------tt------------------------------------------------------------------------------------@-----------------------g----------------------------
--------tt----------------------------------------------------------------------------------------------------------SSSSSSSS---SSS!----------------
--------tt------------------------------------------------S!!S--------------------------------------------------------------C-----------------1----
-----#####-----#####-----------------------------------------------------------------------------------------------g-------------------------------
----######----######---------S@S!S--------------------------------------------##-----------!--!------------------------------------------tt--------
---#######---#######---------------------------------------------------------###--------------------------tt-----S@S---------g-g----gg---tt######--
---#######---####-####------------------------------------------------tt----####--------------------------tt-----------XXXXXXXXXXXXXXXXXXXXXXXXXX--
-M-###-----###########-M------g----------#----######-------------gg---tt---g-###---------tt---------------tt-g---S@S!S-XXXXXXXXXXXXXXXXXXXXXXXXXX--
XXXXXXXXXXXXXXXXXXXXXXXXXXXXXXXXXXX--XXXXXXXXXXXXXXX--XXXXXXXXXXXXXXXXXXXXXXXXXXXXXXXXXXXXXXXXXXXX--XXXXXXXXXXXX-----------------------------------
XXXXXXXXXXXXXXXXXXXXXXXXXXXXXXXXXXX--XXXXXXXXXXXXXXX--XXXXXXXXXXXXXXXXXXXXXXXXXXXXXXXXXXXXXXXXXXXX--XXXXXXXXXXXX-----------------------------------
