---------------------------------------------------------------------------------------------------------------------------------------------------------------
---------------------------------------------------------------------------------------------------------------------------------------------------------------
---------------------------------------------------------------------------------------------------------------------------------------------------------------
---------------------------------------g-----------------------------------------------------------------------------------------------------------------------
-------------------------------------SSS-----------------------------------------------------------------------------------------------------------------------
---------------------------------------------------------------------------------------------------------------------------------------------------------------
-------------------SSS!-------------g--------------------------------------------------------------------------------------------------------------------------
---------------------------------------------------------------------------------------------------------------------------------------------------------------
----------------------------------S@S-----------------------------------------------------------------SSS!-----------------------------------------------------
---------------##----------------------------------#####---------!------------------------------------------------------------SS!S---------------------S!!S----
--------------###----------##----------C----------######---------------------------------------#-------------------------------------S!!S----------------------
-------------####---------###--------------------#######---------------------------------------##-g------------------------------------------------------------
-----tt--------####------####--------------------#######---tt----------------------------------###-####--------------------------------------------------------
-M---tt--#----#####-gg------------------g#-----------------tt--tt------------#----------######-########---------######-M---------------------------------------
XXXXXXXXXXXXXXXXXXXXXXXXXXXXXXXXXXXXXXXXXXXXXXXXXXXXXXXXXXXXXXXXXXXXXXXXXXXXXXXXXX--XXXXXXXXXXXXXXXXXXXXXXXXX---XXXXXXXXXXXXXXXXXX---XXXXXXXXXXXXXXXXXXXXXXXXXX
XXXXXXXXXXXXXXXXXXXXXXXXXXXXXXXXXXXXXXXXXXXXXXXXXXXXXXXXXXXXXXXXXXXXXXXXXXXXXXXXXX--XXXXXXXXXXXXXXXXXXXXXXXXX---XXXXXXXXXXXXXXXXXX---XXXXXXXXXXXXXXXXXXXXXXXXXX
