-----------------------------------------------------------------------------------------------------------------------------------
-----------------------------------------------------------------------------------------------------------------------------------
------------g---------------------------------------------------------------------------------------------SSS!---------------------
----------SSSSSSSS-----------------------------------------------------------------------------------------------------------------
----------------------SU----S@S!-----------##--#-----------------------------------------------------------------------------------
---------g--------------------------tt----###--##-----------------------SSS!----------------tt-------------------------------------
------------------------------------tt---#####-------------------------------------S!!S-----tt----------#####-----------tt---------
-------S@S--------------C----g------tt--######-----------##---S-------------------------#---tt---------######-----------tt---------
---------------------------XXXXX----XXX#######----------###-----------------------------##g-tt--------#######-----------tt---------
----#####------------------XXXXX----XXX#######------------------------------------------###-----------#######----##---g-tt---------
---######----------------g######-----g--------k---------------------M-------------------###---------tt----------####tt---------g---
--#######----------XXXXXXXXXXXXXXXXXXXXXXXXXXXXXXXXXX---XXXXXXXXXXXXXXXXXXXXXXX---XXXXXXXXXXXXXXX---XXXXXXXXXX--XXXXXXXXXXXXXXXXXXX
--#######-----F----XXXXXXXXXXXXXXXXXXXXXXXXXXXXXXXXXX---XXXXXXXXXXXXXXXXXXXXXXX---XXXXXXXXXXXXXXX---XXXXXXXXXX--XXXXXXXXXXXXXXXXXXX
-M-----tt-----#--------------------------------------------------------------------------------------------------------------------
XXXXXXXXXXXXXXXXXX-----------------------------------------------------------------------------------------------------------------
XXXXXXXXXXXXXXXXXX-----------------------------------------------------------------------------------------------------------------
