------------------------------------------------------------------------------------------------------------------------------------------------------
------------------------------------------------------------------------------------------------------------------------------------------------------
------------------------------------------------------------------------------------------------------------------------------------------------------
------------------------------------------------------------------------------------------------------------------------------------------------------
------------------------------------------------------------------------------------------------------------------------------------------------------
------------------------------------------------------------------------------------------------------------------------------------------------------
----------------------g-----------------g-------------------------------------------SSS---------------------------------------------------------------
--------------------------------------SSS-------------------------------------------------------------------------------------------------------------
------------------------------------------------------------------------------------------------------------------------------------------------------
-------------------g-----------------g----------------------------------------------------------------------------------------------------------------
--------------------------!-----#----------tt---------------------##----------------------------------tt-----------SSS-----------tt-------------------
-----------------S@S------------#--S@S-----tt--------------------###----------------------------------tt-------------------------tt-------------------
--------------------------------#----------tt---------------------------------------------------------tt---###-------------------tt-------------------
-M-----------------k-M----------#########g-tt---------------#----------M-------g-------gg----g-#-----------####-----------------###-------------------
XXXXXXXX--XXXXXXXXXXXXXXXXXXXXXXXXXXXXXXXXXXXXXXXXXXXX--XXXXXXXXXXXXXXXXXXXXXXXXXXXXXXXXXXXXXXXXXXXXXXXXX--XXXXXXXXXXX--XXXXXXXXXXXXXXXXXXXXXXXXXXX---
XXXXXXXX--XXXXXXXXXXXXXXXXXXXXXXXXXXXXXXXXXXXXXXXXXXXX--XXXXXXXXXXXXXXXXXXXXXXXXXXXXXXXXXXXXXXXXXXXXXXXXX--XXXXXXXXXXX--XXXXXXXXXXXXXXXXXXXXXXXXXXX---
