--------------------------------------------------------------------------------------------------------------------------------------------------
--------------------------------------------------------------------------------------------------------------------------------------------------
--------------------------------------------------------------------------------------------------------------------------------------------------
--------------------------------------------------------------------------------------------------------------------------------------------------
--------------------------------------------------------------------------------------------------------------------------------------------------
--------------------------------------------------------------------------------------------------------------------------------------------------
--------------------------------------------------------------------@-----------------------------------S!!S--------------------------------------
-------------------------------------------------------@------------------------------------------------------------------------------------------
--------------------------------------------------------------------------------------------------------------------------------------------------
---------------------------S!!S----------------------------------------------------------------------S----------------!---------------------------
----------!--------!-----------------------------!---------------!--!--------##-!--------------S!!S---XXXXXXX---------------#-----##------C-------
--------------------------------tt-------##--#------!--!--------------------###-----------------------XXXXXXX---------------##---###--------------
--------------------------------tt------###--##----------------------------####--------------------------------tt-----------###-####--------------
-M-tt--------######----------k--tt-g-----###------------------#----###------g--------#-------------------------tt------tt---#########------g-M----
XXXXXXXXXXXXXXXXXXXXXXXXXXXXXXXXXXXXXXXXXXXXXXXXXXXXXXXXXXXXXXXXXXXXXXXXXXXXXXXXXXXXXXXXXXXXXXXXXXXXXXXXXXXXXXXXXXXXXXXXXXXXXXXXXXXXXXXXXXXXXXXXXX
XXXXXXXXXXXXXXXXXXXXXXXXXXXXXXXXXXXXXXXXXXXXXXXXXXXXXXXXXXXXXXXXXXXXXXXXXXXXXXXXXXXXXXXXXXXXXXXXXXXXXXXXXXXXXXXXXXXXXXXXXXXXXXXXXXXXXXXXXXXXXXXXXX
