------------------------------------------------------------------------------------------------------------------------
------------------------------------------------------------------------------------------------------------------------
-------------------------------------------------1----------------------------------------------------------------------
------------------------------------------------------------------------------------------------------------------------
------------------------------------------------------------------------------------------------------------------------
----------------------------------------------#####--------------------------------------@------------------------------
---------------------------------------------######-------!-----------------------SU------------------------------------
----------------------------1---------------#######---------------------------------------------------------------------
------------------------g-------------------#######------------------tt---F---------------------------!-----------------
---------SSS------------------------SSS------------k-g------C--------tt---#-----------!--!------------------------------
----------------------S@S---------------------XXXXXXXXX-------------XXXXXXXXXX------------------------------------------
----------------------------------------------XXX-------------------------XXXX------------------------------------------
----------------------------------------------gg-------------g---------------------gg-tt-------------k###----------#----
-M------------k-M-----------gg-----ttXXXXXXXXXXXXXXXXXXXXXXXXX--XXXXXXXXXXXXXXXXXXXXXXXXXXXXXXXXXXXXXXXXXXXXXXXXXXXXXXXX
XXX--XXXXXXXXXXXXXXXXXXXXXXXXXXXXXXXXXXXXXXXXXXXXXXXXXXXXXXXXX--XXXXXXXXXXXXXXXXXXXXXXXXXXXXXXXXXXXXXXXXXXXXXXXXXXXXXXXX
XXX--XXXXXXXXXXXXXXXXXXXXXXXXXXXXXXXXXX---------------------------------------------------------------------------------
