-----------------------------------------------------------------------------------------------------------------------------------
-----------------------------------------------------------------------------------------------------------------------------------
-----------------------------------------------------------------------------------------------------------------------------------
------------------------------------------------------------------------------------------@----------------------------------------
-----------------------------------------------------------------------------------------------------------------------------------
-------------------------------@---------------------------------------------------------------------------------------------------
------------------------------------------------------------------------------S-------------------------------------@--------------
---------------------------------------------------------------------------------------!--!----------------------------------------
-----------------------------------------------------------------------------------------------------------------------------------
-------------------------#--!--!-----##----------------------------------#####--------------------tt---------SSS--------------SSS!-
---------!---------------#----------###--------S@S!S--------------------######-------##---SS------tt-------------!--!--------------
-------------------##--#-#---------####--------------------------------#######------###-----------tt-------------------------------
------------------###--###-----------####-------------------tt---------#######-----####---------g-tt-------------------------------
-M--M---------tt-------------k------#####---g---g-------g---tt-----g----------k-----g---g-g------tt-----g-----------------k----tt--
XXXXXXXXXXXXXXXXXXXXXXXXXXXXXXXXXXXXXXXXXXXXXXXXXXXXXXXXXXXXXXXXXXXXXXXXXXXXXXXXXXXXXXXXXXXXXXXXXXXXXXXXXXXXXXXXXXXXXXXXXXXXXXXXXXX
XXXXXXXXXXXXXXXXXXXXXXXXXXXXXXXXXXXXXXXXXXXXXXXXXXXXXXXXXXXXXXXXXXXXXXXXXXXXXXXXXXXXXXXXXXXXXXXXXXXXXXXXXXXXXXXXXXXXXXXXXXXXXXXXXXX
