---------------------------------------------------------------------------------------------------------------------------------------------
---------------------------------------g-----------------------------------------------------------------------------------------------------
-------------------------------------SSS-----------------------------------------------------------------------------------------------------
---------------------------------------------------------------------------------------------------------------------------------------------
------------------------------------g--------------------------------------------------------------------------------------------------------
------------------------------------------------------------------tt-------------------------------------------------------------------------
----------------------------------S@S-----------------------------tt-------------------------------------------------------------------------
------------------------------------------------------------------tt------------------------------SU-----------------------------------------
-----SS--S!!S---------------------#####-------------------------g-tt------------------SSS!---------------------------------------------------
----------------SSS---------SSS!-######-----------------------#####--------------------------------------------------------------------------
--------------------------------#######----------------------######-------------------------#-------------------!-----------------!----------
--------------------------------#######-----tt--------------#######--------------##---------##-----------------------------------------------
----------###-------------------------------tt--------------#######-------tt----###--######-###------------------------------------------tt--
-M-------########---------tt----------------tt-g----------#########-------tt--###-----#####-###-gg---------------------------------------tt--
XXXXXXXXXXXXXXXXXXXXXXXXXXXXXXXXXXXXXXXXXXXXXXXXXXXX--XXXXXXXXXXXXXXXXXXXXXXXXXXXXXXXXXXXXXXXXXXXXXXXXXXXXXXXXXXXXXXXXXXXXXXXXXXXXXXXXXXXXXXX
XXXXXXXXXXXXXXXXXXXXXXXXXXXXXXXXXXXXXXXXXXXXXXXXXXXX--XXXXXXXXXXXXXXXXXXXXXXXXXXXXXXXXXXXXXXXXXXXXXXXXXXXXXXXXXXXXXXXXXXXXXXXXXXXXXXXXXXXXXXX
