-------------------------------------------------------------------------------------------------------------------------------------------
-------------------------------------------------------------------------------------------------------------------------------------------
-------------------------------------------------------------------------------------------------------------------------------------------
-------------------------------------------------------------------g-----------------------------------------------------------------------
-----------------------------------------------------------------SSS-----------------------------------------------------------------------
-------------------------------------------------------------------------------------------------------------------------------------------
----------------------------------------------------------------g--------------------------------------------------------------------------
-------------------------------------------------------------------------------------------------------------------------------------------
------------------------------SSS-----------------------------S@S--------------------------------------------------------------------------
-----------SSS----------------------##----------SSS!---------------------------------------1--------!---------------SSS--------------------
-----------------------------------###-------------------S@S!S---SS------------------SS!-------------------------------------------C-------
------S@--------------------------####-----------------------------------------------------------------------------------------------------
--------------------------------------------------------------------------tt---------------------------------------------------------------
-M------kg-g-------k---g-#--------------------tt----------g----g-g---gg---tt---------k--------------###---------------tt------------g-M----
XXXXXXXXXXXXXXXXXXXXXXXXXXXXXXXXXXXXXXXXXXXXXXXXXXXXXXXXXXXXXXXXXXXXXXXXXXXXXXXXXXXXXXXXXXXXXXXXX---XXXXXXXX--XXXXXXXXXXXXXXXXXXXXXXXXXXXXX
XXXXXXXXXXXXXXXXXXXXXXXXXXXXXXXXXXXXXXXXXXXXXXXXXXXXXXXXXXXXXXXXXXXXXXXXXXXXXXXXXXXXXXXXXXXXXXXXX---XXXXXXXX--XXXXXXXXXXXXXXXXXXXXXXXXXXXXX
