-------------------------------------------------------------------------------------------------------------------------------------------
-------------------------------------------------------------------------------------------------------------------------------------------
-------------------------------------------------------------------------------------------------------------------------------------------
------------------------------------------------------------g------------------------------------------------------------------------------
----------------------------------------------------------SSS------------------------------------------------------------------------------
----------------------------------------------------g--------------------------------------------------------------------------------------
--------------------------------------------------SSS----g--------@-----------------------------g------------------------------------------
----------------------------------------------------------------------------------------------SSS------------------------------------------
----------!--------------------------------------g-----S@S------------tt----------------------------------------SSS!-----------------------
------------------------------------------S!!-------------------------tt----#####------------g---------SU-----------------------------S!!S-
----#-----------------------##--#--------------S@S----------C--!--!---tt---######-!--------------------------------------------------------
----##---------------------###--##------------------------------------tt--#######----------S@S---------------------------------------------
----###-------###----------------------------------------------------####-#######-------------------------------------------tt-------------
-M--####------####----tt-----------######----tt--------------g-----k#####-----g----------------------g-----------------gg---tt-------------
XXXXXXXXXXXX--XXXXXXXXXXXXXXXXXX---XXXXXXXXXXXXXXXXXXXXXXXXXXXXXXXXXXXXXXXXXXXXXXXXXXXXXXXXXXXXXXXXXXXXXXXXXX---XXXXXXXXXXXXXXXXXXXXXXXXXX-
XXXXXXXXXXXX--XXXXXXXXXXXXXXXXXX---XXXXXXXXXXXXXXXXXXXXXXXXXXXXXXXXXXXXXXXXXXXXXXXXXXXXXXXXXXXXXXXXXXXXXXXXXX---XXXXXXXXXXXXXXXXXXXXXXXXXX-
