---------------------------------------------------------------------------------------------------------------------
---------------------------------------------------------------------------------------------------------------------
----------------SSS--------------------------------------------------------------------------------------------------
------------------------------g--------------------------------------------------------------------------------------
----------------------------SSS--------------------------------------------------------------------------------------
---------------------------------------------------------------------------------------------------------------------
------------#####----------g----------------------@---SSS----------------------------------------!-------------------
-------##--######----------------------------------------------------------------------------------------------------
------###-#######--------S@S---------------------------------------------------#-------------------------------------
-----####-#######--####-------------------------------------SS!S--------------##-------------------------------------
----S@S!-S--------######------C--tt------tt----!--!--S@S!--------------------###---------SS-------S--S!!S------------
-----------------#######---------tt------tt---------------------------------####-------------------------------------
-----------------#######-------XXXXXX----tt------------------###---tt------------------------------------------------
-M---g----------gg------k------XXXXXX------k###-------g------####--tt-----g-------#----g-g------g-g--------------tt--
XXXXXXXXXXXXXXXXXXXXXXXXXXXXXXXXXXXXXXXXXXXXXXXXXXXXXXXXXXX--XXXXXXXXXXXXXXXXXXXXXXXXXXXXXXXXXXXXXXXXXXXXXXXXXXXXXXXX
XXXXXXXXXXXXXXXXXXXXXXXXXXXXXXXXXXXXXXXXXXXXXXXXXXXXXXXXXXX--XXXXXXXXXXXXXXXXXXXXXXXXXXXXXXXXXXXXXXXXXXXXXXXXXXXXXXXX
