------------------------------------------------------------------------------------------------------------------------------------------------
------------------------------------------------------------------------------------------------------------------------------------------------
------------------------------------------------------------------------------------------------------------------------------------------------
-----------------------------------------------------------------------@------------------------------------------------------------------------
------------------------------------------------------------------------------------------------------------------------------------------------
----------------------------------------------------------------------------------------------------------------@------------------g------------
---------------------@-----------------------------------------------------------------------------------------------------------SSS------------
--------------------------------------------------------------------!--!-------------------------------------------------------------------SU---
--------------------------------------------------------------#####-------------------------------------------------------------g---------------
--------------------------SU---------------------------------######-------------------------------------tt---!--!-------------------------------
----S@S!----SU-------!------------------SU------------------#######----------------SU-------------SS----tt--------------------S@S-------S@S!S---
-----------------tt-----------------------------------------#######-------------------------------------tt--------------------------------------
-----------------tt--------------------------------tt-------------------------------------------------------------------------------------------
-M---g-----------tt-g-k------#--------tt------gg---tt-g----------------gg-------tt------------------------------------------g------------g------
XXXXXXXXXXXXXXXXXXXXXXXXXXXXXXXXXXXXXXXXXXXXXXXXXXXXXXXXXX--XXXXXXXXXXXXXX--XXXXXXXXXXXXXXXXXXXXXXXXXXXXXXXXXXXXXXXXXX---XXXXXXXXXXX---XXXXXXX--
XXXXXXXXXXXXXXXXXXXXXXXXXXXXXXXXXXXXXXXXXXXXXXXXXXXXXXXXXX--XXXXXXXXXXXXXX--XXXXXXXXXXXXXXXXXXXXXXXXXXXXXXXXXXXXXXXXXX---XXXXXXXXXXX---XXXXXXX--
