----------------------------------S!!S-SSSSS---SSS!----------------------------------------------
-------------------------------------------------------------------------------------------------
-------------------------------------------------------------------------------------------------
---------------------------------------------------------###---------######------------#---------
-----------------------------------------------###-------####--------XXXXXXXXXXXXXXXXX##---------
-----------------------------------------------XXXXXXXX--XXXX--------XXXXXXXXXXXXXXXXX##---------
-----------------------------------------------XXXXXXXX--XXXX-----------------------####---------
------------------tt--!-----------------------------------------------------------#####----------
------------------tt------------------------------------------!----##------------######----------
------------------tt------------------SU--------------------------###-----------#######----------
---------------S@S!S---------SS----------------------------------####-----------#######----------
----------------------XXXXX-----------------------------------------------###---tt-----------F---
----------------------XXXXX------------###----g-#-----gg---tt-------------####--tt-g---------#---
-M-#-----M------g----######g-g-----g---####XXXXXXXXXXXXXXXXXXXXXXXXXXXXX--XXXXXXXXXXXXXXXXXXXXXXX
XXXXXXXXXXXXXXXXXXXXXXXXXXXXXXXXXXXXX--XXXXXXXXXXXXXXXXXXXXXXXXXXXXXXXXX--XXXXXXXXXXXXXXXXXXXXXXX
XXXXXXXXXXXXXXXXXXXXXXXXXXXXXXXXXXXXX--XXXX------------------------------------------------------
