-----------------------------------------------------------------------------------------------------------------------------------------------
-----------------------------------------------------------------------------------------------------------------------------------------------
-----------------------------------------------------------------------------------------------------------------------------------------------
---------------------g------------------------------------------------g------------------------------------------------------------------------
-------------------SSS----------------------------------------------SSS------------------------------------------------------------------------
-------------------------------------@---------------------------------------------------------------------------------------------------------
------------------g------------------------------------------------g-------------------------------SSS----------!------------------------------
-----------------------------------------------------------------------------------------------------------SS----------------------------------
----------------S@S----------------------------------------------S@S---------------------------------------------------------------------------
-----------!----------------SS!S--!--!--------------------------------------------------------------------g--------------------------------tt--
---------------------C--#-------------------!-----------------#####---#--------------S-----------S@S!S-----------SS-----tt------S!!S-------tt--
------------------------#------------------------------------######---##--------------------------------S@S-------------tt-----------------tt--
------------------------###-------------###-----------------#######---###-----------------------------------------------tt---------------g-tt--
-M-#--------tt--------g-###-------------####-----#-----gg---#######---###------M-----------M------g----###-----g-g----g-tt------------------k--
XXXXXXXXXXXXXXXXXXXXXXXXXXXXXXXXXXXXXX--XXXXXXXXXXXXXXXXXXXXXXXXXXXXXXXXXXXXXXXXXXXXXXXXXXXXXXXXXXXXXXXXXXXXXXXXXXXXXXXXXXXXXXXXXXXXXXXXXXXXX--
XXXXXXXXXXXXXXXXXXXXXXXXXXXXXXXXXXXXXX--XXXXXXXXXXXXXXXXXXXXXXXXXXXXXXXXXXXXXXXXXXXXXXXXXXXXXXXXXXXXXXXXXXXXXXXXXXXXXXXXXXXXXXXXXXXXXXXXXXXXX--
