----------------------------------------------------------------------------------------------------------------SS!S--------------tt-----------
--------------------------------------------------------1-----------##------------SS---------------------SSS!-----------#--!------tt-----------
-------------------------------------------------tt----------------###-------tt-----------------------------------------##--------tt-----------
-------------------------------------------------tt----------###--####-------tt-----------------------------------------###-----g-tt-------F---
-------------------------------------------------tt----------####tt----------tt-------------------M---------------------###-----###--------#---
-----------------------------------------------g-tt---XXXXX--XXXXXXXXXXXXXXXXXXXXXXXXXXXXXXXXX---XXXXXXXXXXXXXXXXXXX---XXXXXXXXXXXXXXXXXXXXXXXX
-------SSS!------------------S!!S------------#####----XXXXX--XXXXXXXXXXXXXXXXXXXXXXXXXXXXXXXXX---XXXXXXXXXXXXXXXXXXX---XXXXXXXXXXXXXXXXXXXXXXXX
--------------------------------------------######---------------------------------------------------------------------------------------------
---!---------------------------------------#######---------------------------------------------------------------------------------------------
-------------------------------------------#######---------------------------------------------------------------------------------------------
---------------------------S@S!S------------------C--------------------------------------------------------------------------------------------
-----------------------------------------------------------------------------------------------------------------------------------------------
----####----------tt-----------------------------------F---------------------------------------------------------------------------------------
-M-#####-gg--gg---tt--------g-----------M----------g---#---------------------------------------------------------------------------------------
XXXXXXXXXXXXXXXXXXXX--XXXXXXXXXXX--XXXXXXXXXXXXXXXXXXXXXXXX------------------------------------------------------------------------------------
XXXXXXXXXXXXXXXXXXXX--XXXXXXXXXXX--XXXXXXXXXXXXXXXXXXXXXXXX------------------------------------------------------------------------------------
