--------------------------------------------------------------------------------------------------------------------------------------------------
--------------------------------------------------------------------------------------------------------------------------------------------------
--------------------------------------------------------------------------------------------------------------------------------------------------
--------------------------------------------------------------------------------------------------------------------------------------------------
-------------------------------------------------------##--#--------------------------------------------------------------------------------------
------------------------------------------------------###--##-------------------------------------------------------------------------------------
-----!-------------------g-------------@-------------#####----------------------------------------------------------------------------------------
-----------------------SSS--------------------------######----------------------1-----------------------------------------------------------------
---------------------------------------------------#######----------------------------------------------------------------------------------------
-------------SSS!-----g----------------------------#######----------------tt------------!---------------------------------------------------------
--------C------------------------SS-!--!--------!-----S----------##--#----tt----------------------S------------------------------------------S----
--------------------S@S-------#---------------------------------###--##---tt-----------------------------tt---------------------tt----------------
-----------------------------##-----------------------------------###---g-tt-----------------------------tt---------------------tt----------------
-M-------g------------g-----###--g-------k######------------------####tt---------gg----------------------tt-g--------tt---------tt-g###-----------
XXXXXXXXXXXXXXXXXXXXXXXXXX-####-XXXXXXXXXXXXXXXXXXXXXXXXXXXXXXXX--XXXXXXXXXXXXXXXXXXXXXXXX---XXXXXXXXXXXXXXXXXXXXXXXXXXXXXXXXXXXXXXXXXXXXXXXXXXXXX
XXXXXXXXXXXXXXXXXXXXXXXXXXXXXXXXXXXXXXXXXXXXXXXXXXXXXXXXXXXXXXXX--XXXXXXXXXXXXXXXXXXXXXXXX---XXXXXXXXXXXXXXXXXXXXXXXXXXXXXXXXXXXXXXXXXXXXXXXXXXXXX
