-------------------------------------------------------------------------------------------------------------------------------------
-------------------------------------------------------------------------------------------------------------------------------------
-----------------------------------------------------------------------------------------------------------------------g-------------
---------------------------------------------------------------------------------------------------------------------SSSSSSSS--------
-------------------------------------------------------------------------------------------------------------------------------------
------------------------------------------------------------------------------S!!S----------------------------------g----------------
-----------SSS-----------------------------------------------------------------------------------------------------------------------
------------------------------------------------------------------------------------------------------------------S@S----------------
--------------------------------------------------------------------------------------------SSS!-------------------------------------
------------------------------------------------------#####-------------------g--------#-----------S!!S--------#####-----------------
--------SS!S---------------------------SS------------######----------------ttXXXXX----##----------------------######-----------------
-----------------------tt--------tt-----------------#######----------------ttXXXXX---###---------------------#######-----------------
-----------------------tt--------tt-------------tt--#######-----###--------tt-------####-----------------tt--#######-------------F---
-M-tt---------gg-------tt-g------tt-gg-g---gg---tt######-----k--####-M----###-----tt---------------------tt------###------g------#---
XXXXXXXXXXXXXXXXXXXXXXXXXXXXXXXXXXXXXXXXXXXXXXXXXXXXXXXXXXXXXX--XXXXXXXXXXXXXXXXXXXXXXXXXXXXXXXXXXXXXXXXXXXXXXXXXXXXXXXXXXXXXXXXXXXXX
XXXXXXXXXXXXXXXXXXXXXXXXXXXXXXXXXXXXXXXXXXXXXXXXXXXXXXXXXXXXXX--XXXXXXXXXXXXXXXXXXXXXXXXXXXXXXXXXXXXXXXXXXXXXXXXXXXXXXXXXXXXXXXXXXXXX
