-----------------------SU--------------------------------------#####-----------------SSS-----------------------------!--!----
----------------------------------S!!S-----------C------------######--------#----S-------------------------------------------
-------------------------------------------------------------#######--------##--------------!--!--------tt---##--#-----------
------------SS!S--S@S!S--------------------------------------#######--------###-------------------------tt--###--##----------
----------------------------------------g---------g--------tt---------------###g-g--tt------------------tt-g-----k-----------
-----------------------XXXXXX---XXXXXXXXXXXXXXXXXXXXXXXXXXXXXXXXXXXXX--XXXXXXXXXXXXXXXXXXXXXXXXXXXXXXXXXXXXXXXXXXXXXXXXXXXXXX
-------#####-------g---XXXXXX---XXXXXXXXXXXXXXXXXXXXXXXXXXXXXXXXXXXXX--XXXXXXXXXXXXXXXXXXXXXXXXXXXXXXXXXXXXXXXXXXXXXXXXXXXXXX
------######-----XXXXXXX-----------------------------------------------------------------------------------------------------
-----#######-----XXXXXXX-----------------------------------------------------------------------------------------------------
-----#######-----------------------------------------------------------------------------------------------------------------
----S---------SU----!--!-----------------------------------------------------------------------------------------------------
-----------------------------------------------------------------------------------------------------------------------------
-----------------------------------------------------------------------------------------------------------------------------
-M---------------------------------------------------------------------------------------------------------------------------
XXXXXXXXXXXXX---XXXXX--------------------------------------------------------------------------------------------------------
XXXXXXXXXXXXXXXXXXXXXXXXXX---------------------------------------------------------------------------------------------------
