--------------------------------------------------------------------------------------------------------------------
----------------------------------------------------------------------------------------------g---------------------
--------------------------------------------------------------------------------------------SSSSSSSS---SSS!---------
--------------------------------------------------------------------------------------------------------------!--!--
SSS----------------------------------------------------------------------------------------g------------------------
--------------------------------------------------------------------------------------------------------------------
--------------------g--------------------@-----------------------------------------------S@S-----------------------k
------------------SSS------------------------------------------------------------------------------------XXXXXXXXXXX
####-----------------------------------------------------------------##--#------------#####--------------XXXXXXXXXXX
####-------------g--------------------------------------------------###--##----------######-------------------------
####------S@S---------S@S!----SU------!--!-----------S@S!S-------S-S@S!S------------#######------##-----------------
####-----------S@S------------------S-----------------------------------------------#######-----###-----------------
-----###---------------------------------------------------------------------------------------####------------F----
-M---####--g-----g-----g-----------------##-----------g----#--------g-------------------------#########--------#----
XXX--XXXXXXXXXXXXXXXXXXXXXXXXXXXXXXXXXXXXXXXXXXXXXXXXXXXXXXXXXXXXXXXXXXXXXX--XXXXXXXXXXXXXX---XXXXXXXXXXXXXXXXXXXXX-
XXX--XXXXXXXXXXXXXXXXXXXXXXXXXXXXXXXXXXXXXXXXXXXXXXXXXXXXXXXXXXXXXXXXXXXXXX--XXXXXXXXXXXXXX---XXXXXXXXXXXXXXXXXXXXX-
