----------------------------------------------------------------------------------------------------------------------
----------------------------------------------------------------------------------------------------------------------
----------------------------------------------------------------------------------------------------------------------
----------------------------------------------------------------------------------------------------------------------
----------------------------------------------------------------------------------------------------------------------
----------------------------------------------------------------------------------------------------------------------
---------------------------------------------------------------#------------------!-------------------------------tt--
---------------------------S----tt----------------------------##--------------------------------------------------tt--
--------------------------------tt-----SS---##--------------------------------------------------------------------tt--
--------------------------g-----tt---------###---SS!----SU--#---------------------------------------S!!S--------g-tt--
------------1-------------------SS------------------------------------------!------SS--#------------------------------
------------------------S@S------------------------------------------------------------##-----------------------------
--------------------------------------------------###-----------##--#------------------###-------------------####-----
-M------------k-g------------kg-g------------gg---####-----g---###--##-----------g-g---###----------###-----#####-gg--
XXX--XXXXXXXXXXXXXXXXXXXXXXXXXXXXXXXXXXXXXXXXXXX--XXXXXXXXXXXXXXXXXXXXXXXXXXXXXXXXXXXXXXXXXXXXXXXXXXXXXXXXXXXXXXXXXXX-
XXX--XXXXXXXXXXXXXXXXXXXXXXXXXXXXXXXXXXXXXXXXXXX--XXXXXXXXXXXXXXXXXXXXXXXXXXXXXXXXXXXXXXXXXXXXXXXXXXXXXXXXXXXXXXXXXXX-
