------------------------------------------------------------------------------------------------------------------------------------------------
------------------------------------------------------------------------------------------------------------------------------------------------
------------------------------------------------------------------------------------------------------------------------------------------------
------------------------------------------------------------------------------------------------------------------------------------------------
------------------------------------------------------------------------------------------------------------------------------------------------
------------------------------------------------------------------------------------------------------------------------------------------------
--------------------------------------------------------------------------------------------@---------------------------------------------------
--------------------------------------------------------------------------tt-------------------------------@------------------------------------
--------------------------------------------------------------------------tt--------------------------------------------------------------------
------------------S!!S-----------------------------------------S!!S-------tt-----------------------------------------SSS!----S!!S---------------
---!--------------------------------SS!S-------##-------------------------SS----SS!S-----!--!---------------------------------------------------
----------------------------------------------###-------------------------------------------------------!--!----------------------#-------##--#-
---------------------------------------------####---------------------------------------------------------------------------------##-----###--##
-----------tt------------tt---M---------k---g-###------M--------tt---gg-g-g--###----------tt---------M----------------tt-------k-###---------k--
XXXXXXXXXXXXXXXXXXXXXXXXXXXXXXXXXXXXXXXXXXXXXXXXXXXXXXXXXXXXXXXXXXXXXXXXXXXXXXXXXXXXXXXXXXXXXXXXXXXXXXXXXXXXXXXXXXXXXXXXXXXXXXXXXXXXXXXXXXXXXX--
XXXXXXXXXXXXXXXXXXXXXXXXXXXXXXXXXXXXXXXXXXXXXXXXXXXXXXXXXXXXXXXXXXXXXXXXXXXXXXXXXXXXXXXXXXXXXXXXXXXXXXXXXXXXXXXXXXXXXXXXXXXXXXXXXXXXXXXXXXXXXX--
