-----------------------------------------------------------------------------------------------------------------------------
-----------------------------------------------------------------------------------------------------------------------------
-----------------------------------------------------------------------------------------------------------------------------
-------------g-------------------------------------------------------------g-------------------------------------------------
-----------SS------------------------------------------------------------SSS-------------------------------------------------
-----------------@-----------------------------------------------------------------------------------------------------------
----------g-------------------------------------------------------------g----------------------------------------------------
----------------------------------------------------------------!------------------------------------------------------------
--------S@S-----------------------------------------------------------S@S----------------------------------------------------
--------------!--!---------------------------S!!S---------------------------SSS!-----------------------------tt----##--------
-----------------------#---S---------SU-----------S------S@S!S--------SS------------SS!----SU----##----------tt---###--------
-----------------------##-----------------------------------------------------------------------###----------tt--####--------
-----------------------###---------------------------------------------------------------------####--------------####------tt
-M-------gg------------###-------M---------k--------------g---------g-g------tt--###----------######------g------g----gg---tt
XXXXXXXXXXXXXXXXXXXXXXXXXXXXXXXXXXXXXXXXXXXXXXXXXXXXXXXXXXXXXXXXXXXXXXXXXXXXXXXXXXXXXXXXXXXXXXXXXXXXXXXXXXXXXXXXXXXXXXXXXXXXX
XXXXXXXXXXXXXXXXXXXXXXXXXXXXXXXXXXXXXXXXXXXXXXXXXXXXXXXXXXXXXXXXXXXXXXXXXXXXXXXXXXXXXXXXXXXXXXXXXXXXXXXXXXXXXXXXXXXXXXXXXXXXX
