-------------------------------------------------------------------------------------------------------------------------------------
-------------------------------------------------------------------------------------------------------------------------------------
-------------------------------------------------------------------------------------------------------------------------------------
------------------------------------------------------SS!S---------------------------------------------------------------------------
-------------------------------------------------------------------------------------------------------------------------------------
-------------------------------------------------------------------------------------------------------------------------------------
-------------------------------------------------#####----------g--------------------------------------------------------------------
------------------------------------------------######--------SSS---!----------------------------------------------------------------
---!-----------S!!S----------------------------#######-----------------------------------S!!S---------------S------------------------
---------------------------------tt------------#######-------g------------S!!S-------------------------S!!S-----------#-------!------
-------##--#---------------------tt--------##--#------C---------------------------C----------------------------------##--------------
------###--##--------------------tt-------###--##----------S@S------------------------------------------------------###--------------
-----------###-------------------------####------------------------------------------------------------------------####------###-----
-M---------####------#-----M----------#####------------gtt-------------------------g-------------------------------###-------####----
XXXXXXXXX--XXXXXXXXXXXXXXXXXXXXXXXXXXXXXXXXXXXXXXXXXXXXXXXXXXXXXXXXXXXXXXXXXXXXXXXXXXXXXXXXXXXXXXXXXXXXXXXXXXXXX---XXXXXXXX--XXXXXXXX
XXXXXXXXX--XXXXXXXXXXXXXXXXXXXXXXXXXXXXXXXXXXXXXXXXXXXXXXXXXXXXXXXXXXXXXXXXXXXXXXXXXXXXXXXXXXXXXXXXXXXXXXXXXXXXX---XXXXXXXX--XXXXXXXX
