----------------------------------------------------------------------------------------------------------------------------------------
----------------------------------------------------------------------------------------------------------------------------------------
----------------------------------------------------------------------------------------------------------------------------------------
----------------------------------------------------------------------------------------------------------------------------------------
----------------------------------------------------------------------------------------------------------------------------------------
----------------------------------------------------------------------------------------------------------------------------------------
----------------------------------------------------g-----------------------------------------------------------------------------------
--------------------------------------------------SSS-----------------------SU----------------------------------------------------------
----------------------------------------!-----------------------------------------------------------------------------------------------
---------------!-----SSS!------------------------g----------S!!S-------------------------------SSS-------S!!----------------------------
------------------------------SS!S----------------------------------------SS----------SU--S@-------------------------------##--#--------
-----------------------------------------------S@S-------------------------------------------------------------##--#------###--##-------
--------------------------------------------#-----------------------------------------------------------------###--##-------####--------
-M-----------g-----tt-------------k------g--####-g---tt-----------------g-g--------g-g-----g----###----------tt------------#####----tt--
XXXXXXXXXXXXXXXXXXXXXXXXXXXXXXXXXXXXXXXXXX--XXXXXXXXXXXXXXXXXXXXXXXXXXXXXXXXXXXXXXXXXXXXXXXXXXXXXXXXXXXXXXXXXXXXXXXXXXXXXXXXXXXXXXXXXXXX
XXXXXXXXXXXXXXXXXXXXXXXXXXXXXXXXXXXXXXXXXX--XXXXXXXXXXXXXXXXXXXXXXXXXXXXXXXXXXXXXXXXXXXXXXXXXXXXXXXXXXXXXXXXXXXXXXXXXXXXXXXXXXXXXXXXXXXX
