--------------------------------------------------------SS!S--------#######---------------------------SS--
----------------------------------------1---------------------------#######-----##--#---------------------
---------------------------------tt--------------------------------tt----------###--##--------------------
---------------------------------tt-----------------###--##--------tt---------tt-----------------gg-g-g---
---------------------------------tt---S------------SSXXXXXXX-#--XXXXXXXXXX-S@S!S-XXXXXXXX-------S----XXXX-
-------------------------------g-tt----------tt------XXXXXXX-##-XXXXXXXXXX-------XXXXXXXX------------XXXX-
---------g-------------------#####-----------tt---------###--###---------------------------tt---------####
-------SSS------------------######-----------tt-gg-g----####-###tt----------g--------tt----tt--------#####
---------------------------#######---XXXXXXXXXXXXXXXXX--XXXXXXXXXXXXXXXXXXXXXXXXXXXXXXXXXXXXXXXXXXXXXXXXXX
------g----------------SSS-#######---XXXXXXXXXXXXXXXXX--XXXXXXXXXXXXXXXXXXXXXXXXXXXXXXXXXXXXXXXXXXXXXXXXXX
----------------------------------C-----------------------------------------------------------------------
----S@S----------##---------------------------------------------------------------------------------------
----------------###--------------------F------------------------------------------------------------------
-M-----tt------######----tt--------g---#------------------------------------------------------------------
XXXXXXXXXXXXXXXXXXXXXXXXXXXXXXXXXXXXXXXXXXX---------------------------------------------------------------
XXXXXXXXXXXXXXXXXXXXXXXXXXXXXXXXXXXXXXXXXXX---------------------------------------------------------------
