---------------------------------------------------------------------------------------------------------
--------------------------------------------------------------------#####-------------g------------------
-------------------------------------------------------------------####-------------SSS------------------
------------------------------------------------------------------#####----------------------------------
----------------------------------------@----------------------S!!###--------------g----------SU---------
---------------------------------------------------------------------------------------------------------
----------------------------------------------#----------------------------------S@S---------------------
-------------------------------SU------------##------------------------------------------tt---####-------
-------------------------------------!--!---SS--------#----SS------C---------------g-----tt--#####-------
------------SSS!---------------------------------tt---##------------------------XXXXXXXXXXXXXXXXXXXXXXXXX
------------------------!-S@S!-------------------tt---###----------------------------XXXXXXXXXXXXXXXXXXXX
-----------------------------------------kg-g----tt-g-###g-g--------g---g--M-----------------------------
------------------------------XXXXXXXXXXXXXXXXXXXXXXXXXXXXXXXXXXXXXXXXXXXXXXXXXXXXXXX--------------------
-M--M----------------------g--XXXXXXXXXXXXXXXXXXXXXXXXXXXXXXXXXXXXXXXXXXXXXXXXXXXXXXX--------------------
XXXXXXXXXXXXXXXXXXXXXXXXXXXXXXXX-------------------------------------------------------------------------
XXXXXXXXXXXXXXXXXXXXXXXXXXXXXXXXX------------------------------------------------------------------------
