----------------------------------------------------------------------------------------------------------------------------------------------------------
----------------------------------------------------------------------------------------------------------------------------------------------------------
----------------------------------------------------------------------------------------------------------------------------------------------------------
------------------------------------------------------------------------------------g---------------------------------------------------------------------
----------------------------------------------------------------------------------SSS---------------------------------------------------------------------
-----------------------------------------------------------------------------------------------------------------------g----------------------------------
--------------------------------------g------------------------------------------g-----------------------------------SSS----------------------------------
------------------------------------SSS-------------------------------------------------------------------------------------------------------------------
------------S-----------------------------------!------------------------------S@S----------------------------------g-------------------------------------
-----------------------------------g----------------------------------##----------------S!!S----------------------------------------SU--------------------
-------------------------------------------------------------!-------###------------C------------S@S!S--#---S@S!--S@S-------#---------------#--!----------
-------------------------tt------S@S--------------------------------####--------------------------------##-----------------##---------------##------------
------##--#--------------tt--------------------###--###------------###----------------------------------###---------------###-#--#----------###-----------
-M---###--##-----######--tt-g------------------###--####-----------###---------------gtt----------g-----###--g-----------####-#--#----------###-----######
XXXXXXXXXXXXXXXXXXXXXXXXXXXXXXXXXXXXXXXX--XXXXXXXX--XXXXXXXXXXXXXXXXXXXXXXXX---XXXXXXXXXXXXXXXXXXXXXXXXXXXXXXXXXXXXXXXXX---XXXXXXXXXXXXX---XXXXXXXXXXXXXXX
XXXXXXXXXXXXXXXXXXXXXXXXXXXXXXXXXXXXXXXX--XXXXXXXX--XXXXXXXXXXXXXXXXXXXXXXXX---XXXXXXXXXXXXXXXXXXXXXXXXXXXXXXXXXXXXXXXXX---XXXXXXXXXXXXX---XXXXXXXXXXXXXXX
