-------------------------------------------------------------------------------------------------------------------------------------------
-------------------------------------------------------------------------------------------------------------------------------------------
-------------------------------------------------------------------------------------------------------------------------------------------
-----------------------------!--!------------------------------------------------------g---------------------------------------------------
-------------------------------------------------------------------------------------SSS---------------------------------------------------
-------------------------------------------------------------------------------------------------------------------------------------------
-----------------------------###----------------------------------------------------g---------------------SU-------------------------------
----------------------------####------------------------------------------------------------------------------------------g----------------
---------------------------#####--------------------------------------------------S@S-----------------------------------SSS----------------
---------------------------#####-----------------------------------------------------------------------#####-------------------------------
--------SU----------------S-----------##--#------#---S---------------------------------C--S@S!S---1---######-----------g---------SS------C-
-------------------------------------###--##-----##--------------------------------------------------#######-------------------------------
-------------------------------------------------###-------------t---##--#---------------------------#######---------S@S-------------------
-M-##tt----------------------------tt------------###------#------t--###--##-------------g--g-----g--------------k--------------g-g--------g
XXXXXXXXXXXXXXX--XXXXXXXXXXXXXXXXXXXXXXXXXXXX---XXXXXXXXXXXXXXXXXXXXXXXXXXXXXXXXXXXXXXXXXXXXXXXXXXXXX--XXXXXXXXXXXXXXXXXXXXXXXXXXXXXXXXXXXX
XXXXXXXXXXXXXXX--XXXXXXXXXXXXXXXXXXXXXXXXXXXX---XXXXXXXXXXXXXXXXXXXXXXXXXXXXXXXXXXXXXXXXXXXXXXXXXXXXX--XXXXXXXXXXXXXXXXXXXXXXXXXXXXXXXXXXXX
