----------------------------------------------------------------------------------------------------------------------------------------------------
----------------------------------------------------------------------------------------------------------------------------------------------------
----------------------------------------------------------------------------------------------------------------------------------------------------
----------------------------------------------------------------------------------------------------------------------------@-----------------------
----------------------------------------------------------------------------------------------------------------------------------------------------
--------------@-------------------------------------------------------------------------------------------------------------------------------------
--------------------------------------------------------------------------!-------------------------------------------------------------------------
-------------------------------------------------------------------------------------------------------------------------!--!------------------1----
----------------------------------------------------------------------------------------------------------------------------------------------------
-----S!!S--!--!---------SSS-------------------------------------------------------------------------------S!!S--------------------------------------
-------------------------------------------------SSS-----------------------SS--S-------------S------------------------------SS--------tt-------SS---
--------------------------------------------------------------tt-----1---------------------------------------------tt-----------------tt------------
-------------------------------------------###----------------tt--------------------------tt-----------------------tt-----------------tt------------
-M----------k----------tt--------#--------####---------#------tt-g---------g---------gg---tt---------g-------------tt-----g-g--------###-----g-g----
XXXXXXXXXXXXXXXXXXXXXXXXXXXXXXXXXXXXXXXXXXXXXXXXXXXXXXXXXXXXXXXXXXXXXXXXXXXXXXXXXXXXXXXXXXXXXXXXXXXXXXXXXXXXXXXXXXXXXXXXXXXXXXX--XXXXXXXXXXXXXXXXX--
XXXXXXXXXXXXXXXXXXXXXXXXXXXXXXXXXXXXXXXXXXXXXXXXXXXXXXXXXXXXXXXXXXXXXXXXXXXXXXXXXXXXXXXXXXXXXXXXXXXXXXXXXXXXXXXXXXXXXXXXXXXXXXX--XXXXXXXXXXXXXXXXX--
