--------------------------------------------------------------------------------------------------------------------------------------------
--------------------------------------------------------------------------------------------------------------------------------------------
--------------------------------------------------------------------------------------------------------------------------------------------
--------------------------------------------------------------------------------------------------------------------------------------------
--------------------------------------------------------------------------------------------------------------------------------------------
--------------------------------------------------------------------------------------------------------------------------------------------
------------------------------------------------------------------------------------------------------------------------------------@-------
------------------------------------------------------------------------------------------------------------------tt------------------------
-----------------##--#-----------------------------------------##------------------------------S!!S---------------tt----------#-------------
----------------###--##---------------------------------------###-------------------------------------------------tt---------##-------------
---------SU---S!S-----S@S!S------------C---##---------------------C----SU----------------C-----------!------------SS--------###--!--!-------
------------------------------------------###------------------------------------------------------------------------------####-------------
-----------------------------------------####-------tt-----##--#----------------------------------------------------------------------------
-M-----tt----g----gg---g----------------g------gg---tt----###--##--gtt--------######------g-gg-------------M----g-g--------------#######----
XXXXXXXXXXXXXXXXXXXXXXXXXXXX--XXXXXXXXXXXXXXXXXXXXXXXXXXXXXXXXXXXXXXXXXXXXXXXXXXXXXXXXXXXXXXXXXXXXXXXXXXXXXXXXXXXXXXX--XXXXXXXXXXXXXXXXXXXXX
XXXXXXXXXXXXXXXXXXXXXXXXXXXX--XXXXXXXXXXXXXXXXXXXXXXXXXXXXXXXXXXXXXXXXXXXXXXXXXXXXXXXXXXXXXXXXXXXXXXXXXXXXXXXXXXXXXXX--XXXXXXXXXXXXXXXXXXXXX
