----------------------------------------------------------------------------------------------------------------------------------------
----------------------------------------------------------------------------------------------------------------------------------------
----------------------------------------------------------------------------------------------------------------------------------------
----------------------------------------------------------------------------------------------------------------------------------------
----------------------------------------------------------------------------------------------------------------------------------------
---------------------------------------------------------------------SSSSS---SSS!-------------------------------------------------------
----------------------------------------------------------------------------------------------------------------------------------------
----------------------------------------------g---------------------------------------------------SU------------------------------------
--------------------------------------------SSS-----------------------------------------------------------------------------------------
-------------------------SSS-----------------------------------------------#####------------------------------1-------------------------
---------------------!---------------------g-----------#----SS----tt------######------!---------S-------gg--------------##--#----SS-----
-------------------------------------------------------##---------tt-----#######-----------------------XXXX------------###--##----------
-----------tt----------------------------S@S------tt---###--------tt-----#######----##-----------------XXXX------###--####--------------
-M-######--tt---------------------g---------------tt---###g-g--tt--------###-----#####---------------######------#########-g---g-g---gg-
XXXXXXXXXXXXXXXXXXXXXXXXXXXXXXXXXXXXXXXXXXXXXXXXXXXXXXXXXXXXXXXXXXXXXXXXXXXXXXXXXXXXXXXXXXXXXXXXXXXXXXXXXXXXXXX--XXXXXXXXXXXXXXXXXXXXXXX
XXXXXXXXXXXXXXXXXXXXXXXXXXXXXXXXXXXXXXXXXXXXXXXXXXXXXXXXXXXXXXXXXXXXXXXXXXXXXXXXXXXXXXXXXXXXXXXXXXXXXXXXXXXXXXX--XXXXXXXXXXXXXXXXXXXXXXX
