------------------------------------------------------------------------------------------------------------------------------------------
------------------------------------------------------------------------------------------------------------------------------------------
------------------------------------------------------------------------------------------------------------------------------------------
------------------------------------------------g-------------!------------------------------------------------------------------@--------
----------------------------------------------SSS-----------------------------------------------------------------------------------------
------------------------------------------------------------------------------------------------------------------------------------------
---------------------------------------------g---------#####-----------------------------------------------------@------------------------
------------------------------------------------------######------------------------------------------------------------------!--!--------
------SSS----------------------------------S@S-------#######------------------------------------------------------------------------------
--------------------------U--------------------------#######------------------------------------------------------------------------------
-------------!-----------------------------S@S!S-----tt-----C------#--------S-----#--!-----SU-----------------!--!-------S@S!S------------
-------------------------------------SU--------------tt-----------##---tt---------##----------------------tt------------------------------
--------------------##--#--------------------------g-tt----------###---tt---------###---------------------tt------------------------------
-M-----------------###--##------------------g----######------g--####---tt-g-------###-----###-------------tt-gtt----------g-------gg------
XXXXXXXXXXXXXXXXXXXXXXXXXXXXXXX---XXXXXXXXXXXXXXXXXXXXXXXXXXXXXXXXXXXXXXXXXXXXXXXXXXXXXXXXXXXXXXXX--XXXXXXXXXXXXXXXXXXXXXXXXXXXXXXXXXXXXXX
XXXXXXXXXXXXXXXXXXXXXXXXXXXXXXX---XXXXXXXXXXXXXXXXXXXXXXXXXXXXXXXXXXXXXXXXXXXXXXXXXXXXXXXXXXXXXXXX--XXXXXXXXXXXXXXXXXXXXXXXXXXXXXXXXXXXXXX
