-------------------------------------------------------------------------------------------------------------------------------------
-------------------------------------------------------------------------------------------------------------------------------------
-------------------------------------------------------------------------------------------------------------------------------------
-------------------------------------------------------------------------------------------------------------------------------------
-S!!S--------------------------------------------------------------------------------------------------------------------------------
-------------------------------@-----------------------------------------------------------------------------------------------------
-----------------------------------------------------------g-------------------------------------------------------------------S-----
---------------------------------------------------------SSS-------------------------------------------------------------------------
####---------------------------------------------------------------------------------------------------------------------------------
####------------------------!--!-------S!!S-------------g-----------------------------------------------------------------#####------
####---------------SSS--------------------------!-----------------------SU--------1------tt--------------SSS!----!-------######------
####--------------------------------------------------S@S--------------------------------tt----##--#--------------------#######------
-----###---------------------###---------------------------------------------------------tt---###--##-------------------#######------
-M---####-M------------------####---------k--------------tt-----g-----tt----------tt-------k###------g----------------tt--------#----
XXX--XXXXXXXXXXXXXXXXXXXXXX--XXXXXXXXXXXXXXXXXXXXXXXXXXXXXXXXXXXXXXXXXXXXXXXXXXXXXXXXXXXXXXXXXXXXXXXXXXXXXXXXXXXXXXXXXXXXXXXXXXXXXXXX
XXX--XXXXXXXXXXXXXXXXXXXXXX--XXXXXXXXXXXXXXXXXXXXXXXXXXXXXXXXXXXXXXXXXXXXXXXXXXXXXXXXXXXXXXXXXXXXXXXXXXXXXXXXXXXXXXXXXXXXXXXXXXXXXXXX
