-----------------------------------------------------------------------------------------------------------------------------------------------
-----------------------------------------------------------------------------------------------------------------------------------------------
-----------------------------------------------------------------------------------------------------------------------------------------------
-----------------------------------------------------------------------------------------------------------------------------------------------
-----------------------------------------------------------------------------------------------------------------------------------------------
----------------------------------------------------------------------------------------g------------------------------------------------------
--------------------------------------------------------------------------------------SSS-------------------------------------@----------------
-----------------------------------------------------------------------------------------------------------------------------------------------
---------------------------------------------SSS------!------------------------------g---------------------------------------------------------
----------SSS------------1---------------------------------------------SS!S-----------------------------tt-------------------------------------
-----------------------------------------------------------------------------------S@S----!-------------tt----#------SS!S--!----##-------------
----------------------------------------------------------------tt--------------------------------------tt----##---------------###---tt--------
----------------------------------------tt----------------###---tt---####----------tt-####----------###-------###-------------####---tt--------
-M-------######-----g-g------------gg---tt-g--------------####--tt-g#####-----gg---tt#####----------###-------###-g------tt--######--tt-g------
XXX--XXXXXXXXXXXXXXXXXXXXXXXXXX---XXXXXXXXXXXXXXXXXXX-----XXXXXXXXXXXXXXXXXXXXXXXXXXXXXXXXXXXXXXXXXXXXXXXXXXXXXXXXXXXXXXXXXXXXXXXXXXXXXXX--XXXX
XXX--XXXXXXXXXXXXXXXXXXXXXXXXXX---XXXXXXXXXXXXXXXXXXX-----XXXXXXXXXXXXXXXXXXXXXXXXXXXXXXXXXXXXXXXXXXXXXXXXXXXXXXXXXXXXXXXXXXXXXXXXXXXXXXX--XXXX
