-------------------------------------------------------------------------------------------------------------------------------------------
-------------------------------------------------------------------------------------------------------------------------------------------
-------------------------------------------------------------------------------------------------------------------------------------------
-------------------------------------------------------------------------------------------------------------------------------------------
-------------------------------------------------------------------------------------------------------------------------------------------
-------------------------------------------------------------------------------------------------------------------------------------------
--------------------------------------------------------------------------------------1-------------------#####----------------------------
---tt--!-----------------------------------------------------------------------------------------##--#---######----------------------------
---tt-------------------------------------------------------------------------------------------###--##-#######----------------------------
---tt------------------------SSS--------#------------------------------SSS---------#####----#####-------#######----------------------------
---------------------------------------##-----------------------------------------######---######--------------C---------------------------
-------XXXXX##--#---------------------###-----------------tt---------------------#######--#######---------------------##--#----------------
-------XXXXX##--##-------------------####-----------------tt---------------------#######--#######--------------------###--##---------------
-M--gg-tt--------#------------g-------------k---g---------tt-g----------------M---------k---------tt------------gtt--------------------g---
XXXXXXXXXXXXXXXXXXXXXXXXXXXXXXXXXXXXXXXXXXXXXXXXXX--XXXXXXXXXXXXXXXXXXXXXXXXXXXXXXXXXXXXXXXXXXXXXXXXXXXXXXXXXXXXXXXXXXXXXXXXXXXXXXXXXXXXXXX
XXXXXXXXXXXXXXXXXXXXXXXXXXXXXXXXXXXXXXXXXXXXXXXXXX--XXXXXXXXXXXXXXXXXXXXXXXXXXXXXXXXXXXXXXXXXXXXXXXXXXXXXXXXXXXXXXXXXXXXXXXXXXXXXXXXXXXXXXX
