--------------------------------------------------------------------------------!--!------S!!S---------------------
-------------------------------------------------------------------------------------------------------------------
-------------------------------------------------------------------------------------------------------------------
--------------------------------------------------------------------------------k-g--------------------------------
-----##--#-----------------------------------------------------------------XXXXXXXXXXX-----------k-#---------------
----###--##--------------------g-------------------------#-----------------XXXXXXXXXXXXXX---XXXXXX##---------------
---#####---------------------SSS------------------------##-------------------------XXXXXX---XXXXXX##---------------
--######---------------------------------------tt------###-----------------!--------------------####---------------
-#######--------------------g------------------tt-----####------------------------------------#####----------------
-#######---------------------------------------tt---#####------------------------------------######----------------
--------C-----------------S@S-------#------------C-######-----------S@S!S--------------#----#######------#---------
-----------------------------------##-------------#######------------------------------##---#######------##--------
----------------tt----------------###---####------#######--------tt--------------------###------tt--###--###---F---
-M-------g-gg---tttt-------------####--#####------g----tt---gg---tt--g----######-M-----###-gg---tt--####-###---#---
XXXXXXXXXXXXXXXXXXXXXXXXXXXXXXXXXXXXXXXXXXXXXXXXXXXXXXXXXXXXXXXXXXXXXXXXXXXXXXXXXXXXXXXXXXXXXXXXXX--XXXXXXXXXXXXXXX
XXXXXXXXXXXXXXXXXXXXXXXXXXXXXXXXXXXXXXXXXXXXXXXXXXXXXXXXXXXXXXXXXXXXXXXXXXXXXXXXXXXXXXXXXXXXXXXXXX--XXXXXXXXXXXXXXX
