----------------------------------------------------------------------------------------------------------------------------------------------------
----------------------------------------------------------------------------------------------------------------------------------------------------
----------------------------------------------------------------------------------------------------------------------------------------------------
--------------------g-------------------------------------------------------------------------------------------------------------------------------
------------------SSS-------------------------------------------------------------------------------------------------------------------------------
----------------------------------------------------@-----------------------------------------------------------------------------------------------
-----------------g--------------------------------------------------SS------------------------------------------------------------------------------
----------------------------------------------------------------------------------------------------------------------------------------------------
--S!!S---------S@S-------------------------------------------------------------------------------------------------------------SSS------------------
-------------------------------------------SU----!--!-----------------------------------------------------------------------------------------------
-------------S-------------------------------------------#---------S@S---##--#-------!---------------------------------SU-------------------------C-
--------------------------tt----------!-----------------##--------------###--##-----------------##--------------------------------------------------
--------------------------tt----------------------###--###-------------------------------------###--------------tt-----------------------tt---------
-M------------------------tt-g#-------------------###-####-----gg---g----------######-----#-----g----------gg---tt----###----------------tt--------g
XXXXXXXXX---XXXXXX--XXXXXXXXXXXXXXXXXXXXXXXXXXXX--XXXXXXXXXXXXXXXXXXXXXXXXXXXXXXXXXXXXXXXXXXXXXXXXXX--XXXXXXXXXXXXXXXXXXXXXXXXXXXXXX---XXXXXXXXXXXXX
XXXXXXXXX---XXXXXX--XXXXXXXXXXXXXXXXXXXXXXXXXXXX--XXXXXXXXXXXXXXXXXXXXXXXXXXXXXXXXXXXXXXXXXXXXXXXXXX--XXXXXXXXXXXXXXXXXXXXXXXXXXXXXX---XXXXXXXXXXXXX
