----------------------------------------------------------------------------------------------------------------------------------------------------------
----------------------------------------------------------------------------------------------------------------------------------------------------------
----------------------------------------------------------------------------------------------------------------------------------------------------------
----------------------------------------------------------------------------------------------------------------------------------------------------------
----------------------------------------------------------------------------------------------------------------------------------------------------------
---------------------------------------g------------------------------------------------------------------------------------------------------------------
-------------------------------------SSS------------------------------------------------------------------------------------------------------------------
---------------------------------------------------------------------------------------------------------------SU-----------------------------------------
------------------------------------g---------------------------------------------------------------------------------------------------------------------
--------------------------------------------------------------------------tt-----------------------tt---------------------SU------------------------------
----------------------------------S@S------SSS---------------SS!S---------tt------SSS--------------tt------------C--------------------------------#----SS-
--------SU--------tt------------------------------------------------------tt-----------------------tt---------------------------------------------##------
------------------tt-------------###-###--------------------------------g-tt----------------------------------------------------------------------###-----
-M----------------tt-g#----------#######----------M--------tt--######---g---------------######---g----------------g---g---------------------------###g-g--
XXXXXXXXXX--XXXXXXXXXXXXXXXXXXXXXXXXXXXXXXXXXXXXXXXXXXXXXXXXXXXXXXXXXXXXXXXXXXXXXXXXXXXXXXXXXXXXXXXXXXXXX---XXXXXXXXXXXXXXXXXX---XXXXX--XXXXXXXXXXXXXXXXXX
XXXXXXXXXX--XXXXXXXXXXXXXXXXXXXXXXXXXXXXXXXXXXXXXXXXXXXXXXXXXXXXXXXXXXXXXXXXXXXXXXXXXXXXXXXXXXXXXXXXXXXXX---XXXXXXXXXXXXXXXXXX---XXXXX--XXXXXXXXXXXXXXXXXX
