--------------------------------------------------------------------------------------------------------------------------------------
--------------------------------------------------------------------------------------------------------------------------------------
--------------------------------------------------------------------------------------------------------------------------------------
------------------------------------------------------------g------------------------g------------------------------------------------
----------------------------------------------------------SSS----------------------SSS------------------------------------------------
--------------------------------------------------------------------------------------------------------------------------------------
---------------------------------------------------------g------------------------g-----------------1---------------S!!S--------------
---------------------------------------------------SS---------------------------------------------------------------------------------
-------------------------------------------------------S@S-----------------------@S---------------------------------------------------
--------------------------------------------------g----------SSS----##-------tt--------------!---#####--------------------------------
-----------------------!-------------------------------------------###-------tt--S--------------######---------------S----------------
-------------------------------##--#------------S@S---------------####-------tt----------------#######-------------------##-------tt--
--------------tt--------------###--##-------------------------------####---g-tt----------------#######---------tt-------###-------tt--
-M-------gg---tttt--------######----------g-----tt---gg-g-g-------k#####----tt---------g---######-----k-M------tt--g-g-####-------tt-g
XXXXXXXXXXXXXXXXXXXXXXXXXXXXXXXXXXXXXXXXXXXXXXXXXXXXXXXXXXXXXXXXXXXXXXXXXXXXXXXXXXXXXXXXXXXXXXXXXXXXXXXXXXXXXXXXXXXXXXXXXXXXXXXXXXXXXX
XXXXXXXXXXXXXXXXXXXXXXXXXXXXXXXXXXXXXXXXXXXXXXXXXXXXXXXXXXXXXXXXXXXXXXXXXXXXXXXXXXXXXXXXXXXXXXXXXXXXXXXXXXXXXXXXXXXXXXXXXXXXXXXXXXXXXX
