----------------------------------------------------------------------------------------------------------------@---------
-----------------------------------------------@--------------------------------------------------------------------------
--------------------------------------------------------------------------------------------------------------------------
--------------------------------------------------------------------------------------------------------------------------
-------------------------------------------------------------------------------------------------------------!--!---------
------@-------------------------------------!--!--------------------------------------------------------------------------
--------------------------------------------------------------------------------------------------------------------------
-------------------##-----------------------------------------------------------------------------------tt---S@S!S--------
------------------###------------------#####------tt--------------------------------------S!!S-SSSSS----tt----------------
---!--!----------####-----------------######-XXXXXXXXXXXXXXX----------------------1---------------------tt------------F---
-------------!-----------------------#######-XXXXXXXXXXXXXXX------------------------------------------S-------g-------#---
----------------------------##--#----#######---------------##-----------------------------------------------XXXXXXXXXXXXXX
---------###---------------###--##-------------------------###------------------------####------------------XXXXXXXXXXXXXX
-M-------####------gg------------------g-------------------###----------------g------#####g-g--######---------------------
XXXXXXX--XXXXXXXXXXXXXXXXXXXXXXXXXXXXXXXXXXXXXXXXXX---XXXXXXXXXXXXXXXXXXXXXXXXXXXXXXXXXXXXXXXXXXXXXXXXXXXXXXXXXXXX--------
XXXXXXX--XXXXXXXXXXXXXXXXXXXXXXXXXXXXXXXXXXXXXXXXXX---XXXXXXXXXXXXXXXXXXXXXXXXXXXXXXXXXXXXXXXXXXXXXXXXXXXXXXXXXXXX--------
