----------------------------------------------------------------------------------------------
----------------------------------------------------------------------------------------------
----------------------------------------------------###---------#####----S!!S-SSSSS---SSS!----
----------------------------------------------g-----####-------######-------------------------
---------------------------------------------XXXXX--XXXX------#######-------------------------
---------------------------------------------XXXXX--XXXX------#######-------------------------
-----------------------------------g---------------------------S!----------k--------#####-----
---------------------------------SSS-----------------------------XXXXXXXXXXX-------######-----
-----------------------------------------------------------------XXXXXXXXXXXXXXX---######-----
------------SU------------------g-----------------------------------------XXXXXX---######-----
----------------------------------------------SU---!-----------------S@S!S--------------------
------------------------------S@S-------------------------------------------------------------
---------tt---------------------------------------------------tt-----------------tt-------F---
-M--gg---tt------#-----M--------###---tt--g-------k------gg---tt-gg---g-----gg---tt-gg----#---
XXXXXXXXXXXXXXXXXXXXXXXXXXXXXXXXXXXX--tt--XXXXXXXXXXXXXXXXXXXXXXXXXXXXXXXXXXXXXXXXXXXXXXXXXXXX
XXXXXXXXXXXXXXXXXXXXXXXXXXXXXXXXXXXXXXXXXXXXXXXXXXXXXXXXXXXXXXXXXXXXXXXXXXXXXXXXXXXXXXXXXXXXXX
