------------------------------------------------------------------------------------------------------------------------------------------
------------------------------------------------------------------------------------------------------------------------------------------
------------------------------------------------------------------------------------------------------------------------------------------
------------------------------------------------------------------------------------------------------------tt----------------------------
-----------------------------------------------------------g------------------------------------------------tt----------------------------
---------------------------------------------------------SSS------------------------------------------------tt----------------------------
-----------------------------------------------------------------------------SSS-------------------------#####----------------------------
--------------------------------------------------------g-----------------------------------------------######----------------------------
-------------------------------------------------------------------------------------------------------#######----------------------------
------SSS---------------------------------------------S@S-----------SU------------------#--------------#######----------------------------
------------------------------S!!S--##--#----------S-----------#-----------------------##-----------S!!S-S---SS------C--------------------
-----------------------------------###--#---------------------##----------------------###-------------------------------------------------
---------------------tt--------------####--------------------####--------------------####-------------------------------------------------
-M--g--###------gg---tt-------------#####-----M------------------------------------------------------------g-g--------g------M------------
XXXXXXXXXXXXXXXXXXXXXXXXXXXXXX--XXXXXXXXXXXXXXXXXXXXXXXXX---XXXXXXXXXXXXXXXXXXXXXXXXXXXXXXXXXXXXXXXXXXXXXXXXXXXXXXXXXXXXXXXXXXXXXXXXXXXXXX
XXXXXXXXXXXXXXXXXXXXXXXXXXXXXX--XXXXXXXXXXXXXXXXXXXXXXXXX---XXXXXXXXXXXXXXXXXXXXXXXXXXXXXXXXXXXXXXXXXXXXXXXXXXXXXXXXXXXXXXXXXXXXXXXXXXXXXX
