--------------------------------------------------------------------------------------------------------------------------------------
--------------------------------------------------------------------------------------------------------------------------------------
--------------------------------------------------------------------------------------------------------------------------------------
------------------------------##------------------------------------------------------------------------------------------------------
-----------------------------###------------------------------------------------------------------------------------------------------
----------------------------####------------------------------------------------------------------------------------------------------
--------tt-----------------#####--------------------------------@-------------------------------------@-------------------------------
--------tt----------------######-------------t-------------------------------------------------------------SU-------------------------
--------tt---------------#######-------------t--SSS!----------------------------------------------------------------------------------
------g-tt----SSS--------#######-------------t------------------------------------------##--------------------------------------------
----S@S!S-------------------S----------------S---------------!--!-------S!!S-----------###---------!--!------C-!-----------S----------
-----------------------------------##--#----------------tt----------------------------####--------------------------------------------
-------------------------tt-------###--##---------------tt----------tt-------------S@S------------------------------------------------
-M---g---------g----gg---tt------tt--------g-g----------tt-g-----k--tt----------------------------------------g------M-----------M----
XXXXXXXXXXXXXXXXXXXXXXXXXXXXXXXXXXXXXXXXXXXXXXXXXXXXXXXXXXXXXXXXXXXXXXXXXXXXXXXXXXXXXXXXXXXXXXXXXXXXXXXXXXXXXXXXXXXXXXXXXXXXXXXXXXXXXX
XXXXXXXXXXXXXXXXXXXXXXXXXXXXXXXXXXXXXXXXXXXXXXXXXXXXXXXXXXXXXXXXXXXXXXXXXXXXXXXXXXXXXXXXXXXXXXXXXXXXXXXXXXXXXXXXXXXXXXXXXXXXXXXXXXXXXX
