---------------------------------------------------------------------------------------------------------------------------------------------------
---------------------------------------------------------------------------------------------------------------------------------------------------
---------------------------------------------------------------------------------------------------------------------------------------------------
---------------------------------------------------------------------------------------------------------------------------------------------------
---------------------------------------------------------------------------------------------------------------------------------------------------
--------------------------------------------------------@--------------------------------------------------g---------------------------------------
------------------------------------------------------------------S!!------------------------------------SSS---!-----------------------------------
-------------------------------------------------------------------------------------------SU---!--------------------------------------------------
------------------------------------------------------------------------##--#---------------------------g----------------------#-------------------
-----------------------------------------------------!--!--------------###--##------------------------------------------------##----SU-------------
--SSS------------------------------------------------------#####-------S----------SU----S@S!S---------S@S----------!--------S@S!-------------------
-----------------------------------------------------------#####--------------------------------XXXXX----------------------------------------------
---------------------------------------------------####--#######--------------------------------XXXXX--------------------------------------------tt
-----------######-M--------------#----######------#####--#######-------------------------g----tt-----------------------------g--------------gg---tt
XXXXXXXXXXXXXXXXXXXXXXX--XXXXXXXXXXXXXXXXXXX--XXXXXXXXXXXXXXXXXXXXXXXXXXXXXXXXXXXXXXXXXXXXXXXXXXXXXXXXXXXXXXXXXXXXXXXXXXXXXXXXXXXXXXXXXX---XXXXXXXX
XXXXXXXXXXXXXXXXXXXXXXX--XXXXXXXXXXXXXXXXXXX--XXXXXXXXXXXXXXXXXXXXXXXXXXXXXXXXXXXXXXXXXXXXXXXXXXXXXXXXXXXXXXXXXXXXXXXXXXXXXXXXXXXXXXXXXX---XXXXXXXX
