---------------------------------------------------------------------------------------------------------------------------------------------
----------------------------------------------------------------------------------------g----------------------------------------------------
--------------------------------------------------------------------------------------SSS----------------------------------------------------
---------------------------------------------------------------------------------------------------------------------------------------------
-------------------------------------------------------------------------------------g-------------------------------------------------------
---------------------------------------------------------------------------------------------------------------------------------------------
-----------------------------------------------------------------------------------S@S---------------------------------------@---------------
-------------------------------------------------------------------------@-------------------------------------------------------------------
------##---------------------------------------------------------------------------#####-----------------------------------------------------
-----###----SSS----------------------------------!--------------------------------######-----------------------------------------------------
-#####----------------S----------------------------------------------------------#######------------------------#-----#---!--!---------------
######----------------------------------------------------!-----------!--!-------#######----------------##-----##-----##------------1--------
######----------------------------------------------------------------------------###------------------###----###-----###--------------------
######-----######-----------M----######-------------k-------------------------g---####----------M--------tt--####-----###----tt------------g-
XXXXXXXXXXXXXXXXXXXXXXXXXXXXXXXXXXXXXXXXXXXXXXXXXXXXXXXXXXXXX--XXXXXXXXXXXXXXXXX--XXXXXXXXXX---XXXXXXXXXXXXXXXXXXXXXXXXXXXXXXXXXXXXXXXXXXXXXX
XXXXXXXXXXXXXXXXXXXXXXXXXXXXXXXXXXXXXXXXXXXXXXXXXXXXXXXXXXXXX--XXXXXXXXXXXXXXXXX--XXXXXXXXXX---XXXXXXXXXXXXXXXXXXXXXXXXXXXXXXXXXXXXXXXXXXXXXX
