----------------------------------------------------------------------------------------------------------------------------------------------
----------------------------------------------------------------------------------------------------------------------------------------------
----------------------------------------------------------------------------------------------------------------------------------------------
----------------------------------------------------------------------------------------------------------------------------------------------
----------------------------------------------------------------------------------------------------------------------------------------------
----------------------------------------------------------------------------@-----------------------------------------------------------------
------------------------------------------------------------------------------------------------#####------------------------@----------------
--------------------------------------------------------------@---------------------------SS!S-######-----------------------------------------
------------------------------------------------------------------S!!S------------------------#######-----------------------------------------
---------#####----------------------S!!S-S-------SS---##-----------------!--!-----------------#######-----------------------------------------
--------######------------tt-------------------------###------------------------------S--------------C-----------1--------!--!----------------
-------#######-------t----tt----------------tt------####------!-------------------------------------------------------------------------------
-------#######-------t----tt----------------tt---------------------------------------------------------------------------------------tt---F---
-M--M----tt----------tt-g###---------tt-----tt-g------------------------------------------------------g######----tt--tt---------gg---tt---#---
XXXXXXXXXXXXXXXXXXXXXXXXXXXXXXXXXXXXXXXXX-XXXXXXXXXXXXXXXXXXXXXXXXXXXXXXXXXXXXXXXX---XXXXXXXXXXXXXXXXXXXXXXXXXXXXXXXXXXXXXXXXXXXXXXXXXXXXXXXXX
XXXXXXXXXXXXXXXXXXXXXXXXXXXXXXXXXXXXXXXXX-XXXXXXXXXXXXXXXXXXXXXXXXXXXXXXXXXXXXXXXX---XXXXXXXXXXXXXXXXXXXXXXXXXXXXXXXXXXXXXXXXXXXXXXXXXXXXXXXXX
