-----------------------------------------------------------------------------------------------------------------------------------------------------------
-----------------------------------------------------------------------------------------------------------------------------------------------------------
-----------------------------------------------------------------------------------------------------------------------------------------------------------
-----------------------------------------------------------------------------------------------------------------------------------------------------------
-----------------------------------------------------------------------------------------------------------------------------------------------------------
--------------------------------------------------g--------------------------------------------------------------------------------------------------------
------------------------------------------------SSS-----------------------------------------g--------------------------------------------------------------
--------------------------------------------------------------------------SU--------------SSS--------------------------------------------------------------
-----------------------------------------------g------------------S!!S-------------------------------------------------------------------------------------
------------------------------------------#-----------------SU---------------------------g-----------------------------------------------------------------
--------------------#--------------------##--S@S------------------------------------S-------------------tt--------------------S@S!S-------SS!S-------------
---------------tt---##---tt-----##--#---###--------------------------------------------S@S--------------tt-------------------------------------------------
---------------tt---###--tt----###--##---------------tt----------###------------------------------------tt---------------------------------------------tt--
-M--g------g---tt-g-###--tt-g###---------------------tt----------####---g--gg------------###---tt---g-g-tt----######-----------g----------------M------tt--
XXXXXXXXXXXXXXXXXXXXXXXXXXXXXXXXXXXXXXXXXXXXXXXX---XXXXXXXXXXXX--XXXXXXXXXXXXXXXXXXXXXXXXXXXX--tt--XXXXXXXXXXXXXXXXXXXXXXX---XXXXXXXXXXXXXXXXXXXXXXXXXXXXXX
XXXXXXXXXXXXXXXXXXXXXXXXXXXXXXXXXXXXXXXXXXXXXXXX---XXXXXXXXXXXX--XXXXXXXXXXXXXXXXXXXXXXXXXXXXXXXXXXXXXXXXXXXXXXXXXXXXXXXXX---XXXXXXXXXXXXXXXXXXXXXXXXXXXXXX
