--------------------------------------------------------------------------------------------------------------------------------------
--------------------------------------------------------------------------------------------------------------------------------------
--------------------------------------------------------------------------------------------------------------------------------------
-------------------------------------------------------------------------------------------------------------------------@------------
--------------------------------------------------------------------------------------------------------------------------------------
--------------------------------------------------------------------------------------------------------------g-----------------------
------------@--------------------------------------------------------------------g--------------------------SSS-----------------------
-------------------------@-----------------------------------------------------SSSSSSSS-------------------------------!--!------------
---------------------------------------------------------##--#---------------------------------------------g--------------------------
---SSS---------------------------------------------SSS--###--##---------------g---------tt------#####---------------------------------
---------!--!----------------1---------------------------XXXXXXXX--XXXX-----------------tt-----######----S@S---------------C----##----
----------------------!--!-------------tt----------------XXXXXXXX--XXXX-----S@S---------tt----#######--------------------------###----
---------------------------------------tt------------------------------tt-------------g-tt----#######----#--###---------------####----
-M--g---------------------------#------tt-g-M---------k-gg-tt----------tt------tt-------------###------###--####------------g-----k---
XXXXXXXXXXXXXXXXXXXXXXXXXXXXXXXXXXXXXXXXXXXXXXXXXXXXXXXXXXXXXXXXXXXXXXXXXXXXXXXXXXXXXXXXXXXXXXXXXXXXXXXXXX--XXXX--XXXXXXXXXXXXXXXXX---
XXXXXXXXXXXXXXXXXXXXXXXXXXXXXXXXXXXXXXXXXXXXXXXXXXXXXXXXXXXXXXXXXXXXXXXXXXXXXXXXXXXXXXXXXXXXXXXXXXXXXXXXXX--XXXX--XXXXXXXXXXXXXXXXX---
