---------------------------------------------------@-----------------------------SU----------------------------------------
---------------------------------------------------------SU----------g----1------------------------------------------------
-------------------------------------------------------------------SSS-----------------------------------------------------
----------------1-----SU-#---SSS----------------------------------------------#####---------------------------------SU-----
---------tt----------------------------S--------!--!-------C------g-------SS-######----------------------------------------
---------tt-----------------------------------------------------------------#######----------------------------------------
---------tt-----------####--------------------------------------S@S---------#######----tt---------------------tt-----------
-------g-tt----------#####-gg-###-----------#-----g---------g-----------g-g------tt----tt--------#-----M------tt-----------
-----#####-----XXXXXXXXXXXXXXXXXXXXXXXXXXXXXXXXXXXXXXXXXXXXXXXXXXXXXXXXXXXXXXXXXXXXXXXXXXXX--XXXXXXXXXXXXXXXXXXXXXXXXXXX---
----######-----XXXXXXXXXXXXXXXXXXXXXXXXXXXXXXXXXXXXXXXXXXXXXXXXXXXXXXXXXXXXXXXXXXXXXXXXXXXX--XXXXXXXXXXXXXXXXXXXXXXXXXXX---
---#######-----------------------------------------------------------------------------------------------------------------
---#######-----------------------------------------------------------------------------------------------------------------
--------####---F-----------------------------------------------------------------------------------------------------------
-M-----#####---#-----------------------------------------------------------------------------------------------------------
XXXXXXXXXXXXXXXXXXX--------------------------------------------------------------------------------------------------------
XXXXXXXXXXXXXXXXXXX--------------------------------------------------------------------------------------------------------
