---------
---------
---------
---------
---------
---------
---------
---------
---------
---------
---!--!--
---------
---------
---------
-XXXXXXXX
-XXXXXXXX
