-----------
-----------
-----------
-----------
-----------
-----------
-----------
-----------
-----------
-----------
-----------
-----------
-----------
------g-g--
-XXXXXXXXXX
-XXXXXXXXXX
