----------
----------
----------
----------
----------
----------
----------
----------
----------
----------
----------
---------t
---------t
---------t
-XXXXXXXXX
-XXXXXXXXX
