--------
--------
--------
--------
--------
--------
--------
--------
--------
--------
----SS--
--------
--------
g-g-g---
XXXXXXXX
XXXXXXXX
