-----------
-----------
-----------
-----------
-----------
-----------
-----------
-----------
-----------
----#####--
---######--
--#######--
-########--
-----------
-----------
-----------
