---------
---------
---------
---------
---------
---------
---------
---------
---------
---------
--#------
--##-----
--###----
--####---
--XXXXXXX
--XXXXXXX
