-----------
-----------
-----------
-----------
-----------
-----------
-----------
-----------
-----------
-----------
-----------
-----------
-----------
--g------tt
-XXXXXXXXXX
-XXXXXXXXXX
