--------
--------
--------
--------
--------
--------
--------
--------
--------
--------
-SU----!
--------
--------
-------k
-XXXXXXX
-XXXXXXX
