--------
--------
--------
--------
--------
--------
--------
--------
--------
--------
---SS!S-
--------
--------
--------
XXXXXXXX
XXXXXXXX
