----------
----------
----------
----------
----------
----------
----------
----------
----------
----------
----------
----------
-------F--
-------#--
-XXXXXXXXX
-XXXXXXXXX
