---------
---------
---------
---------
---------
---------
---##----
--###----
-####----
---------
---------
---------
---------
---------
---------
---------
