-----------
-----------
-----------
-----------
-----------
-----------
-----------
-----------
-----------
-----------
-----------
-----------
-----------
-########--
-XXXXXXXXXX
-XXXXXXXXXX
