-------------------------------------------------------------------------------------------------------------------------------------------
-------------------------------------------------------------------------------------------------------------------------------------------
-------------------------------------------------------------------------------------------------------------------------------------------
-------------------------------------------------------------------------------------------------------------------------------------------
-------------------------------------------------------------------------------------------------------------------------------------------
-------------------------------------------------------------------------------------------------------------------------------------------
-----------------------------------------------------g---------------------------------------S!!S----@-------------------------------------
---------------------------------------------------SSSSSSS---------------------------------------------------------------------------------
-------------------------------------------------------------------------------------------------------------------------------------------
--------------------------------------------------g------------#---------------------------------------------------------------------------
--------!-------tt------------------------#-------------------##----!---#-------------tt------SS--!--!--------------------tt---------------
----------------tt------------------------##----S@S----------###--------##------------tt----------------------------------tt---------------
----------------tt-----------------tt#----###------------#--####--------##------------tt-------------------#--------------tt------tt-----tt
-M-t----------g--------------------tt##---###---gg------####------------####----------tt----g-g---k--------##-----gg--###---####--tt-----tt
XXXXXXXXXXXXXXXXXXXXXXXXXXXXXXXXXXXXXXXXX-XXXXXXXXXXXXXXXXXXXXXXXXXXXXX-XXXXXXXXXXXXXXXXXXXXXXXXXXXXXXXXXXXXXXXXXXXXXXXXX--#####-XXXXXXXXXX
XXXXXXXXXXXXXXXXXXXXXXXXXXXXXXXXXXXXXXXXX-XXXXXXXXXXXXXXXXXXXXXXXXXXXXX-XXXXXXXXXXXXXXXXXXXXXXXXXXXXXXXXXXXXXXXXXXXXXXXXXXXXXXXX-XXXXXXXXXX
