-------------------------------------------------------------------------------------------------------------------------------------
-------------------------------------------------------------------------------------------------------------------------------------
-------------------------------------------------------------------------------------------------------------------------------------
-------------------------------------------------------------------------------------------------------------------------------------
-------------------------------------------------------------------------------------------------------------------------------------
-------------------------------------------------------------------------------------------------------------------------------------
------------------------------------tt--------#--------------------------------------------------------------------------------------
------------------------------------tt--------##-----------------------------------------------g-------------------------------------
------------------------------------tt---#----###--------------------------------------------SSSSSSSS--------------------------------
----------------------------------------------###-------------------------------1------------------------S---------!-----------------
--------------------------!-------S-----------XXX--SU-----------!---------------------------g---------------------------------tt-----
----------------------------------------------XXX-----------------------------------------------------------------------------tt-----
-----------tt-------#---------tt-----X---XXXX-----------------------tt---tt---------------S@S---------t--------------tt---#####t-----
-M---g-g---tt-------##--------tt-----X---XXXX-----g-g---g-g-t-------tt---tt---------------------------tt---t---------tt---#####------
XXXXXXXXXXXXXXXXXXXXXXXXXXXXXXXXXXXXXXXXXXXXXXXXXXXXXXXXXXXXXXXXXXXXXXXXXXXXXXXXXXXXX--XXXXXXXXXXXXXXXXXXXXXXXXXXXXXXXXXXXXXXXX------
XXXXXXXXXXXXXXXXXXXXXXXXXXXXXXXXXXXXXXXXXXXXXXXXXXXXXXXXXXXXXXXXXXXXXXXXXXXXXXXXXXXXX--XXXXXXXXXXXXXXXXXXXXXXXXXXXXXXXXXXXXXXXX------
