------------------------------------------------------------------------------------------------------------------------------------------------------
------------------------------------------------------------------------------------------------------------------------------------------------------
------------------------------------------------------------------------------------------------------------------------------------------------------
------------------------------------------------------------------------------------------------------------------------------------------------------
-------------------##---------------------------------------------------------------------------------------------------------------------------------
------------------###----------------------------------------------------------------------------------------------------##---------------------------
------------------###---------------------------------------------------------------------------------------------------###---------------------------
------------------###---------------------------------------------------------------------------------------#-----------###---------------------------
------------------###-----------------------------------1---------------------------1----------------------##-----------###---------------------------
-------tt---------###----------------------------tt----------------------SS!S-----------------------------###--!--------###----------!----------------
-------tt-----!----SS--------SU------------------tt------------------------------------------------------####-----------###---------------------------
-------tt-----------------------------------#----tt---------------tt--------------------------tt----tt------------------#####-------------------------
------tt-###--------------------------t-g-g-t--##-----------------tt--------g-----------------tt----tt---------------gg-#####-----------tt----------gg
-M----tt####-----g-g-------------##---tXXXXXXXXXXXXXX-XXXXXXX--XXXXXXXXXXXXXXXXXXXXXXXXXX--XXXXXXXXXXXXXXXXXXXXXXXXXXXXXXXXXXXXXXXXXXXXXXXXXXXXXXXXXXX
XXXXXXXXXXXXXXXXXXXXXXXX---XXXXXXXXXXXXXXXXXXXXXXXXXX-XXXXXXX--XXXXXXXXXXXXXXXXXXXXXXXXXX--XXXXXXXXXXXXXXXXXXXXXXXXXXXXXXXXXXXXXXXXXXXXXXXXXXXXXXXXXXX
XXXXXXXXXXXXXXXXXXXXXXXX---XXXXXXXXXXXXX--------------------------------------------------------------------------------------------------------------
