-----------------------------------------------------------------------------------------------------------------------------
-----------------------------------------------------------------------------------------------------------------------------
-----------------------------------------------------------------------------------------------------------------------------
-----------------------------------------------------------------------------------------------------------------------------
------------------------------------------------------------------------------------------------------#----------------------
----------------------@------------------------------------------------------------------------------##--#-------------------
----------------------------------------------------------------------------------------------------###-##---------!---------
---------------------------------------------------------------------------------------------------####-##-------------------
----------------------------------------------------------------------------------1---------------------##-------------------
-----------SS!S----!--!--------------------------------------------!-------#--#------------#--#--------S###------------------
-----SS--------------------SU---------------------------------------------##--##----------##--##--------###------------------
----------------------------------tt-------------------------------------###--##---------###--##-tt----------------------F---
------------tt-###-k--------------tt------tt------------tt-###-tt---########---------------t-----tt--g-g-----------gg----#---
-M-g-g------tt####-XXXX--------##-tt-g----tt------gg----tt-###-tt-g#########----XXXXXXX--XXXXXX-XXXXXXXXXXXXXXXXXXXXXXXXXXXXX
XXXXXXXXXXXXXXXXXXXXXXXXXXXXXXXXXXXXXXXXXXXXXXXXXXXXXXXXXX-XXXXXXXXXXXXXXXXXXXXXXXXXXXX--XXXXXX-XXXXXXXXXXXXXXXXXXXXXXXXXXXXX
XXXXXXXXXXXXXXXXXXXXXXXXXXXXXXXXXXXXXXXXXXXXXXXXXXXXXXXXXX-XXXXXXXXXXXXXXXXXXXXXXX-------------------------------------------
