-------------------------------------------------------------------------------------------------------------------------------------------
-------------------------------------------------------------------------------------------------------------------------------------------
-------------------------------------------------------------------------------------------------------------------------------------------
-------------------------------------------------------------------------------------------------------------------------------------------
-------------------------------------------------------------------------------------------------------------------------------------------
-------------------------------------------------------------------------------------------------------------------------------------------
--------------------------------------------------------------------------------------------##---------------------@-----------------------
------------------------------------------------------------------------------------g------###---------------------------------------------
----------------------------#-----------------------------------------------------SSSSSSSS-###---------------------------------------------
---------------------------##-----------------------------------!--------------------------###---------1-----------------------------------
-----#--#---#-------------###---#--#----SU--------!------tt-------------#--------g---------###------------------!--!-----------------------
----##--##-##-tt---------####--##--#---------------------tt------------##------------------###------##-------------------------------------
---###--#####-tt-----tt---##--###--#---------------------tt-----####--###------S@S----------###----###---------------------------------tt--
-M-g-------##-tt-g---tt-XXX---g-g---####------gg-----------gg--#####-------gg-----#---tt----#####t--------------k----g-g-t-------------tt--
XXXXXXXXXXXXXXXXXXXXXXX-XXX-XXXXXXXXXXXXXXXXXXXXXXXXXXXXXXXXXXXXXXXX-XXXXXXXXXXXXXXXXXXXXXXXXXXXXXXXXXXXXXXX--XXXXXXXXXXXXXXXXXXXXXXXXXXXXX
XXXXXXXXXXXXXXXXXXXXXXX-----XXXXXXXXXXXXXXXXXXXXXXXXXXXXXXXXXXXXXXXX-XXXXXXXXXXXXXXXXXXXXXXXXXXXXXXXXXXXXXXX--XXXXXXXXXXXXXXXXXXXXXXXXXXXXX
