-----------------------------------------------------------------------------------------------------------------------------------------------------------------------------------------------
-----------------------------------------------------------------------------------------------------------------------------------------------------------------------------------------------
-----------------------------------------------------------------------------------------------------------------------------------------------------------------------------------------------
-----------------------------------------------------------------------------------------------------------------------------------------------------------------------------------------------
-----------------------------------------------------------------------------------------------------------------------------------------------------------------------------------------------
---------------------------g-------------------------------------------------------------------------------------------------------------------------------------------------------------------
-------------------------SSSSSSSS--------------------------------@-----------------------------------------------------------------------------------------------------------------------------
-----------------------------------------------------------------------------------------------------------------------------------------------------------------------------------------------
------------------------g----------------------------------------------------------------------------------------------------------------------------------------------------------------------
------------1----------------------------------------------------------------------------------------------------------------------------------g-----------------------------------------g-----
----------------------S@S------------------------SS!S---------!--!------------t------SSS----S!!S---##------------##--------------SSS!--------SSSSSSSS-##--------------SSS!-------------SSSSSSSS
------------------------------------------------------------------------------t-------------------###-----------###----------------------------------###---------------------------------------
---------------------------------------tt-----------------tt-------tt---------t-------------------###----------####----------#--------------g--------###----------#-------------------g--------
-M---g-g--------------------------####-tt---g-g-t------gg-tt--k----tt-----------#####-------------###---------#####---------##-----------------------###---------##----------------------------
XXXXXXXXXXXXXXXXX--XXXXXXXXXXXXXXXXXXXXXXXXXXXXXXXXXXXXXXXXXXXXXXXXXXXXXXXXXXXX-#####-------g-g-t-###--------######--------###------C-----S@S--------###--------###------C-----S----S@S--------
XXXXXXXXXXXXXXXXX--XXXXXXXXXXXXXXXXXXXXXXXXXXXXXXXXXXXXXXXXXXXXXXXXXXXXXXXXXXXX-XXXXX----XXXXXXXX-###-------#######-------####-----------------------###-------####----------------SS----------
