----------------------------------------------------------------------------------------------------------------------------
----------------------------------------------------------------------------------------------------------------------------
----------------------------------------------------------------------------------------------------------------------------
----------------------------------------------------------------------------------------------------------------------------
----------------------------------------------------------------------------------------------------------------------------
---------------------------------------------------------------------------------------------#------------------------------
--------------------------------tt-----------------##------------------SU--------tt---------##------------------------------
--------------------------------tt----------------###----------------------------tt--------###----SSS!--------------g-------
--------------------------------tt---------------####----------------------------tt-------####--------------------SSSSSSSS--
-------------------1----------------------------#####-------------##-----------------gg--g-g--------------------------------
--------------!-----------------S@S!S----------######------#-----###!---S------XXXXXXXXXXXXXXX-------------------g----------
----------------------------------------------#######------##---####-----------XXXXXXXXXXXXXXX------------------------------
------tt#---------------------------------tt---------------###-###-----------------------------#####-----------S@S----------
-M----tt##-------------------#------gg----tt---------------#######-----t------gg--g-g-t------gg#####------------g-----------
XXXXXXXXXXXXXXXXXXXXXXXX--XXXXXXXXXXXX-XXXXXXXX-------XXXX-XXXXXXXXXXXXXXXXXXXXXXXXXXXXXXXXXXXXXXXXXXXXXXXXXXXXXXXXXXXXXXXXX
XXXXXXXXXXXXXXXXXXXXXXXX--XXXXXXXXXXXX-XXXXXXXXX---XXXXXXX-XXXXXXXXXXXXXXXXXXXXXXXXXXXXXXXXXXXXXXXXXXXXXXXXXXXXXXXXXXXXXXXXX
