--------------------------------------------------------------------------------------------------------------------------------------------
--------------------------------------------------------------------------------------------------------------------------------------------
--------------------------------------------------------------------------------------------------------------------------------------------
------------------------------------------------------------------------------------S@------------------------------------------------------
--------------------------------------------------------------------------------------------------------------------------------------------
-------------------------g------------------------------------------------------------------------------------------------------------------
------------@----------SSSSSS-------------------------------------------------------------tt------------------------------------------------
-------------------------------------------------------------------------------------S----tt----------#-------------------------------------
----------------------g---------------tt--------------------------------------------------tt---------##-------------------------------------
-------------------------------S!!----tt---------------------SSS--------1---------------------------###-------------------------------------
------SU----!-------S@S---------------tt-------------------------------------------SS-----S@S!S----####--------------------------!---S@S!S--
--------------------------------------------------------------------------------------------------#####----------##-------------------------
--------------------------------------------------tt-###---####--tt------------------------------######-tt------###-------------------------
-M-g-----k-----g-g---------------g----------------tt####--#####--tt--------------g-g-----------------gg-tt----------------------------------
XXXXXXXXXXXXXXXXXXXXXXXXXX---XXXXXXXXXXX---XXXXXXXXXXXXXXXXXXXX-XXXXXXXXXXXXX--XXXXXXXXXXXXXXXXXXXXXXXXXXXXXXXXXXXXXXXXXXXXXXXXXXXXX--------
XXXXXXXXXXXXXXXXXXXXXXXXXX---XXXXXXXXXXX---XXXXXXXXXXXXXXXXXXXX-XXXXXXXXXXXXX--XXXXXXXXXXXXXXXXXXXXXXXXXXXXXXXXXXXXXXXXXXXXXXXXXXXXX--------
