------------------------------------------------------------------------------------------------------------------------------------------
------------------------------------------------------------------------------------------------------------------------------------------
------------------------------------------------------------------------------------------------------------------------------------------
------------------------------------------------------------------------------------------------------------------------------------------
------------------------------------------------------------------------------------------------------------------------------------------
------------------------------------------------------------------------------------------------------------------------------------------
----------------------S!!S----------------------------------------------------------------------------------------------------------------
-----------------------------------##------tt----##---------------------------------------------------------------------------------------
----------------------------------###------tt---###-----------------------------------------------------------1-----------tt-----1--------
---------------------------------####------tt---###----------------------------------------------------SU-----------------tt--------------
-----------------------SS-------#####-----------###-----##--#--------------tt---------------------------------------------tt--------------
-------------------------------######-----XXXXXX###----###--##-------------tt---------------------------------------------C-###-----------
------------------------------#######-----XXXXXX###---------###-------#----tt------tt----------tt-tt----t----------------######-----------
-M--------------g-g-tg-g----------####g-g-----g-g----##-----####-----#####-tt------tt---####---tt-XXXXXXXXXXXXXXXXX--XXXXXXXXXXXXXXXXX--XX
XXXXXXXXXXXXXXXXXXXXXXXXXXXXXXXXXXXXXXXXXXXXXXXXXXXXXXXXXXX-XXXXXXXXXXXXXX-XXXXXX-XXXXXXXXXXXXXXX-XXXXXXXXXXXXXXXXX--XXXXXXXXXXXXXXXXX--XX
XXXXXXXXXXXXXXXXXXXXXXXXXXXXXXXXXXXXXXXXXXXXXXXXXXXXXXXXXXX-XXXXXXXXXXXXXX-XXXXXX-XXXXXXXXXXXXXXX-----------------------------------------
