-----------------------------------------------------------------------------------------------------------------------------------------------------------------
-----------------------------------------------------------------------------------------------------------------------------------------------------------------
-----------------------------------------------------------------------------------------------------------------------------------------------------------------
-----------------------------------------------------------------------------------------------------------------------------------------------------------------
---------------------------------------------------------------------------g-------------------------------------------------------------------------------------
-------------------------------------------------------------------------SSSSSSSS--------------------------------------------------------------------------------
---------------------------------------------------------g-------------------------------------------------------------------------------------------------------
---------------------SS!S------------------------------SSSSSSSS---------g----------------------------------------------------------------------------------------
-----------------------------------------------------------------#-----------------------------------------------------------------------------------------------
----------------------------#--#----------------------g----------#----S@S----------------------------------#------------------S!!S-------------------------------
-----##--#---------!---SS--##--##--------------------------------###--------------------------------------##----------S@S!S-----------tt----SS-------------------
----###--##---------------###--##-------------------S@S----------###-------------------------------------###--------------------------tt-------------------------
---------###---------------------tt---------------tt------####---###--------------------------tt--------####--------------------------tt---------------------tt--
-M-------###---------g-g---------tt---------------tt-----#####--####--g-g-----gg--------------tt---------gg------------g------g-g-t-------g-g----------------tt--
XXXXXXXX-XXXXXXXXXXXXXXXXXXXXXXXXXXXXXXXXXXXXXXXXXXXXXXXXXXXXX-XXXXXXXXXXXXXXXXXXXXXXXXXXXXXXXXXXXXXXXXXXXXXXXXXXXXXXXXXXXXXXXXXXXXXXXXXXXXXXXXXXXXXXXXXXXXXXXXXX
XXXXXXXX-XXXXXXXXXXXXXXXXXXXXXXXXXXXXXXXXXXXXXXXXXXXXXXXXXXXXX-XXXXXXXXXXXXXXXXXXXXXXXXXXXXXXXXXXXXXXXXXXXXXXXXXXXXXXXXXXXXXXXXXXXXXXXXXXXXXXXXXXXXXXXXXXXXXXXXXX
