-------------------------------------------------------------------------------------------------------------------------------------------------------------
-------------------------------------------------------------------------------------------------------------------------------------------------------------
-------------------------------------------------------------------------------------------------------------------------------------------------------------
-------------------------------------------------------------------------------------------------------------------------------------------------------------
-------------------------------------------------------------------------------------------------------------------------------------------------------------
---------------------------------------------------------------------------------------------------------------------------------------------##--------------
--------------------------------------------------------------------------------#--#-------------------------------#--#---------------------###--------------
-------------------------------------------------------------------------------##--##-----------------------------##--##--------------------###--------------
----------------------------------------------------------------------------#--##--###----------------------------##--###-------------------###--------------
------------------------------------------------------#------#-------------##--##--####---------------------------##--###-------------------###--------------
---------------------------------#-------------------##-----##------------###-------------------------SS!S----------SS----------------------###----------SS!S
-------S@S!S--------------------##----------#-------###----###S@S!S------####--------------------------------------------S@S!S------S@S!S---###--------------
-------------------##--#-------###S@S!S-----##-----####---####-----------####--------#-----------tt---------tt------------------------------###-----tt-------
-M--g----------t--###--##-----####----------###---#####--#####--------t-g------gg---##-g-g-tt----tt---------tt#gg-g-g------------t-----------g------tt-------
XXXXXXXXXXXXXXXXXXXXXX-###---#####--------t-####--#####--#####---XXXXXXXXXXXXXXXXXXXXXXXXXXXXXXXXXXXXXXXXXXXXXXXXXXXXXXXXXXXXXXXXXXXX-XXXXXXXXXXXXXXXXXXXXXXX
XXXXXXXXXXXXXXXXXXXXXX-####--#####---XXXXXXXXXXXXXXXXXXXXXXXXXX--XXXXXXXXXXXXXXXXXXXXXXXXXXXXXXXXXXXXXXXXXXXXXXXXXXXXXXXXXXXXXXXXXXXX-XXXXXXXXXXXXXXXXXXXXXXX
