----------------------------------------------------------------------------------------------------------------------------------------------------------------------------------------------------------
----------------------------------------------------------------------------------------------------------------------------------------------------------------------------------------------------------
----------------------------------------------------------------------------------------------------------------------------------------------------------------------------------------------------------
----------------------------------------------------------------------------------------------------------------------------------------------------------------------------------------------------------
----------------------------------------------------------------------------------------------------------------------------------------------------------------------------------------------------------
----------------------------------------------------------------------------------------------------------------------------------------------------------------------------------------------------------
----------------------------------------------------------------------------------------------------------------------------------------------------------------------------------------------------------
----------------------------------------------------------------------------------------------------------------------------------------------------------------------------------------------------------
-------------------------------------------------------------------------------------------##-------------------------------------------------------------------------------------------------------------
------------------------------------------------------------------------------------------###-------------------------------------------------------------------------------------------------------------
-----------------------------------t--------------------------------t--------------t-----####------------------------------t----------------t----------------t---------------------------------------t----
-----------------------------------t--------------------------------t--------------t----#####------------------------------t----------------t----------------t---------------------------------------t----
----------------tt-----------------t-------------tt-----------------t----tt--------t---######----tt--------------tt--------t----------------t----------------t----tt--------------tt-----------------t----
-M-####--###g---tt#####--###---g-g-t####--###g---tt#####--###---g-g-tg---tt#---g-g-t####--###g---tt#####--###g---tt#---g-g-t####--###---g-g-t####--###---g-g-tg---tt#####--###g---tt#####--###---g-g-tg---
XXXXXXXXXXXXXXXXXXXXXXXXXXXXXXXXXXXXXXXXXXXXXXXXXXXXXXXXXXXXXXXXXXXXXXXXXXXXXXXXXXXXXXXXXXXXXXXXXXXXXXXXXXXXXXXXXXXXXXXXXXXXXXXXXXXXXXXXXXXXXXXXXXXXXXXXXXXXXXXXXXXXXXXXXXXXXXXXXXXXXXXXXXXXXXXXXXXXXXXXXX
XXXXXXXXXXXXXXXXXXXXXXXXXXXXXXXXXXXXXXXXXXXXXXXXXXXXXXXXXXXXXXXXXXXXXXXXXXXXXXXXXXXXXXXXXXXXXXXXXXXXXXXXXXXXXXXXXXXXXXXXXXXXXXXXXXXXXXXXXXXXXXXXXXXXXXXXXXXXXXXXXXXXXXXXXXXXXXXXXXXXXXXXXXXXXXXXXXXXXXXXXX
