----------------------------------------------------------------------------------------------------------------------------------------------------------------------------------------------------------
----------------------------------------------------------------------------------------------------------------------------------------------------------------------------------------------------------
----------------------------------------------------------------------------------------------------------------------------------------------------------------------------------------------------------
----------------------------------------------------------------------------------------------------------------------------------------------------------------------------------------------------------
----------------------------------------------------------------------------------------------------------------------------------------------------------------------------------------------------------
----------------------------------------------------------------------------------------------------------------------------------------------------------------------------------------------------------
----------------------------------------------------------------------------------------------------------------------------------------------------------------------------------------------------------
----------------------------------------------------------------------------------------------------------------------------------------------------------------------------------------------------------
---------------------------------------------------------------------------------------------------------------##-----------------------------------------------------------------------------------------
--------------------------------------------------------------------------------------------------------------###-----------------------------------------------------------------------------------------
-----------------t--------------t----------------t---#--#----------------t--------------t--------------t-----####--------------t------##---------------t--------------t----------------t----------------t-
-----------------t--------------t----------------t--##--##---------------t--------------t--------------t----#####--------------t-----###---------------t--------------t----------------t----------------t-
-------tt--------t----tt--------t----------------t-###--##-----tt--------t----tt--------t----tt--------t---######----tt--------t----####-----tt--------t----tt--------t----------------t----------------t-
-M-g---tt#---g-g-tg---tt#---g-g-t####--###---g-g-t####--###g---tt#---g-g-tg---tt#---g-g-tg---tt#---g-g-t####--###g---tt#---g-g-t####--###g---tt#---g-g-tg---tt#---g-g-t####--###---g-g-t####--###---g-g-t#
XXXXXXXXXXXXXXXXXXXXXXXXXXXXXXXXXXXXXXXXXXXXXXXXXXXXXXXXXXXXXXXXXXXXXXXXXXXXXXXXXXXXXXXXXXXXXXXXXXXXXXXXXXXXXXXXXXXXXXXXXXXXXXXXXXXXXXXXXXXXXXXXXXXXXXXXXXXXXXXXXXXXXXXXXXXXXXXXXXXXXXXXXXXXXXXXXXXXXXXXXX
XXXXXXXXXXXXXXXXXXXXXXXXXXXXXXXXXXXXXXXXXXXXXXXXXXXXXXXXXXXXXXXXXXXXXXXXXXXXXXXXXXXXXXXXXXXXXXXXXXXXXXXXXXXXXXXXXXXXXXXXXXXXXXXXXXXXXXXXXXXXXXXXXXXXXXXXXXXXXXXXXXXXXXXXXXXXXXXXXXXXXXXXXXXXXXXXXXXXXXXXXX
