----------------------------------------------------------------------------------------------------------------------------------------------------------------------------------------------------------
----------------------------------------------------------------------------------------------------------------------------------------------------------------------------------------------------------
----------------------------------------------------------------------------------------------------------------------------------------------------------------------------------------------------------
----------------------------------------------------------------------------------------------------------------------------------------------------------------------------------------------------------
----------------------------------------------------------------------------------------------------------------------------------------------------------------------------------------------------------
----------------------------------------------------------------------------------------------------------------------------------------------------------------------------------------------------------
----------------------------------------------------------------------------------------------------------------------------------------------------------------------------------------------------------
----------------------------------------------------------------------------------------------------------------------------------------------------------------------------------------------------------
---------------------------------------------------------------------------------------------------##-----------------------------------------------------------------------------------------------------
--------------------------------------------------------------------------------------------------###-----------------------------------------------------------------------------------------------------
----------t-------------##--#-----t-----------------------t---#--#---------t---------------------####-------t--------------t------------------------------t------------------------------t---#--#---------
----------t------------###--#-----t-----------------------t--##--##--------t--------------------#####-------t--------------t------------------------------t------------------------------t--##--##--------
----------t----tt-----####--#-----t----tt-----------------t-###--##--------t-------------tt----######-------t----tt--------t----tt--------------tt--------t----tt--------------tt--------t-###--##--------
-M----g-g-tg---tt#####--###---g-g-tg---tt#####--###---g-g-t####--###---g-g-t####--###g---tt#####--###---g-g-tg---tt#---g-g-tg---tt#####--###g---tt#---g-g-tg---tt#####--###g---tt#---g-g-t####--###---g-g-
XXXXXXXXXXXXXXXXXXXXXXXXXXXXXXXXXXXXXXXXXXXXXXXXXXXXXXXXXXXXXXXXXXXXXXXXXXXXXXXXXXXXXXXXXXXXXXXXXXXXXXXXXXXXXXXXXXXXXXXXXXXXXXXXXXXXXXXXXXXXXXXXXXXXXXXXXXXXXXXXXXXXXXXXXXXXXXXXXXXXXXXXXXXXXXXXXXXXXXXXXX
XXXXXXXXXXXXXXXXXXXXXXXXXXXXXXXXXXXXXXXXXXXXXXXXXXXXXXXXXXXXXXXXXXXXXXXXXXXXXXXXXXXXXXXXXXXXXXXXXXXXXXXXXXXXXXXXXXXXXXXXXXXXXXXXXXXXXXXXXXXXXXXXXXXXXXXXXXXXXXXXXXXXXXXXXXXXXXXXXXXXXXXXXXXXXXXXXXXXXXXXXX
