----------------------------------------------------------------------------------------------------------------------
----------------------------------------------------------------------------------------------------------------------
-----------------------------------------------------------------------------------------------------@----------------
----------------------------------------------------------------------------------------------------------------------
----------------------------------------------------------------------------------------------------------------------
----------------------------------------------------------------------------------------------------------------------
---------------------!----------------------------------------------------------------1--------------!--!--------tt---
-------------------------g----------------S!!S------------------##-------C------------------SS!S-----------------tt---
-----------------------SSSSSSSS--------------------------------###--------------------------------------------##------
-------------------------------------1------------------------####-----------------tt-------------------t-----##------
--S!!S------!------S@S!------------!--------------#--------------S##------g-#------tt#------------------t-----##------
------------------------------------------##------##--------------XXXXXXXXXXX------#####XXXXXXXXXXXXXX--XXXXXXXXXXXXX-
-------------------------------t----------##------###------tt-----X-###XXXXXX--tt-######XXXXXXXXXXXXXX--XXXXXXXXXXXXX-
-----------------#####-----g-g-t----------##-------####----tt--g-g-####--------tt#######------------------------------
XXXXXXXXXXXXXXXXXXXXXXXXXXXXXXXXXXXXXXXXXXXXXXXXX--XXXXXXXXXXXXXXXXXXXXXXXXXXXXXXXXXXXXX------------------------------
XXXXXXXXXXXXXXXXXXXXXXXXXXXXXXXXXXXXXXXXXXXXXXXXX--XXXXXXXXXXXXXXXXXXXXXXXXXXXXXXXXXXXXX------------------------------
