-----------------------------------------------------------------------------------------------------------------------------------------
-----------------------------------------------------------------------------------------------------------------------------------------
-----------------------------------------------------------------------------------------------------------------------------------------
-----------------------------------------------------------------------------------------------------------------------------------------
-----------------------------------------------------------------------------------------------------------------------------------------
-----------------------------------------------------------------------------------------------------------------------------------------
----------------------------------S------------------------------------------------------------------------------------------------------
---------------------------------#-------------------g----------------------------C-------------##---------------------------------------
--------------------------------##-----------------SSSSSSSS------------------------------------###---------------------------------------
-------------------1-----------###----tt---------------------------------------------S!!S-----####---------------------------------------
-----------------!-------tt---####----tt-----------------------------------------------------#####-------------#----------------------SU-
---------#####-----------tt--#####----tt----------------------------------------------------######-----tt------##------------------------
--------######-----------tt----###-------###---tt-------t----tt-----------------------------------#----tt------###-----------------------
-M----g-######---------------g####--gg---####--tt--##---t----tt-----------------------------------####-----tt--------g----tt-------------
XXXXXXXXXXXXXXXXXXXXXXXXXXXXXXXXXXXXXXXXXXXXXXXXXXXXXXXXXXXXXXXXXXXXXXXXX--XXXXXXXX--XXXXXXXXXXXXXXXXXXXXXXXX-XXXXXXXXXXXXXXXXXXX--XXXXXX
XXXXXXXXXXXXXXXXXXXXXXXXXXXXXXXXXXXXXXXXXXXXXXXXXXXXXXXXXXXXXXXXXXXXXXXXX--XXXXXXXX--XXXXXXXXXXXXXXXXXXXXXXXX-XXXXXXXXXXXXXXXXXXX--XXXXXX
