-----------------------------------------------------------------------------------------------------------------------------------------------------------------------------------
-----------------------------------------------------------------------------------------------------------------------------------------------------------------------------------
-----------------------------------------------------------------------------------------------------------------------------------------------------------------------------------
-----------------------------------------------------------------------------------------------------------------------------------------------------------------------------------
-----------------------------------------------------------------------------------------------------------------------------------------------------------------------------------
------------------------g----------------------------------------------------------------------------------------------------------------------------------------------------------
----------------------SSSSSSSS-----------------------------------------------------------------------------------------------------------------------------------------------------
-----------------------------------------------------------------------------------------------------------------------------------------------------------------------------------
---#--#----------------------------------------------------------------------------------------------------------------------------------------------------------------------------
--##--##---------------------------------------------------------------------------------------------------------------------------------------------------------------------------
-----SS-------##-----SS!S---SS------C----------------------------------------------------------------------------------------------------------------------------------------------
-------------###-------------------------------------------------------------------------------------------------------------------------------------------------------------------
------------####-----------------t-------------------------------------------------------------------------------------------------------------------------------------------------
-M-g-g--g-t---g---##------g-g--g-t--------SU----!-----SU-----------!------------!------------!-----SU-----------!------------!------------!------------!-----SU----!------------!--
XXXXXXXXXXXXXXXX--XXXXXXXXXXXXXXXX-------------------------------------------------------------------------------------------------------------------------------------------------
XXXXXXXXXXXXXXXX--XXXXXXXXXXXXXXXX------------------------tt-----------tt-----------tt-----------------tt-----------tt-----------tt-----------tt-----------------------tt----------
