------------------------------------------------------------------------------------------------------------------------------------------------------------------
------------------------------------------------------------------------------------------------------------------------------------------------------------------
------------------------------------------------------------------------------------------------------------------------------------------------------------------
------------------------------------------------------------------------------------------------------------------------------------------------------------------
------------------------------------------------------------------------------------------------------------------------------------------------------------------
------------------------------------------------------------------------------------------------------------------------------------------------------------------
---------------------------------------------------------------!--------------------------------------------------------------------------------------------------
------------------------------------------------------------------------------------------------------------------------------------------------------------------
--------------------------------------------------------------------------------------------t-------------##------------------------------------------------------
----#---------------------------------------------------------------------------------------t------------###------------------------------------------------------
----##----------------tt--------!----!-----------------!-----S@S!---S@S-----##-----S@S------t--------S--####-----------------------S------------------------------
----###---------------tt-----------------------#--#------------------------###----------#####------------##-----------tt------------------------------------------
---t--------------------###-------------------##--##----------------------####---------######--tt--------##-----------tt---###------------------------###---------
-M-t--------#####-------####---------k---g---g----tt------g----tt--------g----tt-------######--tt#-------##-----##-----##--####--------##----g----tt--####--------
XXXXXXXXXXXXXXXXX--XXXXXXXXXXXXXXXXXXXXXXXXXXXXXXXXXXXXXXXXXXXXXXXXXXXXXXXXXXXXXXXXXXXXXXXXXXXXXXX-XXXXXXXXXXXXXXXXXX--XXXXXXXXXXXXXXXXXXXXXXXXXXXXXXXXXXXXXXXXX--
XXXXXXXXXXXXXXXXX--XXXXXXXXXXXXXXXXXXXXXXXXXXXXXXXXXXXXXXXXXXXXXXXXXXXXXXXXXXXXXXXXXXXXXXXXXXXXXXX-XXXXXXXXXXXXXXXXXX--XXXXXXXXXXXXXXXXXXXXXXXXXXXXXXXXXXXXXXXXX--
