-------------------------------------------------------------------------------------------------------------------------------------------------------------------------
-------------------------------------------------------------------------------------------------------------------------------------------------------------------------
-------------------------------------------------------------------------------------------------------------------------------------------------------------------------
-------------------------------------------------------------------------------------------------------------------------------------------------------------------------
-------------------------------------------------------------------------------------------------------------------------------------------------------------------------
-------------------------------------------------------------------------------------------------------------------------------------------------------------------------
----------------SS--------------------------------------!----------------------------------------------------------------------------------------------------------------
-------------------------------------------------------------------------------------------------------------------------------------------------------------------------
---------------g---------------------------------------------------------------------------------------------------------------------------------------------------------
-------------------------------------------------------------------------------------------------------------------------------------------------------------------------
-------------S@S------------------------!---------##--S@S!S---!-----------#--#---------@----------##--#----------##--#----------##--#----------##--#---------@----#####--
-------------------------------------------------###---------------------##--##------------------###--##--------###--##--------###--##--------###--##------------######--
------------------------------------------------####--------------------###--###----------------####--###------####--###------####--###------####--###----------#######--
-M---------t########-------g-g---------------g------ttt-g----------gg--####--####--------------#####--####----#####--####----#####--####----#####--####--------########--
XXXXXXXXXXXXXXXXXXXXXXXXXXXXXXXXXXXXXXXXXXXXXXXXXXXXXXXXXXXXXXXXXXXXXXXXXXXXXXXXXXXXXXXXXXXXXXXXXXX-t-g-########-------t-g------------------------XXXXXXXXXXXXXXXXXXXXXXX
XXXXXXXXXXXXXXXXXXXXXXXXXXXXXXXXXXXXXXXXXXXXXXXXXXXXXXXXXXXXXXXXXXXXXXXXXXXXXXXXXXXXXXXXXXXXXXXXXXX-XXXXXXXXXXXXXX-----XXXXXX-----XXXXXXXXXX------XXXXXXXXXXXXXXXXXXXXXXX
