-----------------------------------------------------------------------------------------------------------------------------------------------------------
-----------------------------------------------------------------------------------------------------------------------------------------------------------
-----------------------------------------------------------------------------------------------------------------------------------------------------------
----------------------SS-----------------------------------------------------------------------------------------------------------------------------------
-----------------------------------------------------------------------------------------------------------------------------------------------------------
---------------------g----------g--------------------------------------------------------------------------------------------------------------------------
------------------------------SSSSSSSS----------------------#---------------------------#------------------------------------------------------------------
-------------------S@S--------------------------------------##--------!-------##----!---##--------!--------------------------------------------------------
-----------------------------g------------------------------###--------------###--------###----------------------------------------------------------------
------------------------------------------------------------####------------####--------####---------------------------------------------------------------
--------------!-----!--!---S@S--------------#-------##--#----#####---------#####---------#####--------------@---------@----------##--#---------@-----------
-----------t-------------------------------##------###--##--######--S@S!--######--S@S!--######--S@S!S---------------------------###--##--------------------
-----------t------------------------------###-----####--##-#######-------#######-------#######---------------------------------####--###-------------------
-M---------t---------------g------tt-gg--####----#####--##########------########------########--------------------------------#####--####------------------
XXXXXXXXXXXXXXXXXXXXXXXXXXXXXXXXXXXXXXXXXXX---#####----XXXXXXXXXXXXX-XXXXXXXXXXXXX-XXXXXXXXXXXXX-XXXXXXXXXXXXXXXXXXXXXXXXXXXXXXXXX--XXXXXXXXXXXXXXXXXXXXXXX
XXXXXXXXXXXXXXXXXXXXXXXXXXXXXXXXXXXXXXXXXXX--######----XXXXXXXXXXXXX-XXXXXXXXXXXXX-XXXXXXXXXXXXX-XXXXXXXXXXXXXXXXXXXXXXXXXXXXXXXXX--XXXXXXXXXXXXXXXXXXXXXXX
