-------------------------------------------------------------------------------------------------------------------------------------------------
-------------------------------------------------------------------------------------------------------------------------------------------------
-------------------------------------------------------------------------------------------------------------------------------------------------
-------------------------------------------------------------------------------------------------------------------------------------------------
-------------------------------------------------------------------------------------------------------------------------------------------------
-------------------------------------------------------------------------------------------------------------------------------------------------
------------------------------##--#----------------------------------##--------------------------------------------------------------------g-----
-----------------------------##--!----------------------------------##--!-------------------------------------##----!--------------------SSSSSSSS
----------------------------###------------------------------------###---------------------------------------###---------------------------------
---------------------------####-----------------------------------####--------------------------------------####------------------------g--------
-------#-------##--#----#####---------------##--#---------@----#####---------------##--#----------##--#----#####---------------##----------------
------##------###--##--######--S@S!S-------###--##------------######--S@S!S-------###--##--------###--##--######--S@S!S-------###-----S@S--------
-----###-----####--##-#######-------------####--###----------#######-------------####--###------####--##-#######-------------####----------------
-M--####----#####--##########------------#####--####--------########------------#####--####----#####--##########------------#####----------------
XXXXXX########----XXXXXXXXXXXXX-XXXXXXXXXXXXX--XXXXXXXXXXXXXXXXXXXXXXX-XXXXXXXXXXXX------------------XXXXXXXXXXXXX-XXXXXXXXXXXXX--XXXXXXXXXXXXX--
XXXXXXXXXXXXXXXX--XXXXXXXXXXXXX-XXXXXXXXXXXXX--XXXXXXXXXXXXXXXXXXXXXXX-XXXXXXXXXXXX--XXXXXXXXXX------XXXXXXXXXXXXX-XXXXXXXXXXXXX--XXXXXXXXXXXXX--
