--------------------------------------------------------------------------------------------------------------------------------------------------------------------------
--------------------------------------------------------------------------------------------------------------------------------------------------------------------------
--------------------------------------------------------------------------------------------------------------------------------------------------------------------------
------------------------------------------------------------------------------------------------------------------------------------------------------!-------------------
--------------------------------------------------------------------------------------------------------------------------------------------------------------------------
--------------------------------------------------------------------------------------------------------------------------------------------------------------------------
--------------------------------------------##--#-----------------------------------------------------------#-------------------------------------------------------------
---------------------------------!---------###--##------------tt-------------------------tt-----------------##------------tt----!--!--------##------S@S!S-----------!--!--
------------------------------------------####--###------#----tt-------------t-----------tt-----------------###-----------tt---------------###----------------------------
-----------------------------------------#####--####----##----tt-------------t-----------tt-----------------####----------tt--------------####----------------------------
-------#-------##--#----#####---------#####----------tt----########----------t-------tt---------g-g--M----########---g------tt---------g------tt-------tt----M------------
------##------###--##--######--S@S!--######---------XXXXXXXXXXXXXXXXXXXXXXXXXXXXXXXXXXXXXXXXXXXXXXXXXXXXXXXXXXXXXXXXXXXXXXXXXXXXXXXXXXXXXXXXXXXXXXXXXXXXXXXXXXXXXXXXXXXXXX
-----###-----####--##-#######-------#######---------XXXXXXXXXXXXXXXXXXXXXXXXXXXXXXXXXXXXXXXXXXXXXXXXXXXXXXXXXXXXXXXXXXXXXXXXXXXXXXXXXXXXXXXXXXXXXXXXXXXXXXXXXXXXXXXXXXXXXX
-M--####----#####--##########------########--------F----------------------------------------------------------------------------------------------------------------------
XXXXXX-g------tt--XXXXXXXXXXXXX-XXXXXXXXXXXXX------#----------------------------------------------------------------------------------------------------------------------
XXXXXXXXXXXXXXXX--XXXXXXXXXXXXX-XXXXXXXXXXXXXXXXXXXXXX--------------------------------------------------------------------------------------------------------------------
