--------------------------------------------------------####--###------###---------------------#######-------------------t--------------------------------
-------------------------------------------------------#####--####----####------#----------tt-########-------------------t--------------------------------
----------------------------------------------------#####----------------------------------XXX-------------tt------------t----------------tt-----g------tt
---------------------------------------------------######-----------------XXXXXXXXXXX---XXXXXX--XXXXXXXXXXXXXXXXXXXXXXXXXXXXXXX---XXXXXXXXXXXXXXXXXXXXXXXX
--------------------------------------------------#######-----------------XXXXXXXXXXX---XXXXXX--XXXXXXXXXXXXXXXXXXXXXXXXXXXXXXX---XXXXXXXXXXXXXXXXXXXXXXXX
----------------------------------------@--------########---------------##--------------------------------------------------------------------------------
-------------------------!----------------------SU----!--!--!----------###--------------------------------------------------------------------------------
----------------------------------------------------------------------####--------------------------------------------------------------------------------
---------------------------------------------------------------------#####--------------------------------------------------------------------------------
-----------------------------------###-g------tt------k--------t-g---------------------g------------------------------------------------------------------
-------------------!---S@S!S------####XXXXXXXXXXXXXXXXXXXXXXXXXXXXXXXXXXXX---XXXXXXXXXXX------------------------------------------------------------------
---------------------------------#####XXXXXXXXXXXXXXXXXXXXXXXXXXXXXXXXXXXX---XXXXXXXXXXX------------------------------------------------------------------
-----tt-------------------------########------------------------------------------------------------------------------------------------------------------
-M---tt#---------------########---g-g-tt------------------------------------------------------------------------------------------------------------------
XXXXXXXXXXXXX---XXXXXXXXXXXXXXXXXXXXXXXXXXXXX-------------------------------------------------------------------------------------------------------------
XXXXXXXXXXXXX---XXXXXXXXXXXXXXXXXXXXXXXXXXXXX-------------------------------------------------------------------------------------------------------------
