-------------------------------------------------------------------------------------------------------------------------------------------------------------------------
--------------------------------------------------------g----------------------------------------------------------------------------------------------------------------
-------------------------------------------------------------------------------------------------------------------------------------------------------------------------
------------------------------------------------------S@S---------------------------------------------------------------------------g------------------------------------
----------------------------------------------------------------------------------------------------------------------------------SSSSSSSS-------------------------------
-------------------------------------------------------------------------------------------------------------------------------------------------------------------------
------#----------##--#----------------------------------#####--------------------------------------------------------------------g---------------------------------------
------##--------###--##----------------------------!---######----tt-----------!-----------------------!-------#-------#--------------------------------------------------
------###------####--###------------------------------#######----tt-----------------------t------------------##------##--!-----S@S---------#--#--------------------------
------####----#####--####------tt-------------tt-----########----tt-----------------------t-----------------###-----###-------------------##--##-------------!--!------#-
---SU----!---------------------tt#-----g-g----tt#-------tt-----g------tt-gg---------------t----------------####----####------------------###--###---------------------##-
-------------------XXXXXXXXXXXXXXXXXXXXXXXXXXXXXXXXXXXXXXXXXXXXXXXXXXXXXXXXXXXXXXXXXXXXXXXXXXXXX---XXXXXXXXXX-g------tt------########---####--####-------------------###-
-------------------XXXXXXXXXXXXXXXXXXXXXXXXXXXXXXXXXXXXXXXXXXXXXXXXXXXXXXXXXXXXXXXXXXXXXXXXXXXXX---XXXXXXXXXXXXXXXXXXXXXXXXXXXXXXXXXXXXXXXXXX--tt----t-g------------####-
-M-------k---------g-----------------------------------------------------------------------------------------XXXXXXXXXXXXXXXXXXXXXXXXXXXXXXXX-XXXXXXXXXXXXXXXXXXXXXXXXXXX
XXXXXXXXXXXXXXXXXXXX--------------------------------------------------------------------------------------------------------------------------XXXXXXXXXXXXXXXXXXXXXXXXXXX
XXXXXXXXXXXXXXXXXXXX-----------------------------------------------------------------------------------------------------------------------------------------------------
