-------------------------------------------------------------------------------------------------------------------------------------------------
-------------------------------------------------------------------------------------------------------------------------------------------------
-------------------------------------------------------------------------------------------------------------##--#-----#-------------------------
------------------------------------------------------------------------------------------------------------###--##------------------------------
-----------------------------------------------------------------------------------------------------------####--###-----------------------------
----------------------------------------------------------------------------------------------------------#####--####----------------------------
--------------------------------------#--------------------------------------------@-------------------#####--SU----!--------!-------------------
--------------------------------------##--------!-----------------------------------------------------######-------------------------------------
--------------------------------------###------------------------------------------------------------#######-------------------------------------
--------------------------------------####-----------------------------------------------tt---------########--------k-------------g------ttt-g---
-------#-------##--#----------##--#----#####---------------##--#---------@----###t-g-----tt#-gg-M-----g-g-tt--XXXXXXXXXXXXXXXXXXXXXXXXXXXXXXXXXXX
------##------###--##--------###--##--######--S@S!S-------###--##------------####XXXXXXXXXXXXXXXXXXXXXXXXXXXXXXXXXXXXXXXXXXXXXXXXXXXXXXXXXXXXXXXX
-----###-----####--###------####--##-#######-------------####--###----------#####XXXXXXXXXXXXXXXXXXXXXXXXXXXXXXXX--------------------------------
-M--####----#####--####----#####--##########------------#####--####--------########--------------------------------------------------------------
XXXXXX-g----------------tt-------XXXXXXXXXXXXX-XXXXXXXXXXXXX--XXXXXXXXXXXXXXXXXXXXXXX------------------------------------------------------------
XXXXXXXXXXX--XXXXXXXXXXXXXXXXX---XXXXXXXXXXXXX-XXXXXXXXXXXXX--XXXXXXXXXXXXXXXXXXXXXXX------------------------------------------------------------
