---------------------------------------------------------------------------------------------------------------------------------------------------------------------------
---------------------------------------------------------------------------------------------------------------------------------------------------------------------------
---------------------------------------------------------------------------------------------------------------------------------------------------------------------------
---------------------------------------------------------------------------------------------------------------------------------------------------------------------------
---------------------------------------------------------------------------------------------------------------------------------------------------------------------------
---------------------------------------------------------------------------------------------------------------------------------------------------------------------------
--------------------------------------------------------------------!------------------------------------------------------------------------------------------------------
---------------------------------------------------------------------------------------------------------------------------------------------------------------------------
---------------------------------------------------------------------------------------------------------------------------------------------------------------------------
------------------------------------@--------------------------------------------------------------------------------------------------------------------------------------
---------------------------------------------!--!-------------!---S@S!S--------#-------##--#----------##--#----------##--#---------@---------@---------@----------##--#----
-----------t-----------------------------------------------t------------------##------###--##--------###--##--------###--##--------------------------------------###--##---
-----------t-----------------------------------------------t-----------------###-----####--###------####--###------####--###------------------------------------####--###--
-M---------t-----g-g-----------M-----tt--------------------g------tt-tt-----####----#####--####----#####--####----#####--####----------------------------------#####--####-
XXXXXXXXXXXXXXXXXXXXXXXXXXX---XXXXXXXXXXXXXXXXXXXXXXXXXXXXXXXXXXXXXXXXXXXXXXXX########--SU----!-tt-------------tt-------XXXXXXXXXXXXXXXXXXXXXXXXXXXXXXXXXXXXXXXXXXX-t-g----
XXXXXXXXXXXXXXXXXXXXXXXXXXX---XXXXXXXXXXXXXXXXXXXXXXXXXXXXXXXXXXXXXXXXXXXXXXXXXXXXXXXXXX-------XXX--XXXXXXXXXXXXXXXXX---XXXXXXXXXXXXXXXXXXXXXXXXXXXXXXXXXXXXXXXXXXX-XXXXXX-
