-----------------------------------------------------------------------------------------------------------------------------------------------------
-----------------------------------------------------------------------------------------------------------------------------------------------------
---------------------------------------------------------------------------------------------------------------------------------------##--#---------
--------------------------------------------------------------------------------------------------------------------------------------###--##--------
-------------------------------------------------------------------------------------------------------------------------------------####--###-------
------------------------------------------------------------------------------------------------------------------------------------#####--####------
----------!-----------------------------------------------------------------------------------------------------##--#------------#####--SU----!------
--------------------------tt-----------------------------------------------------------------------------------###--##----------######---------------
--------------------------tt----------------------------------------------------------------------------------####--###------#-#######---------------
--------------------------tt---------------------------------------------------------------------------------#####--####----##########--------kt-g---
--------S@S!S------------!--!--SU----!----------#--#---------@---------@----------##--#----------##--#----#####----------tt-----g-g-tt--XXXXXXXXXXXXX
----------------------t------------------------##--##----------------------------###--##--------###--##--######---------XXXXXXXXXXXXXXXXXXXXXXXXXXXXX
-----tt---------------t-----------------------###--###--------------------------####--###------####--##-#######---------XXXXXXXXXXXXXXXXXXX----------
-M--------------------t--------------k-------####--####------------------------#####--####----#####--##########--------F-----------------------------
XX--XXXXXXXXXXXXXXXXXXXXXXXXXXXXXXXXXXXXXXXXXXXXXXXXXXXXXXXXXXXXXXXXXXXXXXXXXX----------t-g---------XXXXXXXXXXXXX------#-----------------------------
XX--XXXXXXXXXXXXXXXXXXXXXXXXXXXXXXXXXXXXXXXXXXXXXXXXXXXXXXXXXXXXXXXXXXXXXXXXXX--XXXXXXXXXXXXXX------XXXXXXXXXXXXXXXXXXXXXX---------------------------
