-----------------------------------------------------------------------------------------------------------------------------g-------------g--------
------------------------------------------------------------------------------------------------------------------#---------------------------------
-------------------------------------------------------------------------------------------------------------SS!S-##-------S@S--------C--S@S--------
------------------------------------------------------------------------------------------------------------------###-------------------------------
------------------------------------------------------------------------------------------------------------------####------------------------------
--------------------------------------------------------------##--#---------@---------------------------##---------tt----########--M-----g-g-tt-----
---------------------------------!---------------------------###--##-----------------tt----------------###XXXXXXXXXXXXXXXXXXXXXXXXXXXXXXXXXXXXXXXXXX
------------------------------------------------------------####--###----------------tt---------------####XXXXXXXXXXXXXXXXXXXXXXXXXXXXXXXXXXXXXXXXXX
-----------------------------------------------------------#####--####---------------tt--------------########---------------------------------------
--------------------------------------------------------#####----XXXXXXXXXt-g----tt---------g-g--M-----g-g-tt---------------------------------------
--------------tt---------------S@S!S-------------------######----XXXXXXXXXXXXXXXXXXXXXXXXXXXXXXXXXXXXXXXXXXXXXXXXX----------------------------------
--------------tt--------------t-----------------------#######-------------XXXXXXXXXXXXXXXXXXXXXXXXXXXXXXXXXXXXXXXX----------------------------------
--------------tt---tt---------t----------------------########---------------------------------------------------------------------------------------
-M--gg--g------tt--tt#--------t########-------g-g---gg--tt----t-g------------g----------------------------------------------------------------------
XXXXXXXXXXXXXXXXXXXXXXXXXXXXXXXXXXXXXXXXXXXXXXXXXXXXXXXXXXXXXXXXXXXXXXXXXXXXXX----------------------------------------------------------------------
XXXXXXXXXXXXXXXXXXXXXXXXXXXXXXXXXXXXXXXXXXXXXXXXXXXXXXXXXXXXXXXXXXXXXXXXXXXXXX----------------------------------------------------------------------
