--------------------------------------------------------------------------------------------------------------------------------------------------------------------------
--------------------------------------------------------------------------------------------------------------------------------------------------------------------------
--------------------------------------------------------------------------------------------------------------------------------------------------------------------------
--------------------------------------------------------------------------------------------------------------------------------------------------------------------------
--------------------------------------------------------------------------------------------------------------------------------------------------------------------------
--------------------------------------------------------------------------------------------------------------------------------------------------------------------------
------------------------------------------------------------------------------------------------##--#----------##---------------------------------------------------------
-------------------------------------------------------------tt-------!------------------------###--##--------#SU----!----#--#------------------#####---------------------
-------------------------------------------------------------tt-------------------------------####--###------##----------##--##----------------######---------------------
------------##-----------------------------------------------tt------------------------------#####--####----###---------###--###------------t-#######---------------------
----------------------------#--#----------##--#---------@----#####---------------##--#----#####----------tt----------k-####--####-----------t########------------------F--
-----------------t---------##--##--------###--##------------######--S@S!S-------###--##--######---------XXXXXXXXXXXXXXXXXXXX--tt------------t-g------tt-----g-g--------#--
-----------------t--------###--###------####--###----------#######-------------####--##-#######---------XXXXXXXXXXXXXXXXXXXX-XXXXXXXXXXXXXXXXXXXXXXXXXXXXXXXXXXXXXXXXXXXXX
-M-t-g-----------t-------####--####----#####--####--------########------------#####--##########--------F---------------------XXXXXXXXXXXXXXXXXXXXXXXXXXXXXXXXXXXXXXXXXXXXX
XXXXXXXXXXXXXXXXXXXXXXXXXXXXXXXXXXXXXXXXXXX--XXXXXXXXXXXXXXXXXXXXXXX-XXXXXXXXXXXXX--XXXXXXXXXXXXX------#------------------------------------------------------------------
XXXXXXXXXXXXXXXXXXXXXXXXXXXXXXXXXXXXXXXXXXX--XXXXXXXXXXXXXXXXXXXXXXX-XXXXXXXXXXXXX--XXXXXXXXXXXXXXXXXXXXXX----------------------------------------------------------------
