------------------------------------------------------------------------------------------------------------------------------------------------##----##------
------------------------------------------------------------------------------------------------------------------------------------------------###---###-----
----------------------------------------------------------------------------------------------------------------------------------##--#---------####--####----
---------------------------------------------------------------------------------------------------------------------------------###--##-----SU----!--XXXXXXX-
--------------------------------------------------------------------------------------------------------------------------------####--###-------------XXXXXXX-
----------------------------------------------------------------@--------------------------------------------------------------#####--####--------------------
-----------------------------------------------------------------------------------------tt---------------------##----------#----------tt----------k########--
-----------------------------------------------------------------------------------------tt------------SS!S----###---------##XXXXX---XXXXXXXXXXXXXXXXXXXXXXXXX
-----------------------------------------------------------------------------------------tt-------------------####--------###XXXXX---XXXXXXXXXXXXXXXXXXXXXXXXX
--------------------@------------------------------------------------gg------g-g---------tt----M-------------#####-------########-----------------------------
----------------------------------------------tt----------XXXXXXXXXXXXXXXXXXXXXXXXXXXXXXXXXXXXXXXXXX-----------------M-----g-g-tt-----------------------------
----------------------------------------------tt----------XXXXXXXXXXXXXXXXXXXXXXXXXXXXXXXXXXXXXXXXXXXXXXXXXXXXXXX---XXXXXXXXXXXXXXXXXX------------------------
---------------t------------------------------tt--------########------------------------------------XXXXXXXXXXXXX---XXXXXXXXXXXXXXXXXX------------------------
-M------g-g----tt#########--t-g-----------t-g------tt-gg--g-g-tt----------------------------------------------------------------------------------------------
XXXXXXXXXXXXXXXXXXXXXXXXXXXXXXXXXXXXXXXXXXXXXXXXXXXXXXXXXXXXXXXXXXXXX-----------------------------------------------------------------------------------------
XXXXXXXXXXXXXXXXXXXXXXXXXXXXXXXXXXXXXXXXXXXXXXXXXXXXXXXXXXXXXXXXXXXXX-----------------------------------------------------------------------------------------
