------------------------------------------------------------------------------------------------------------------------------------------------------------------------
------------------------------------------------------------------------------------------------------------------------------------------------------------------------
------------------------------------------------------------------------------------------------------------------------------------------------------------------------
------------------------------------------------------------------------------------------------------------------------------------------------------------------------
------------------------------------------------------------------------------------------------------------------------------------------------------------------------
----------------g-----------------------------------------------------------------------------@-------------------------------------------------------------------------
-------S------SSSSSSSS----------------------------------------------------------##-----------------------tt---------------------------------tt-------tt-----------------
-------------------------------------------------------------------------------###-----------------------tt---------------------------------tt-------tt-----------------
------g------g----------------------------------------------------------------####-----------------------tt-------------tt------------------tt-------tt-----------------
-------------------------------##-----------------------#--------------------#####-----------------g------tt-------gg---tt#-gg------g-g--t-g----g------ttM----########--
----S@S----S@S----------------###---!-------------------##------------SU----!-----------XXXXXXXXXXXXXXXXXXXXXXXXXXXXXXXXXXXXXXXXXXXXXXXXXXXXXXXXXXXXXXXXXXXXXXXXXXXXXXXX
-----------------------------####--------------t--------###-----------------------------XXXXXXXXXXXXXXXXXXXXXXXXXXXXXXXXXXXXXXXXXXXXXXXXXXXXXXXXXXXXXXXXXXXXXXXXXXXXXXXX
----------------------------#####--------------t--------####--------------------------########--------------------------------------------------------------------------
-M-t-g---########--M-----tt--------------------t-------g------tt------------k-----g-g---g-g-tt--------------------------------------------------------------------------
XXXXXXXXXXXXXXXXXXXXXXXXXXXXXXXXXXXXXXXXXXXXXXXXXXXXXXXXXXXXXXXXXXXXXXXXXXXXXXXXXXXXXXXXXXXXXXXXXXX---------------------------------------------------------------------
XXXXXXXXXXXXXXXXXXXXXXXXXXXXXXXXXXXXXXXXXXXXXXXXXXXXXXXXXXXXXXXXXXXXXXXXXXXXXXXXXXXXXXXXXXXXXXXXXXX---------------------------------------------------------------------
