-------------------------------------------------------------------------------------------------------------------------------------------------------
-------------------------------------------------------------------------------------------------------------------------------------------------------
-------------------------------------------------------------------------------------------------------------------------------------------------------
-------------------------------------------------------------------------------------------------------------------------------------------------------
-------------------------------------------------------------------------------------------------------------------------------------------------------
-----------------------------------------@----------------------------------------##--#----------##-----------------g----------##--#----------##--#----
----------!----------------------------------------------------------------------###--##--------------------------SSSSSSS-----###--##--------###--##---
--------------------------------------------------------------------------------####--###------------------------------------####--###------####--###--
-------------------------------------------------------------------------------#####--####-----------------------g----------#####--####----#####--####-
------------------------------------###--!--!-----tt------------!-------SU----!--------SU----!----#--#-------------------#####----XXXXXXXXXXXXX--------
--------S@S!S----------------------####-----------tt---------------------------------------------##--##--------S@S------######----XXXXXXXXXXXXX--------
----------------------------------#####-----------tt--------------------------------------------###--###---------------#######-------------------------
-----tt-------------tt-----------######--------t-g-------------------gg-------k--------------k-####--####-------------########-------------------------
-M---tt#-g------tt--tt#M-----------g-g-XXXXXXXXXXXXXXXXXXX---XXXXXXXXXXXXXXXXXXXXXXXXXXXXXXXXXXXXXX########---g------tt-g-g-tt-------------------------
XXXXXXXXXXXXXXXXXXXXXXXXXXXXXXXXXXXXXXXXXXXXXXXXXXXXXXXXXX---XXXXXXXXXXXXXXXXXXXXXXXXXXXXXXXXXXXXXXXXXXXXXXXXXXXXXXXXXXXXXXXXXXXXXX--------------------
XXXXXXXXXXXXXXXXXXXXXXXXXXXXXXXXXXXXXXXXXXXXXX-----------------------------------------------------XXXXXXXXXXXXXXXXXXXXXXXXXXXXXXXX--------------------
