------------------------------------------------------------------------------------------------------------------#####--####--------------
----------------------------------------------------------------------------------------##--#------------------#####------###--------------
---------------------------------------------------------------------------------------###--##----------------######-----####--------------
-----------------------------------------------------------S@S!S----------------------####--###--------------#######----#####--------------
-------------------------------------------------------------------------------------#####--####------------##---------######--------------
----------------------------##--#----------#--------------------------------------#####--t-g------------M--------SS!S-SU----!--------------
----------------##---------###--##--------##--------------SU----!-----------!----######--XXXXXXXXXXX---XXXXXXX-----------------------------
---------------###--------####--###------###-----#------------------------------#######--XXXXXXXXXXX---XXXXXXX-----------------------------
--------------####-------#####--####----####-----##----------------------------########-------------------------------------k-gg-########--
-------------#####----#####-------########--M-------------------k----------------g-g-tt-----------------------XXXXXXXXXXXXXXXXXXXXXXXXXXXXX
------------######---######-------XXXXXXXXXXXXXXXXXXXX---XXXXXXXXXXXXX---XXXXXXXXXXXXXXXXXXX------------------XXXXXXXXXXXXXXXXXXXXXXXXXXXXX
-----------#######--#######-------XXXXXXXXXXXXXXXXXXXX---XXXXXXXXXXXXX---XXXXXXXXXXXXXXXXXXX-----------------------------------------------
----------########-########--------F-------------------------------------------------------------------------------------------------------
-M---------t-tt-----g------tt------#-------------------------------------------------------------------------------------------------------
XXXXXXXXXXXXXXXXXXXXXXXXXXXXXXXXXXXXXX-----------------------------------------------------------------------------------------------------
XXXXXXXXXXXXXXXXXXXXXXXXXXXXXXXXXXXXXX-----------------------------------------------------------------------------------------------------
