------------------------------------------------------------------------------------------------------------------------------------------------------
------------------------------------------------------------------------------------------------------------------------------------------------------
------------------------------------------------------------------------------------------------------------------------------------------------------
---------------------------------------------------------------------------------------------------------------------------------------------SS---SSS!
------------------------------------------------------------------------------------------------------------------------------------------------------
--------------------------------------------------------------------------------------------------------------------------------------------g---------
--------------------##---------------------------#----------------------------------------------------------------------------------------------------
-------------------###---------------------------##--------!------------------------------------------------------------------------------S@S--------C
------------------####---------------------------###--------------------------------------------------------------------------------------------------
--------------------###--------------------------####-------------------------------------------------------------------------------------------------
----tt----SU----!--####----#--#----------##--#----#####---------------##--#----------##--#---------@---------@----------##--#---------@----#####------
----tt------------#####---##--##--------###--##--######--S@S!S-------###--##--------###--##----------------------------###--##------------######------
----tt-----------######--###--###------####--##-#######-------------####--###------####--###--------------------------####--###----------#######------
-M--tt----------kt-g----####--####----#####--##########------------#####--####----#####--####------------------------#####--####--------########------
XXXXXXXXXXXXXXXXXXXXXXXXXXXXXXXXXXXXXXXXXX--XXXXXXXXXXXXX-XXXXXXXXXXXXX--XXXXXXXXXXXXX--XXXXXXXXXXXXXXXXXXXXXXXXXXXXXXXXX--XXXXXXXXXXXXXXXXXXXXXXX----
XXXXXXXXXXXXXXXXXXXXXXXXXXXXXXXXXXXXXXXXXX--XXXXXXXXXXXXX-XXXXXXXXXXXXX--XXXXXXXXXXXXX--XXXXXXXXXXXXXXXXXXXXXXXXXXXXXXXXX--XXXXXXXXXXXXXXXXXXXXXXX----
