----------------------------------------------------------------------------------------------------------------------------------------------------------------------
----------------------------------------------------------------------------------------------------------------------------------------------------------------------
----------------------------------------------------------------------------------------------------------------------------------------------------------------------
----------------------------------------------------------------------------------------------------------------------------------------------------------------------
----------------------------------------------------------------------------------------------------------------------------------------------------------------------
----------------------------------------------------------------------------------------------------------------------------------------------------------------------
-------------------------------------------------------------------------------#----------------------------------------##--#-----#-----------------------------------
-----------------------------tt------------------------------------------------##--------!-----------------------------###--##----##--!-------------------------SS----
-----------------------------tt------------------------------------------------###------------------------------------####--###---##----------------------------------
-----------------------------tt----------------##------------------------------####----------------------------------#####--####--##---------------------------g------
----------------------------!--!--------------###-------------#--#---------@----#####--------------@---------@----#####------#####--------------@---------------------
-------------------------t-------------------####------------##--##------------######--S@S!S---------------------######-----######--S@S!S--------------------S@S------
-------------------------t------------------#####-----------###--###----------#######---------------------------#######----#######------------------------------------
-M--gg------g-g----------t---------gg-########---g------tt-####--####--------########--------------------------########---########------------------------------------
XXXXXXXXXXXXXXXXXXXXXXXXXXXXXXXXXXXXXXXXXXXXXXXXXXXXXXXXXXXXXXXXXXXXXXXXXXXXXXXXXXXXXXX-XXXXXXXXXXXXXXXXXXXXXXXXXXXXXXXXX------------XXXXXXXXXXXXXXXXXXXXXXXXXXXXXXXXX
XXXXXXXXXXXXXXXXXXXXXXXXXXXXXXXXXXXXXXXXXXXXXXXXXXXXXXXXXXXXXXXXXXXXXXXXXXXXXXXXXXXXXXX-XXXXXXXXXXXXXXXXXXXXXXXXXXXXXXXXX------------XXXXXXXXXXXXXXXXXXXXXXXXXXXXXXXXX
