---------------------------------------------------------------------------------------------------------------------------------------------------------------------------
---------------------------------------------------------------------------------------------------------------------------------------------------------------------------
---------------------------------------------------------------------------------------------------------------------------------------------------------------------------
---------------------------------------------------------------------------------------------------------------------------------------------------------------------------
---------------------------------------------------------------------------------------------------------------------------------------------------------------------------
---------------------------------------------------------------------------------------------------------------------------------------------------------------------------
----------------------@----------------------------------------------------------------------------------------------------------------------------------------------------
------tt-------------------------------------------------------------------------------------------------------------------------------------------------------------------
------tt-------------------------------------------------------------------------------------------------------------------------------------------------------------------
------tt------------------------------------@------------------------------------------------------------------------------------------------------------------------------
-----!--!-------------!--!--------tt--------------------------------------------#-------##--#---------@---------@----------##--#----------##--#----------##--#----------##-
----------------------------------tt---------------------------------t---------##------###--##----------------------------###--##--------###--##--------###--##--------###-
----------------------------------tt---------------------------------t--------###-----####--###--------------------------####--###------####--###------####--###------####-
-M---------M-----gg----------g------tt-tt---------------g-g----------t-------####----#####--####------------------------#####--####----#####--####----#####--####----#####-
XXXXXXXXXXXXXXXXXXXXXXXXXXXXXXXXXXXXXXXXXXXXXXXXXXXXXXXXXXXXXXXXXXXXXXXXXXXXXXXXX-tt-------XXXXXXXXXXXXXXXXXXXXXXXXXXXXXXXX------------------XXXXXXXX----------------------
XXXXXXXXXXXXXXXXXXXXXXXXXXXXXXXXXXXXXXXXXXXXXXXXXXXXXXXXXXXXXXXXXXXXXXXXXXXXXXXXXXXXXXXX---XXXXXXXXXXXXXXXXXXXXXXXXXXXXXXXX--XXXXXXXXXX------XXXXXXXX--XXXXXXXXXX----------
