-----------------------------------------------------------------------------------------------------------------------------------------------------------------
-----------------------------------------------------------------------------------------------------------------------------------------------------------------
-------------------------------------------------------------------------tt----------------------------SS---SSS!-------------------------------------------------
-------------------------------------------------------------------------tt--------------------------------------------------S-----------------------------------
-------------------------------------------------------------------------tt-------#-------------------g----------------------------------------------------------
----------------------------------------@----------------------------#####-------##-----------------------------------------g------------------------------------
--------------------------------------------------------------!-----######--SU----!-----------------S@S--------C#--------------#---------------------------------
---------------------------------------------------------------------------------------------------------------##---------S@S--##--------------------------------
-----------------------------------------------------------------------------------------tt-------------------###-----#--------###------------------------------t
-----------------------------------###t-g--------g-g--t-g--------------g-g--------k-gg---tt#-------g------tt-####----##--------####-----------------------------t
---------------------------!--!---####XXXXXXXXXXXXXXXXXXXXXXXXXXXXXXXXXXXXXXXXXXXXXXXXXXXXXXXXXXXXXXXXXXXXXXXXX-g------ttt-g----tt----M-----------tt------------t
---------------------------------#####XXXXXXXXXXXXXXXXXXXXXXXXXXXXXXXXXXXXXXXXXXXXXXXXXXXXXXXXXXXXXXXXXXXXXXXXXXXXXXXXXXXXXXXXXXXXXXXXXXXXXXXXXXXXXXXXXXXXXXXXXXX
--------------------------------########-----------------------------------------------------------------------XXXXXXXXXXXXXXXXXXXXXXXXXXXXXXXXXXXXXXXXXXXXXXXXXX
-M------g-g--t-g------------------g-g-tt-------------------------------------------------------------------------------------------------------------------------
XXXXXXXXXXXXXXXXXXXXXXXXXXXXXXXXXXXXXXXXXXXXX--------------------------------------------------------------------------------------------------------------------
XXXXXXXXXXXXXXXXXXXXXXXXXXXXXXXXXXXXXXXXXXXXX--------------------------------------------------------------------------------------------------------------------
