---------------------g-----------------------------------------------------------------------------
---------------------------------------------------------------------------------------------------
-------------------S@S--------C-------tt---!-------------------------------------!-----------------
--------------------------------------tt-----------------------------------------------------------
--------------------------------------tt-----------------------------------------------------------
-----------##--#----#####---------#####------------------------------------------------------------
----------###--##--#####-----S!--######--S@S!S-------!-------------------------S@S!S---------------
---------####--##----------------------------------------------------------------------------------
--------#####--##----------------------------------------------------------------------------------
-----#####----XXX---------------------------#####-------------@-------------------#####------------
----######----XXX----tt--------------!-----!--!----S@S!S----------SU----!--!-----######----------#-
---#######-----------tt---------------------------------------------------------#######---------##-
--########-----------tt--------------------------------------------------------########--------###-
-M--g-------------tt----M--------------------------g------ttt-g---------k---------tt----M-----####-
XXXXX--XXXXXXXXXXXXXXXXXXXXXXXXXXXXXXXXXXXXXXXXXXXXXXXXXXXXXXXXXXXXXXXXXXXXXXXX--XXXXXXXXXXXXXXXXXX
XXXXX--XXXXXXXXXXXXXXXXXXXXXXXXXXXXXXXXXXXXXXXXXXXXXXXXXXXXXXXXXXXXXXXXXXXXXXXX--XXXXXXXXXXXXXXXXXX
