--------------------------------------------------------------------------------------------------------------------------####--
------------------------------------------------------------------------------------------g------------------------------#####--
-----------------------------------------------------------------------##--#------------------------------------###---#####-----
----------------------------------------------------------------------###--##S@S!S------S@S-----------!--!---SU------######-----
---------------------------------------------------------------------####--##---------------------------------------#######-----
--------------------------------------------------------------------#####--##--------------------------------------########-----
----------------#----------##--#--------------#------------------#####---t-g----tt-----g------tt------k------------k-g-g-tt-----
----------------##--------###--##------SS!S---##----------------######---XXXXXXXXXXXXXXXXXXXXXXXXXXXXXXXXXXXXXXXXXXXXXXXXXXXXXXX
----------------###------####--###------------###--------------#######---XXXXXXXXXXXXXXXXXXXXXXXXXXXXXXXXXXXXXXXXXXXXXXXXXXXXXXX
----------------####----#####--####-----------####------------########----------------------------------------------------------
-----!-------SU--SU----!---------------------g------tt--------t-g-g-tt----------------------------------------------------------
-----------------------------------XXXXXXXXXXXXXXXXXXXXXXXXXXXXXXXXXXXXXXXX-----------------------------------------------------
-----------------------------------XXXXXXXXXXXXXXXXXXXXXXXXXXXXXXXXXXXXXXXX-----------------------------------------------------
-M--------gg-----------k------------g-------------------------------------------------------------------------------------------
XXXXXXXXXXXXXXXXXXXXXXXXXXXXXXXXXXXXX-------------------------------------------------------------------------------------------
XXXXXXXXXXXXXXXXXXXXXXXXXXXXXXXXXXXXX-------------------------------------------------------------------------------------------
