----------------------------------------------------------------------------------------------------------------------------------------------------------------------------
----------------------------------------------------------------------------------------------------------------------------------------------------------------------------
----------------------------------------------------------------------------------------------------------------------------------------------------------------------------
----------------------------------------------------------------------------------------------------------------------------------------------------------------------------
----------------------------------------------------------------------------------------------------------##--#-------------------------------------------------------------
-----------------------------------------------------------------------@------------------!--------------###--##------------------------------------------------------------
------------------------------------------!-------------------------------------------------------------####--###-----------------------------------------------------------
-------------------------------------------------------------------------------------------------------#####--####----------------------------------------------------------
----------------------------------------------------------------------------------------------------#####------#####--------------------------------------------------------
---------------------------------------------------------##--#----###--!--!-------------S@S!S------######-----######------------------------------------------------#--#----
---------SU----!------------------------S@S!S-----------#SU------####-----------------------------#######----#######-----------------------------------------------##--##---
--------#-------------------------t--------------------##-------#####----------tt----------------########---########-------------tt--------------------------tt---###--###--
-------##-------------------------t--tt---------------###------######----------tt#-------g------tt-g-g-tt------tt---------g-g----tt#---------M---------------tt#-####--####-
-M-t-g---------k-----g-g----------t--tt#########---tt----------k-g-g-XXXXXXXXXXXXXXXXXXXXXXXXXXXXXXXXXXXXXXXXXXXXXXXXXXXXXXXXXXXXXXXXXXXX---XXXXXXXXXXX---XXXXXXXXXXXX------
XXXXXXXXXXXXXXXXXXXXXXXXXXXXXXXXXXXXXXXXXXXXXXXXXXXXXXXXXXXXXXXXXXXXXXXXXXXXXXXXXXXXXXXXXXXXXXXXXXXXXXXXXXXXXXXXXXXXXXXXXXXXXXXXXXXXXXXXX---XXXXXXXXXXX---XXXXXXXXXXXX------
XXXXXXXXXXXXXXXXXXXXXXXXXXXXXXXXXXXXXXXXXXXXXXXXXXXXXXXXXXXXXXXXXXXXXXXXXXXX------------------------------------------------------------------------------------------------
