-------------------------------------------------------------------------------------------------------------------------------------------------------------
-------------------------------------------------------------------------------------------------------------------------------------------------------------
----------------------------------------------------------------------------------------------------------------@---------@----------------------------------
-----------------SS---------------------------------------------------------------------------------tt-------------------------------------------------------
----------------------------------------------------------------------------------------------------tt-------------------------------------------------------
----------------g--------------------------------------------------------------------##--#----------tt-------------------------------------------------------
------------------------------@-----------------------------------------------------###--##--SU----!---------SU----!------!--!------#--#---------------------
--------------S@S------------------------------------------------------------------####--###---------------------------------------##--##--------------------
----------------------------------------------------------------------------------#####--####-------------------------------------###--###-------------------
---------------------#-----------------------##--------------------------------##------------------k---------------k-gg----------####--####------------------
------tt-------!--!--##-------!--!----------###-!------------------------##---###--XXXXXXXXXXXXXXXXXXXXXX---XXXXXXXXXXXXXXXXXXXXXXXXX########---gg-########--
------tt-------------###-------------------####----------#--------t-----###--####--XXXXXXXXXXXXXXXXXXXXXX---XXXXXXXXXXXXXXXXXXXXXXXXXXXXXXXXXXXXXXXXXXXXXXXXX
------tt-------------####-----------------#####---------##--------t----####-########-------------------------------------------------XXXXXXXXXXXXXXXXXXXXXXXX
-M--g------tt---------tt-------------g------tt------t-g-----------t-g------tt-g-g-tt-------------------------------------------------------------------------
XXXXXXXXXXXXXXXXXXXXXXXXXXXXXXXXXXXXXXXXXXXXXXXXXXXXXXXXXXXXXXXXXXXXXXXXXXXXXXXXXXXXXXXXX--------------------------------------------------------------------
XXXXXXXXXXXXXXXXXXXXXXXXXXXXXXXXXXXXXXXXXXXXXXXXXXXXXXXXXXXXXXXXXXXXXXXXXXXXXXXXXXXXXXXXX--------------------------------------------------------------------
