--------------------------------------------------------------------------------------------------------------------------------------------------------
--------------------------------------------------------------------------------------------------------------------------------------------------------
--------------------------------------------------------------------------------------------------------------------------------------------------------
--------------------------------------------!-----------------------------------------------------------------------------------------------------------
--------------------------------------------------------------------------------------------------------------------------------------------------------
--------------------------------------------------------------------------------------------------------------------------------------------------------
----------------------------------------------------------------------------------------------------------------------------------------------@---------
------------------------------------------S@S!S-------!-----------------##----!-------------------------------------------!-----------------------!-----
-----------------------------------------------------------------------###------------------------------------------------------------------------------
----------------------------------------------------------------------####------------------------------------------------------------------------------
-------#--#----------##--#----------##--#----#####--------------@----#####--------------@---------@---------@----#####--------------@----XXXXXXX--------
------##--##--------###--##--------###--##--######--S@S!S-----------######--S@S!S-------------------------------######--S@S!S-----------#XXXXXXXS@S!S---
-----###--###------####--###------####--##-#######-----------------#######-------------------------------------#######-----------------#######----------
-M--####--####----#####--####----#####--##########----------------########------------------------------------########----------------########----------
XXXXXXXSU----!----------XXXXXXXXXXXXX--XXXXXXXXXXXXX-XXXXXXXXXXXXXXXXXXXXXXX-XXXXXXXXXXXXXXXXXXXXXXXXXXXXXXXXXXXXXXXXXXX-XXXXXXXXXXXXXXXXXXXXXXX--------
XXXXXXX-----------------XXXXXXXXXXXXX--XXXXXXXXXXXXX-XXXXXXXXXXXXXXXXXXXXXXX-XXXXXXXXXXXXXXXXXXXXXXXXXXXXXXXXXXXXXXXXXXX-XXXXXXXXXXXXXXXXXXXXXXX--------
