---------------------------------------------------------------------------------------------------------------------------------------------------
---------------------------------------------------------------------------------------------------------------------------------------------------
---------------------------------------------------------------------------------------------------------------------------------------------------
---------------------------------------------------------------------------------------------------------------------------------------------------
---------------------------------------------------------------------------------------------------------------------------------------------------
---------------------------------------------------------------------------------------------------------------------------------------------------
-----------------------------------------------------------------------------------------------------------@---------------------------------g-----
-------------------------------------------------------------------------##----!--------------tt---------------------!---------------------SSSSSSSS
------------------------------------------------------------------------###-------------------tt---------------------------------------------------
-----------------------------------------------------------------------####-------------------tt------------------------------------------g--------
-------#--#---------@----------##--#----------##--#----------##--#----#####--------------@----#####---------#####---------------##--#--------------
------##--##------------------###--##--------###--##--------###--##--######--S@S!S-----------######--S@S!--######--S@S!S-------###--#---S@S--------
-----###--###----------------####--###------####--###------####--##-#######-----------------#######-------#######-------------####--#--------------
-M--####--####--------------#####--####----#####--####----#####--##########----------------########------########------------#####--#--------------
XXXXXXXXXXXXXXXXXXXXXXXXXXXXXXXX--XXXXXXXX---------SU----!------XXXXXXXXXXXXX-XXXXXXXXXXXXXXXXXXXXXXX-XXXXXXXXXXXXX-XXXXXXXXXXXXX--XXXXXXXXXXXXX---
XXXXXXXXXXXXXXXXXXXXXXXXXXXXXXXX--XXXXXXXX--XXXXXXX-------------XXXXXXXXXXXXX-XXXXXXXXXXXXXXXXXXXXXXX-XXXXXXXXXXXXX-XXXXXXXXXXXXX--XXXXXXXXXXXXX---
