----------------------------------------------------------------------------------------------------------------------------------------------------------------
-----------------------------------------------------------------------##--#-----#------------------------------------------------------------------------------
----------------------------------------------------------------------###--##----##----------------!---------------------------------!--------------------------
---------------------------------------------------------------------####--###---###----------------------------------------------------------------------------
--------------------------------------------------------------------#####--####--####---------------------------------------------------------------------------
----------------##------@--------------------------------#####---#####------#####--XXXX----@--------------------------------------#-----------------------------
---------------###--------------------------------------######--######-----######-SU-------------S@S!S------!--------------------##S@S!S------------------------
--------------####-------------------------------------#######-#######----#######-----------------------------------------------###------------------t----------
-------------#####-----------------------------tt-----################---########----------------------------------------------####------------------t----------
----------#####---t-g----tt---------g-g---gg---tt#t-g----tt-----g-g-tt------tt----------k########---tt-------------------########---g------tt--------t-----g-g--
---------######---XXXXXXXXXXXXXXXXXXXXXXXXXXXXXXXXXXXXXXXXXXXXXXXXXXXXXXXXXXXXXXXXXXXXXXXXXXXXXXXXXXXXXXXXXXXXXXXXXXX---XXXXXXXXXXXXXXXXXXXXXXXXXXXXXXXXXXXXXXXX
--------#######---XXXXXXXXXXXXXXXXXXXXXXXXXXXXXXXXXXXXXXXXXXXXXXXXXXXXXXXXXXXXXXXXXXXXXXXXXXXXXXXXXXXXXXXXXXXXXXXXXXX---XXXXXXXXXXXXXXXXXXXXXXXXXXXXXXXXXXXXXXXX
-------########-------------------------------------------------------------------------------------------------------------------------------------------------
-M-M-----g-g-tt-------------------------------------------------------------------------------------------------------------------------------------------------
XXXXXXXXXXXXXXXXXXXX--------------------------------------------------------------------------------------------------------------------------------------------
XXXXXXXXXXXXXXXXXXXX--------------------------------------------------------------------------------------------------------------------------------------------
