--------------------------------------------------------------------------------------------------------------------------------------------
------------------------------------------------------------------------------------@----------------------##--#----------##--#----------##-
------------------------------------------------------tt----!---------------------------------------------###--##--------###--##--SU----!##-
------------------------------------------------------tt-------------------------------------------------####--###------####--###--------##-
------------------------------------------------------tt------------------------------------------------#####--####----#####--####-------##-
------------------------------------------##--#----#####-----------------------#####-------------gg--tt---------------------t-g---------k---
------------------------------!----------###--##--######--S@S!S------tt-------######---XXXXX---XXXXXXXXXXXX-------XXXXXXXXXXXXXXXXXXXXXXX---
----------------------------------------####--##-#######-------------tt------#######---XXXXX---XXXXXXXXXXXX-------XXXXXXXXXXXXXXXXXXXXXXX---
---------------------------------------#####--##########-------------tt-----########---------------------------F----------------------------
------------------------------------#####----XXXXXX----------tt-------------########-------g-g-----------------#----------------------------
----------------------------S@S!S--######----XXXXXXXXXXX---XXXXXXXXXXXXX---XXXXXXXXXXXXXXXXXXXXXXXXXX---XXXXXXXXXX--------------------------
----------------------------------#######----------XXXXX---XXXXXXXXXXXXX---XXXXXXXXXXXXXXXXXXXXXXXXXX---XXXXXXXXXX--------------------------
-------------------------tt------########---------------------------------------------------------------------------------------------------
-M------g-g--########--------------g-g-tt---------------------------------------------------------------------------------------------------
XXXXXXXXXXXXXXXXXXXXXX--XXXXXXXXXXXXXXXXXXXXXX----------------------------------------------------------------------------------------------
XXXXXXXXXXXXXXXXXXXXXX--XXXXXXXXXXXXXXXXXXXXXX----------------------------------------------------------------------------------------------
