-------------------------------------------------------------------------------------------------------------------------------------------------------
-------------------------------------------------------------------------------------------------------------------------------------------------------
-------------------------------------------------------------------------------------------------------------------------------------------------------
-----------------------------------------------------SS---SSS!-----------------------------------------------------------------------------------------
-------------------------------------------------------------------------------------------------------------------------------------------------------
----------------------------------------------------g--------------------------------------------------------------------------------------------------
----------!-------##----!------------------------------------------------------------------------------------------------------------@-----------------
-----------------###------------------------------S@S--------C-----------------------------------------------------------------------------------------
----------------####-----------------------------------------------------------------------------------------------------------------------------------
---------------#####---------------##--#----------------------@----------------------------------------------------------------------------------------
--------S@S!--######--S@S!S-------###--##------SU----!------------!-------------#--#---------@----------##--#----------##--#----###--!--!----------!---
-------------#######-------------####--###-------------------------------------##--##------------------###--##--------###--##--####--------------------
-----tt-----########------------#####--####-----------------------------------###--###----------------####--###------####--##-#####--------------------
-M---tt#-XXXXXXXXXXXXX-XXXXXXXXXXXXX--g------tt------k########---------------####--####--------------#####--####----#####--########--------t-g---------
XXXXXXXX-XXXXXXXXXXXXX-XXXXXXXXXXXXX-XXXXXXXXXXXXXXXXXXXXXXXXXXXXXXXXXXXXXXXXXXXXXXXXXXXXXXXXXXXXXXXXXXXXSU----XXXXXXXXXXXXXXXXXXXXXXXXXXXXXXXXXXXXXXXX
XXXXXXXX-----------------------------XXXXXXXXXXXXXXXXXXXXXXXXXXXXXXXXXXXXXXXXXXXXXXXXXXXXXXXXXXXXXXXXXXXX------XXXXXXXXXXXXXXXXXXXXXXXXXXXXXXXXXXXXXXXX
