--------------------------------------------------------------------------------------------------------------------------------------------------------
--------------------------------------------------------------------------------------------------------------------------------------------------------
--------------------------------------------------------------------------------------------------------------------------------------------------------
-------------------------------------------------------------------------!------------------------------------------------------------------------------
--------------------------------------------------------------------------------------------------------------------------------------------------------
--------------------------------------------------------------------------------------------------------------------------------------------------------
--------------------------------------------------------------------------------------------------------------------------------------------------g-----
-----------------------------------------------------------------------S@S!S-------!------------------------------------------------------------SSSSSSSS
--------------------------------------------------------------------------------------------------------------------------------------------------------
-----------------------------------------------------------------------------------------------------------------------------------------------g--------
----------------#--#----------##--#----------##--#---------@---------@----#####---------------##--#----------##--#----------##--#-----------------------
---------------##--##--------###--##--------###--##----------------------######--S@S!S-------###--##--------###--##--------###--##-----------S@S--------
--------------###--###------####--###------####--###--------------------#######-------------####--###------####--###------####--###---------------------
-M-----------####--####----#####--####----#####--####------------------########------------#####--####----#####--####----#####--####--------------------
XXXXXXXX---XXXXXXXXXXXXXXX-------XXXXXXXXXXXXX--XXXXXXXXXXXXXXXXXXXXXXXXXXXXXXXXX-XXXXXXXXXXXXX-t-g-########--SU----!------------XXXXXXXXXXXXXXXXXXXXX--
XXXXXXXX---XXXXXXXXXXXXXXX--XXXXXXXXXXXXXXXXXX--XXXXXXXXXXXXXXXXXXXXXXXXXXXXXXXXX-XXXXXXXXXXXXX-XXXXXXXXXXXXXX----------XXXXX---XXXXXXXXXXXXXXXXXXXXXX--
