-------------tt-----------------------------------------------
-t-g----g------tt---------#####-------------------------------
-XXXXXXXXXXXXXXXXXXXXXX--######----!---S@S!S-------!----------
-XXXXXXXXXXXXXXXXXXXXXX-#######-------------------------------
-----------------------########-------------------------------
------------------------g------tt---------#####---------------
-----------------------XXXXXXXXXXXXXXXX--######--S@S!S--------
-----------------------XXXXXXXXXXXXXXXX-#######---------------
---------------------------------------########---------------
--------------------#------------------t-g----tt----#####-----
--------------!-----##-----------------XXXXXXXXXXXXX#####-----
--------------------###---------------#XXXXXXXXXXXXX#####-----
--------------------####-------------#####-------########-----
-M--gg-M----------t-g-------------tt----########---g-g-tt-----
XXXXXXXXXXXXXXXXXXXXXXXXXXXXX---XXXXXXXXXXXXXXXXXXXXXXXXXXXXXX
XXXXXXXXXXXXXXXXXXXXXXXXXXXXX---XXXXXXXXXXXXXXXXXXXXXXXXXXXXXX
