-------------------------------------------------------------------------------------------------------tt-------------------------------
----------------------------------------------------------------------------------------gg--g------tt--tt#---#####----------------------
------------------------------------------------------------------------------XXXXX---XXXXXXXXXXXXXXXXXXXX--######--S@S!S---------------
------------------------------------------------------------------------------XXXXX---XXXXXXXXXXXXXXXXXXXX-#######----------------------
----------------------------------------------------------------------------------------------------------########----------------------
-------@-------------------------------------------------------------@-------------------------------------------------#####------------
-----------------------------------------------@--------------------------------tt-------------!--------------!--!----######------------
--------------------------------------------------------------------------------tt-----------------------------------#######------------
--------------------------------------------------------------------------------tt----------------------------------########------------
--------#####---------#####-------#-----------------------------###t-g---########-------g-g--------------------------g------tt---------g
-------######--------######-------##-----------!--!------------####XXXXXXXXXXXXXXXXXXXXXXXXXXXXXXXXXXXXX---XXXXXXXXXXXXXXXXXXXXXXXXXXXXX
------#######-------#######-------###-------------------------#####XXXXXXXXXXXXXXXXXXXXXXXXXXXXXXXXXXXXX---XXXXXXXXXXXXXXXXXXXXXXXXXXXXX
-----########------########----tt-####-----------------------########-------------------------------------------------------------------
-M--tt--------------g------tt--tt#-tt-----gg-----------------t-g-g-tt-------------------------------------------------------------------
XXXXXXXXXXXXXXX---XXXXXXXXXXXXXXXXXXXXXXXXXXXXXXXXXXXXXXXXXXXXXXXXXXXXXXXX--------------------------------------------------------------
XXXXXXXXXXXXXXX---XXXXXXXXXXXXXXXXXXXXXXXXXXXXXXXXXXXXXXXXXXXXXXXXXXXXXXXX--------------------------------------------------------------
