----------------------------------------------------------------------------------------------------------------------------------------------------------------
----------------------------------------------------------------------------------------------------------------------------------------------------------------
----------------------------------------------------------------------------------------------------------------------------##--#---------@---------------------
---------------------------------------------------------------------------------------------------------------------------###--##------------------------------
--------------------------------------------------------------------------------------------------------------------------####--###-----------------------------
-------------------------------------------------------------------------------------------------------------------------#####--####----------------------------
------------------------------------------------------------------------------##--#----------##--#--------------#-----#####----XXXXXXXXXXX-tt-------------------
-----------------------------------------------------------------------------###--##--------###--##-------------##---######----XXXXXXXXXXXXXXXXXXXXXXX---XXXXXXX
----------------------------------------------------------------------------####--###------####--###------------###-#######---------------XXXXXXXXXXXX---XXXXXXX
--------------------------------------------#------------------------------#####--####----#####--####-----------###########-------------------------------------
--------------------------------------------##---------#-------##--#----#####----XXXXXXXX------------M-----gg-t-g----g-g-tt-------------------------------------
--------------------------------------------###-------##------###--##--######----XXXXXXXX--XXXXXXXXXXXXXXXXXXXXXXXXXXXXXXXXXXXXX--------------------------------
--------------------------------------------####-----###-----####--##-#######--------------XXXXXXXXXXXXXXXXXXXXXXXXXXXXXXXXXXXXX--------------------------------
-M------g-g--t-g--------g-g---gg-t-g---M-----tt-----####----#####--##########--------F--------------------------------------------------------------------------
XXXXXXXXXXXXXXXXXXXXXXXXXXXXXXXXXXXXXXXXXXXXXXXXXXXXXXt-g---------XXXXXXXXXXXXX------#--------------------------------------------------------------------------
XXXXXXXXXXXXXXXXXXXXXXXXXXXXXXXXXXXXXXXXXXXXXXXXXXXXXXXXXXXX------XXXXXXXXXXXXXXXXXXXXXX------------------------------------------------------------------------
