--------------------------------------------------------------------------------------------------------------------------------------------------------
--------------------------------------------------------------------------------------------------------------------------------------------------------
--------------------------------------------------------------------------------------------------------------------------------------------------------
----------------------------------------------------------------------------------SS-----------SS--------------------------------------SS-------SS------
--------------------------------------------------------------------------------------------------------------------------------------------------------
---------------------------------------------------------------------------------g------------g---------------------------------------g--------g--------
------------------------------------------------------------------------------------------------------------------##--#---------------------------------
-------------------------------------------------------------------------------S@S----------S@S--------!---------###--##--------#---S@S------S@S--------
----------------------------------------------------------------------------------------------------------------####--###------##-----------------------
---------------------------------------------------------------------------------------------------------------#####--####----###-----------------------
---------------tt---------------#--#----------##--#----------##--#---------@----#####---------#####---------#####--------g------tt########---g-g-tt-----
---------------tt--------------##--##--------###--##--------###--##------------######--S@S!--######--S@S!--######-------XXXXXXXXXXXXXXXXXXXXXXXXXXXXXXXX
---------------tt-------------###--###------####--###------####--###----------#######-------#######-------#######-------XXXXXXXXXXXXXXXXXXXXXXXXXXXXXXXX
-M-----------g------tt-------####--####----#####--####----#####--####--------########------########------########--------F------------------------------
XXXXXXXX---XXXXXXXXXXXXXXXXXXXXXXXXXXXXXXXXXXXX-----t-g---------XXXXXXXXXXXXXXXXXXXXXXX-XXXXXXXXXXXXX-XXXXXXXXXXXXX------#------------------------------
XXXXXXXX---XXXXXXXXXXXXXXXXXXXXXXXXXXXXXXXXXXXX-----XXXXXX------XXXXXXXXXXXXXXXXXXXXXXX-XXXXXXXXXXXXX-XXXXXXXXXXXXXXXXXXXXXX----------------------------
