---------------------------------------------------------------------------------------------------------------------------------------------------
---------------------------------------------------------------------------------------------------------------------------------------------------
---------------------------------------------------------------------------------------------------------------------------------------------------
-----------------------------------------------------------------------------------------------SS---SSS!-------------------------------------------
---------------------------------------------------------------------------------------------------------------------------------------------------
----------------------------------------------------------------------------------------------g----------------------------------------------------
---------------------------!-----------------------------------------------------------------------------------------------------##--#----------##-
--------------------------------------------------------------------------------------------S@S--------!------------------------###--##--------###-
-------------------------------------------------------------------------------------------------------------------------------####--###------####-
------------------------------------------------------------------------------------------------------------------------------#####--####----#####-
---------------------!-----!--!------#-------##--#---------@----------##--#----------##--#----#####---------------##--#----#####--------g------tt--
------------------------------------##------###--##------------------###--##--------###--##--######--S@S!S-------###--##--######-------XXXXXXXXXX--
-----------------------------------###-----####--###----------------####--###------####--##-#######-------------####--##-#######-------XXXXXXXXXX--
-M------g-g--t-g------------------####----#####--####--------------#####--####----#####--##########------------#####--##########--------F----------
XXXXXXXXXXXXXXXXXXXXXXXXXXXXXXXXXXXSU----!------XXXXXXXXXXXXXXXXXX-------------#####----XXXXXXXXXXXXX-XXXXXXXXXXXXX--XXXXXXXXXXXXX------#----------
XXXXXXXXXXXXXXXXXXXXXXXXXXXXXXXXXXX-------------XXXXXXXXXXXXXXXXXX--XXXXXXXX--######----XXXXXXXXXXXXX-XXXXXXXXXXXXX--XXXXXXXXXXXXXXXXXXXXXX--------
