--------------------------------------------------------------------------------------------------------------------------------------------------------------------------------------------
--------------------------------------------------------------------------------------------------------------------------------------------------------------------------------------------
--------------------------------------------------------------------------------------------------------------------------------------------------------------------------------------------
--------------------------------------------------------------------------------------------------------------------------------------------------------------------------------SS----------
--------------------------------------------------------------------------------------------------------------------------------------------------------------------------------------------
------------------------------------------------------------------------------------------------------------------------------------------------##--#----#####-----------------g------------
-----------------------------------------------------------------------------------------------------------------------------------------------###--##--######------------------------------
---------------------tt-----------------------------------------------------------------------------------------------------------------------####--##-#######---------------S@S------------
---------------------tt----------------------------------------------------------------------------------------------------------------------#####--##########--#---------------------------
---------------------tt-----------------------@-------------------------------------------------------------------------------------------#####----XXXXXXXXXXXXX##--------------------------
-------------SU---t-----------------------------------------!-----------------------------------------------------!--!-------------------######----XXXXXXXXXXXXX-!-----------!--!-----------
------------------XX--------t-----------------------------------------------------------------------------------------------------------#######---------------------------t-----------------
------------------XX--------t--tt-------------------------------------------tt------------------------------------------------------tt-########---------------------------t--------------F--
-M------g-g--------k--------t--tt#-----g-g--########---gg------------g-g----tt#-------------------------gg-M-----------------g-g----tt#########-------g-g--------k--------t--------------#--
XXXXXXXXXXXXXXXXXXXXXXXXXXXXXXXXXXXXXXXXXXXXXXXXXXXXXXXXXXXXXXXXXXXXXXXXXXXXXXXXXXXX---XXXXXXXXXXXX---XXXXXXXXXXXXXXXXXXXXXXXXXXXXXXXXXXXXXXXXXXXXXXXXXXXXXXXXXXXXXXXXXXXXXXXXXXXXXXXXXXXXXX
XXXXXXXXXXXXXXXXXXXXXXXXXXXXXXXXXXXXXXXXXXXXXXXXXXXXXXXXXXXXXXXXXXXXXXXXXXXXXXXXXXXX---XXXXXXXXXXXX---XXXXXXXXXXXXXXXXXXXXXXXXXXXXXXXXXXXXXXXXXXXXXXXXXXXXXXXXXXXXXXXXXXXXXXXXXXXXXXXXXXXXXX
