----------------------------------------------------------------------------------------------------------------------------------------------------------------
----------------------------------------------------------------------------------------------------------------------------------------------------------------
-----------------------------------------------------------------------------------------!----------------------------------------------------------------------
----------------------------------------------------------------------------------------------------------------------------------------------------------------
----------------------------------------------------------------------------------------------------------------------------------------------------------------
-------------------------##--#----------------------------------------------------------------------------------------------------------------------------------
------------------------###--##-----------!--------------------------------------------S@S!S--------------------------------------------------------------------
-----------------------####--###-----------------------------------------------------------------------tt-------------------------------------------------------
----------------------#####--####----------------------------------------------------------------------tt-------------------------------------------------------
-------------------#####-----XXXXXX-------------------------------------------------------#####--------tt-------------------------------------------------------
-----!--!---------######-----XXXXXX-----S@S!S-------------------------------#-----#------######-------!--!----------------#--#----------##--#----------##--#----
-----------------#######---------------------------------------------t-----##-----##----#######--------------------------##--##--------###--##--------###--##---
-------------tt-########----------------------------------tt---------t----###-----###--########-------------------------###--###------####--###------####--###--
-M-----------tt#-g------tt---------M----########----------tt#--------t-tt----M--g------tt-tt-----gg--------------g-g---####--####----#####--####----#####--####-
XXXXXXXXXXXXXXXXXXXXXXXXXXXXXXX---XXXXXXXXXXXXXXXXXXXXXXXXXXXXXXXXXXXXXXXXXXXXXXXXXXXXXXXXXXXXXXXXXXXXXXXXXXXXXXXXXXXXXXXXSU------#####------SU----!------------
XXXXXXXXXXXXXXXXXXXXXXXXXXXXXXX---XXXXXXXXXXXXXXXXXXXXXXXXXXXXXXXXXXXXXXXXXXXXXXXXXXXXXXXXXXXXXXXXXXXXXXXXXXXXXXXXXXXXXXXX-------######-------------------------
