-------------------------------------------------------------------------------------------------------------------------------------------------------------
-------------------------------------------------------------------------------------------------------------------------------------------------------------
-------------------------------------------------------------------------------------------------------------------------------------------------------------
--------------------------------SS---SSS!------------------------!-------------------------------------------------------------------------------------------
-------------------------------------------------------------------------------------------------------------------------------------------------------------
----------g-------------g------g-----------------------------------------------------------------------------------------------------------------------------
--------SSSSSSSS------SSSSSSSS----------------------------------------------------------------------------------------#----------##--#----------##-----------
------------------------------@S--------C----------------------S@S!S--------------------------------------------------##--------###--##--------#SU----!------
-------g-------------g------------------------------------------------------------------------------------------------###------####--###------##-------------
--------------------------------------------------------------------------------------------------------@-------------####----#####--####----###-------------
-----S@S-----------S@S----------!-----------------------------SU----!--------------------#--!----------------------SU----!----------------tt----------kt-g---
--------------------------------------------------------t--------------------t----------##-------------------------------------XXXXXXXXXXXXXXXXXXXXXXXXXXXXXX
--------------------------------------------------------t--tt----------------t---------###-------------------------------------XXXXXXXXXXXXXXXXXXXXXXXXXXXXXX
-M-########---gg--g------tt------------------gg---------t--tt#------k--------tM-----tt-----------g------tt---------------k---------g-------------------------
XXXXXXXXXXXXXXXXXXXXXXXXXXXXXXXXXXXXXXXX---XXXXXXXXXXXXXXXXXXXXXXXXXXXXXXXXXXXXXXXXXXXXXXXXXXXXXXXXXXXXXXXXXXXX---XXXXXXXXXXXXXXXXXX-------------------------
XXXXXXXXXXXXXXXXXXXXXXXXXXXXXXXXXXXXXXXX---XXXXXXXXXXXXXXXXXXXXXXXXXXXXXXXXXXXXXXXXXXXXXXXXXXXXXXXXXXXXXXXXXXXX---XXXXXXXXXXXXXXXXXX-------------------------
