---------------------------------------------------------------------------------------------------------------------------------------------------------------------
---------------------------------------------------------------------------------------------------------------------------------------------------------------------
----------------------------------------------------------SS------------------------------------------------------------------------------------------------##--#----
----------------------------------------------------------------------------------------------------------------------------------------!------------------###--##---
---------------------------------------------------------g------------------------------------------------------------------------------------------------####--###--
-------------------------------@-------------------------------------------------------------------------------------------------------------------------#####--####-
-------------------------------------------------------S@S----------------------!--!------#-------##--#----------##-----------------------------------#####----------
---------------------------------------------------#-------------------------------------##------###--##--------###-------------------S@S!S----------######----------
--------------------------------------------------##------------------------------------###-----####--###------####---------------------------------#######----------
-----------------------------------------M----########---tt----t-g----gg-M-------------####----#####--####----#####--tt-#--------------------------########----------
-------------------------XXXXXXXXXXXXXXXXXXXXXXXXXXXXXXXXXXXXXXXXXXXXXXXXXXXXXXXXXXXXXXXXX-g-g-tt----XXXXXXXXXXXXX---tt#---------########------------g-g-tt----------
-------------------------XXXXXXXXXXXXXXXXXXXXXXXXXXXXXXXXXXXXXXXXXXXXXXXXXXXXXXXXXXXXXXXXXXXXXXXXXXXXXXXXXXXXXXXXX-XXXXXXXXXX---XXXXXXXXXXXXXXXX---XXXXXXXXXXXXX-----
-----------------------########-----------------------------------------------------------XXXXXXXXXXXX-------------XXXXXXXXXX---XXXXXXXXXXXXXXXX---XXXXXXXXXXXXX-----
-M-------M---------g-g---g-g-tt--------------------------------------------------------------------------------------------------------------------------------------
XXXXXXXXXXXXXXXXXXXXXXXXXXXXXXXXXXXX---------------------------------------------------------------------------------------------------------------------------------
XXXXXXXXXXXXXXXXXXXXXXXXXXXXXXXXXXXX---------------------------------------------------------------------------------------------------------------------------------
