-----------------------------------------------------------------------------------------------------------------------------------------------------
-----------------------------------------------------------------------------------------------------------------------------------------------------
-----------------------------------------------------------------------------------------------------------------------------------@-----------------
-----------------------------------------------------------------------------------------------------------------------------------------------------
-----------------------------------------------------------------------------------------------------------------------------------------------------
-----------------------------------------------------------------------------------------------------------------------------------------------------
-------------------------------------------------------------------------------------------------##--#----------##--#---------#####------------t-g---
--------------------------------------------------------------------------------tt----!---------###--##--------###--##-------######---XXXXX---XXXXXXX
--------------------------------------------------------------------------------tt-------------####--###------####--###-----#######---XXXXX---XXXXXXX
--------------------------------------------------------------------------------tt------------#####--####----#####--####---########------------------
---SU----!----#--#----------##--#----------##--#---------@----------##--#----#####---------#####--------########---g------tt-g-g-tt------------------
-------------##--##--------###--##--------###--##------------------###--##--######--S@S!--######--------XXXXXXXXXXXXXXXXXXXXXXXXXXXXXXXX-------------
------------###--###------####--###------####--###----------------####--##-#######-------#######--------XXXXXXXXXXXXXXXXXXXXXXXXXXXXXXXX-------------
-M-------k-####--####----#####--####----#####--####--------------#####--##########------########--------F--------------------------------------------
XXXXXXXXXXXXXXXXXXXXXXXXXXXXXSUXXXXXXXXXXXXX--XXXXXXXXXXXXXXXXXXXXXXX--XXXXXXXXXXXXX-XXXXXXXXXXXXX------#--------------------------------------------
XXXXXXXXXXXXXXXXXXXXXXXXXXXXX--XXXXXXXXXXXXX--XXXXXXXXXXXXXXXXXXXXXXX--XXXXXXXXXXXXX-XXXXXXXXXXXXXXXXXXXXXX------------------------------------------
