-------------------------------------------------------------------------------------------------------------------------------------------------------------
-------------------------------------------------------------------------------------------------------------------------------------------------------------
-------------------------------------------------------------------------------------------------------------------------------------------------------------
-------------------------------------------------------------------------------------------------------------------------------------------------------------
-------------------------------------------------------------------------------------------------------------------------------------------------------------
-------------------------------------------------------------------------------------------------------------------------------------------------------------
---------------------------------------------------------------------@---------------------------------------------------------------------------------------
-------------------------------------------------------------------------!-----------------------------------------------------------------------------------
-------------------------------------------------------------------------------------------------------------------------------------------------------------
-------------------------------------------------------------------------------------------------------------------------------------------------------------
-------#-------##--#---------@----------##--#----------##--#----#####--------------@----------##--#----------##--#----------##--#----------##--#----------##-
------##------###--##------------------###--##--------###--##--######--S@S!S-----------------###--##--------###--##--------###--##--------###--##--------###-
-----###-----####--###----------------####--###------####--##-#######-----------------------####--###------####--###------####--###------####--###------####-
-M--####----#####--####--------------#####--####----#####--##########----------------------#####--####----#####--####----#####--####----#####--####----#####-
XXXXXXXXX---------XXXXXXXXXXXXXXXXXX-------------tt-------XXXXXXXXXXXXX-XXXXXXXXXXXXXXXXXXXXXXX--XXXXXXXX----------########---t-g-########----XXXXXXXXXXXXX--
XXXXXXXXX---------XXXXXXXXXXXXXXXXXX--XXXXXXXXXXXXXXXXX---XXXXXXXXXXXXX-XXXXXXXXXXXXXXXXXXXXXXX--XXXXXXXX--XXXXXXXXXXXXXXXXXX-XXXXXXXXXXXXXX--XXXXXXXXXXXXX--
