----------------------------------------------------------------------------------------------------------------------------------####--###---------
---------------------------------------------------------------------------------------------------------------------------------#####--####--------
------------------------------------------------------------------------------------------------------------------------------#####-----g-g-tt------
------------------------------------------------------SS---------------------------------------------------------------------######----XXXXXXXXXXXX-
----------------------------------------------------------------------------------------------------------------------------#######----XXXXXXXXXXXX-
-----------------------------------------------------g-----------g------------------------##--#-----------#--#-------------########-----------------
---------------------------------------------------------------SSSSSSSS------------------###--##----------#--##-------!---SU----!-------------------
---------------------------------------------------S@S----------------------------------####--###---------#--###-------------------------t----------
--------------------------------------------------------------g------------------------#####--####--------#--####------------------------t----------
-------------#####------------------------------------------------------------------#####-------t-g----gg-########--------------k--------t---------g
------------######---!----------tt-----------------!--!-----S@S------------!--!----######-------XXXXXXXXXXXXXXXXXXXXXXXXXXXXXXXXXXXXXXXXXXXXXXXXXXXX
-----------#######--------------tt------------------------------------------------#######-------XXXXXXXXXXXXXXXXXXXXXXXXXXXXXXXXXXXXXXXXXXXXXXXXXXXX
----------########--------------tt-----------------------------------------------########--------F--------------------------------------------------
-M-----------tt----------t-g----tt----------M-------------tt---------------------########--------#--------------------------------------------------
XXXXXXXX---XXXXXXXXXXXXXXXXXXXXXXXXXXXXXXXXXXXXXXXXXXXXXXXXXXXXXXXXXX---XXXXXXXXXXXXXXXXXXXXXXXXXXXX------------------------------------------------
XXXXXXXX---XXXXXXXXXXXXXXXXXXXXXXXXXXXXXXXXXXXXXXXXXXXXXXXXXXXXXXXXXX---XXXXXXXXXXXXXXXXXXXXXXXXXXXX------------------------------------------------
