-----------------------------------------------------------------------------------------------------------------------------------------------------------
-----------------------------------------------------------------------------------------------------------------------------------------------------------
-----------------------------------------------------------------------------------------------------------------------------------------------------------
-----------------------------------------------------------------------------------------------------------------------------------------------------------
-----------------------------------------------------------------------------------------------------------------------------------------------------------
--------------------------------------------------------------------------------------------------------------@--------------------------------------------
--------S--!-----------------------------@--------------------------@-----------------------------------------------------#-------##--#--------------------
-----------------------------------------------------------------------------------------tt------------------------------##------##--!---------------------
-------g---------------------------------------------------------------------------------tt-----------------------------###-----###------------------------
---------------------@-----@---------------------------@------------------------@--------tt--------------###########---####----####------------------------
-----S@S-S@S!S---------------------------!--!-----------------------!--!----------------!--!------------####XXXXXXXXXXXXX---#####--------------@-----------
-------------------------------------------------------------------------------------------------------#####XXXXXXXXXXXXX--######--S@S!S-------------------
------------------------------------------------------------------------------------t-----------------########------------#######--------------------------
-M-t-g----g------ttt-g---########---gg----------g------tt------------------tt------tt#------------------g-g-tt-----------########--------------------------
XXXXXXXXXXXXXXXXXXXXXXXXXXXXXXXXXXXXXXXXXXXXXXXXXXXXXXXXXXXXXX---XXXXXXXXXXXXXXXXXXXXXXXXXXXXXXXXXX---XXXXXXXXXXXXX-----------------XXXXXXXXXXXXXXXXXXXXXXX
XXXXXXXXXXXXXXXXXXXXXXXXXXXXXXXXXXXXXXXXXXXXXXXXXXXXXXXXXXXXXX---XXXXXXXXXXXXXXXXXXXXXXXXXXXXXXXXXX---XXXXXXXXXXXXX-----------------XXXXXXXXXXXXXXXXXXXXXXX
