-------------------####--###------------#######----------------------------------------------------t----------
------------------#####--####----------########------------------------###t-g----gg--tt------------t-----g-g--
---------------#####-----------------------!----SU----!--------!--!---####XXXXXXXXXXXXXXXXXXXXXXXXXXXXXXXXXXXX
--------------######---XXXXXXXXXXXXXXXX------------------------------#####XXXXXXXXXXXXXXXXXXXXXXXXXXXXXXXXXXXX
-------------#######---XXXXXXXXXXXXXXXX-----------------------------########----------------------------------
------------########----------------------------------kt-g------------g-g-tt----------------------------------
-----------SU----!------tt-----------!---S@S!S--XXXXXXXXXXXXXXXXXXXXXXXXXXXXXXXXX-----------------------------
------------------------tt----------------------XXXXXXXXXXXXXXXXXXXXXXXXXXXXXXXXX-----------------------------
------------------------tt------------------------------------------------------------------------------------
-----------------k-g-g-tt-------------------#####-------------------------------------------------------------
-----!-----XXXXXXXXXXXXXXXXXXXX---XXXXXXX--######-------------------------------------------------------------
-----------XXXXXXXXXXXXXXXXXXXX---XXXXXXX-#######-------------------------------------------------------------
------------------------------tt---------########-------------------------------------------------------------
-M----------tt---------g-g----tt#----------g-g-tt-------------------------------------------------------------
XXXXXXXXXXXXXXXXXXXXXXXXXXXXXXXXXXXXXX---XXXXXXXXXXXXX--------------------------------------------------------
XXXXXXXXXXXXXXXXXXXXXXXXXXXXXXXXXXXXXX---XXXXXXXXXXXXX--------------------------------------------------------
