-----------------------------------------------------------------------------------------------------------------------------------------------------------
-----------------------------------------------------------------------------------------------------------------------------------------------------------
-----------------------------------------------------------------------------------------------------------------------------------------------------------
-----------------------------------------------------------------------------------------------------------------------------------------------------------
-----------------------------------------------------------------------------------------------------------------------------------------------------------
-----------------------------------------------------------------------------------------------------------------------------------------------------------
-----SS--------SS---------------------------------------------------------------------------------------------!--------------------------------------------
-----------------------------------------------------------------------------------------------------------------------------------------------------------
----g---------g--------------------------------------------------------------------------------------------------------------------------------------------
------------------------------------------------------------###----------@---------@-------------------------------------------------------#---------------
--S@S-------S@S-------!--!-----------SU----g--!---------------!--!--------------------------------------------S!S----SU----!---------------##--------------
------------------------------------------XX-----------------------------------------------------------------------------------------------###-------------
------------------------------------------XX--------tt-------------------------------------------------------------------------------------####------------
-M--tt-----g------tt---------gg-M----------k--------tt#M------------M-----tt-------------M-----gg-M------------tt----------k----------------tt-------------
XXXXXXXXXXXXXXXXXXXXXXXXXXXXXXXXXXXXXXXXXXXXXXXXXXXXXXXXXXXXXXXXXXXXXXXXXXXXXXXXXXXXX---XXXXXXXXXXXXXXXXXXXXXXXXXXXXXXXXXXXXXXXXXXXXXXX---XXXXXXXXXXXXX---X
XXXXXXXXXXXXXXXXXXXXXXXXXXXXXXXXXXXXXXXXXXXXXXXXXXXXXXXXXXXXXXXXXXXXXXXXXXXXXXXXXXXXX---XXXXXXXXXXXXXXXXXXXXXXXXXXXXXXXXXXXXXXXXXXXXXXX---XXXXXXXXXXXXX---X
