----------------------------------------------------------------------------------------------------------------------------------------------
----------------------------------------------------------------------------------------------------SS!S----------SU----!----------S@S--------
------------------------------------------------------------------------------------------------#---------------------------------------------
-----------------------------------------------------------------------------------------------##--------#-----------------tt-----------------
-------------------------------------------------------------------------------##--#--------#####-----------------------k--tt#-gg--g-g-tt-----
----------------------------------------------##--#-----#---------------------###--##------######XXXXXXXXXXXXX---XXXXXXXXXXXXXXXXXXXXXXXXXXXXX
---------------------------------------------###--##----##-------------------####--###----#######XXXXXXXXXXXXX---XXXXXXXXXXXXXXXXXXXXXXXXXXXXX
--------------------------------------------####--###---###-----------------#####--####--########---------------------------------------------
-------------------------------------------#####--####--####-------------#####------tt-----g-g-tt---------------------------------------------
---------@------------------------------#####--SU----!--XXXXX-----------######-----XXXXXXXXXXXXXXXXXXX----------------------------------------
----------------------------------##----#####-----------XXXXX----------#######-----XXXXXXXXXXXXXXXXXXX----------------------------------------
---------------------------t-----###----#####----------------------tt-########----------------------------------------------------------------
---------------------------t----####----#####--------k-tt-----gg---tt#-g------tt---------g----------------------------------------------------
-M--tt----M-----gg---------t-g------tt-g-g-tt--XXXXXXXXXXXXXXXXXXXXXXXXXXXXXXXXXXXXXXXXXXX----------------------------------------------------
XXXXXXXXXXXXXXXXXXXXXXXXXXXXXXXXXXXXXXXXXXXXXXXXXXXXXXXXXXXXXXXXXXXXXXXXXXXXXXXXXXXXXXXXXX----------------------------------------------------
XXXXXXXXXXXXXXXXXXXXXXXXXXXXXXXXXXXXXXXXXXXXXXXXXX--------------------------------------------------------------------------------------------
