------------------------------------------------------------------------------------------------------S@S!S-----------------------------------####--###----------------------
---------------------------------------------##--#-------------------------------------------------------------------------------------------#####--####---------------------
--------------------------------------------###--##-------!-------------#-------##------------------##------------------------------------#####---########--------k########--
-------------------------------------------------###-------------------##------###-----------------###-----!-----------------------------######---XXXXXXXXXXXXXXXXXXXXXXXXXXX
-------------------------------------------------####-----------------###-----####----------------####--------------t-------------------#######---XXXXXXXXXXXXXXXXXXXXXXXXXXX
--------------------@-----------------------g-g---tt-----------------####----#####---------------#####--------------t------------------########------------------------------
--------------------------------------#XXXXXXXXXXXXXXXXXXXXXXXXXXXXXXXt-g-------------------g------tt------k--------t-----g-g----------t-g-g-tt------------------------------
-------------------------------------##XXXXXXXXXXXXXXXXXXXXXXXXXXXXXXXXXXXXXXXXXX---XXXXXXXXXXXXXXXXXXXXXXXXXXXXXXXXXXXXXXXXXXXXXXXXXXXXXXXXXXXXXXXX-------------------------
------------------------------------########--------------------------XXXXXXXXXXX---XXXXXXXXXXXXXXXXXXXXXXXXXXXXXXXXXXXXXXXXXXXXXXXXXXXXXXXXXXXXXXXX-------------------------
---------------#####------------M-----g-g-tt---------------------------------------------------------------------------------------------------------------------------------
-----------#--######---XXXXX---XXXXXXXXXXXXXXXXXX----------------------------------------------------------------------------------------------------------------------------
----------##-#######---XXXXX---XXXXXXXXXXXXXXXXXX----------------------------------------------------------------------------------------------------------------------------
---------###########---------------------------------------------------------------------------------------------------------------------------------------------------------
-M--g------tt-g-g-tt---------------------------------------------------------------------------------------------------------------------------------------------------------
XXXXXXXXXXXXXXXXXXXXXXXXX----------------------------------------------------------------------------------------------------------------------------------------------------
XXXXXXXXXXXXXXXXXXXXXXXXX----------------------------------------------------------------------------------------------------------------------------------------------------
