--------------------------------------------------------------------------------------------------------------------------------------------------------------
--------------------------------------------------------------------------------------------------------------------------------------------------------------
--------------------------------------------------------------------------------------------------------------------------------------------------------------
--------------------------------------------------------------------------------------------------------------------------------------------------------------
--------------------------------------------------------------------------------------------------------------------------------------------------------------
--------------------------------@-----------------------------------------------------------------------------------@-----------------------------------------
------------------------------------------!------------------SS------SS--!------------------------------------------------------------------------------------
----------------------------------------------------------------------------------------#---------------------------------------------------------------------
------------------------------------------------------------g-------g------------------##---------------------------------------------------------------------
---------------------------###---#####------------------------------------------------###-#--------------------#####------------------------------------------
---------#--!-------------####--######--S@S!S-------!-----S@S-----S@S--S@S!S-----SU----!--##------------------######----!--!------------------tt------#--#----
--------##---------------#####-#######----------------------------------------------------###----------------#######--------------------------tt-----##--##---
-------###--------------##############----------------------------------------------------####-----------tt-########--------------------------tt----###--###--
-M--tt------------------t-g-g-tt--t-g---########-----------tt----t-g---########--------k-g------ttM------tt#########---------------g-g--########---####--####-
XXXXXXXXXXXXXXXXXXXXXXXXXXXXXXXXXXXXXXXXXXXXXXXXXXXXXXXXXXXXXXXXXXXXXXXXXXXXXXXXXXXXXXXXXXXXXXXXXXXXXXXXXXXXXXXXXXXXXXXXXXXXXXXXXXXXXXXXXXXXXXXXXXXXXXXt-g----
XXXXXXXXXXXXXXXXXXXXXXXXXXXXXXXXXXXXXXXXXXXXXXXXXXXXXXXXXXXXXXXXXXXXXXXXXXXXXXXXXXXXXXXXXXXXXXXXXXXXXXXXXXXXXXXXXXXXXXXXXXXXXXXXXXXXXXXXXXXXXXXXXXXXXXXXXXXXX-
