-----#####--####--########-------------------------------------
--#####------tt-----g-g-tt-----#####---------------------------
-######-----XXXXXXXXXXXXXXXXXXX#####--S@S!S--------------------
#####----------XXXXXXXXXXXXXXXX#####---------------------------
#####-----------------------########---------------------------
----------g-g----------------------------#####-----------------
XXXXXXXXXXXXXXX-----------tt------------######----!------------
XXXXXXXXXXXXXXX-----------tt---------t-#######-----------------
--------------------------tt---------t########--------------F--
------###########---g------tt--------t########--------------#--
-----####XXXXXXXXXXXXXXXXXXXXXXXXXXXXXXXXXXXXXXXXXXXXXXXXXXXXXX
----#####XXXXXXXXXXXXXXXXXXXXXXXXXXXXXXXXXXXXXXXXXXXXXXXXXXXXXX
---########----------------------------------------------------
-M-t-g----g-g-tt-----------------------------------------------
XXXXXXXXXXXXXXXXXXXXX------------------------------------------
XXXXXXXXXXXXXXXXXXXXX------------------------------------------
