--------------------------------------------------------------------------------------------------------------------------------------------------------------------------
----------------------------------##--#-----------------------------------------------------------------------------------------------------------------------------------
---------------------------------###--##----------------------------------------------------------------------------------------------------------------------------------
--------------------------------####--###----------------tt---------------------------------------------------------------------------------------------------------------
-------------------------------#####--####---------------tt---------------------------------------------------------------------------------------------------------------
--------------------@-------#####------------------------tt------------------------------------------------@----------------------@---------------------------------------
---------------------------######----------------SU----!----------tt----------------!--------------------------!----------------------------!----------tt------SU----!----
--------------------------#######---------------------------------tt-----------------------------------------------------------------------------------tt-----------------
-------------------------########--------tt-----------------------tt----------------------tt-----------------------------------------------------------tt-----------------
------------------------t-g--------------tt#M----------k--------t-tt---------g-g----------tt#-------g------tt----------------gg-########---------g------ttM----------k-gg-
--------------XXXXXXXXXXXXXXXXXXXXX---XXXXXXXXXXXXXXXXXXXXXXXXXXXXXXXXXXXXXXXXXXXXXXXXXXXXXXXXXXXXXXXXXXXXXXXXXXXXXXXXXX---XXXXXXXXXXXXXXXXXXXXXXXXXXXXXXXXXXXXXXXXXXXXXXX
--------------XXXXXXXXXXXXXXXXXXXXX---XXXXXXXXXXXXXXXXXXXXXXXXXXXXXXXXXXXXXXXXXXXXXXXXXXXXXXXXXXXXXXXXXXXXXXXXXXXXXXXXXX---XXXXXXXXXXXXXXXXXXXXXXXXXXXXXXXXXXXXXXXXXXXXXXX
------------########------------------------------------------------------------------------------------------------------------------------------------------------------
-M------g-g---g-g-tt------------------------------------------------------------------------------------------------------------------------------------------------------
XXXXXXXXXXXXXXXXXXXXXXXXX-------------------------------------------------------------------------------------------------------------------------------------------------
XXXXXXXXXXXXXXXXXXXXXXXXX-------------------------------------------------------------------------------------------------------------------------------------------------
