--------------------------------------------------------------------------------------------------------------------------------tt--------------
------------------------------------#------------------------------------------------------------------------------------@------tt--------------
------------------------------------##--------!-----------!------------SS----------------------!-------------------------------!--!--SU----!----
------------------------------------###---------------------------------------------------------------------------------------------------------
------------------------------------####------------------------------g-------------------------------------------------------------------------
----------------------------##--#----#####--------------------------------------------#####-------------------------###t-g-----------------k-gg-
---------------------------###--##--######--S@S!S---!---S@S!S-------S@S--------!-----######--S@S!S--------------t--####XXXXXXXXXXXXXXXXXXXXXXXXX
--------------------------####--##-#######------------------------------------------#######---------------------t-#####XXXXXXXXXXXXXXXXXXXXXXXXX
-------------------------#####--##########----------------------t------------------########---------------------t########-----------------------
----------------------#####----XXXXXXXXXXXXXt-g---------t-g-----tt#-g------tt-----------------------------g------tt-tt-----g-g-tt---------------
----tt---------------######----XXXXXXXXXXXXXXXXXXXXXXXXXXXXXXXXXXXXXXXXXXXXXXXXXXXX------XXXXXXXXXXXXXXXXXXXXXXXXXXXXXXXXXXXXXXXXXXXXX----------
----tt--------------#######-----------------XXXXXXXXXXXXXXXXXXXXXXXXXXXXXXXXXXXXXXX------XXXXXXXXXXXXXXXXXXXXXXXXXXXXXXXXXXXXXXXXXXXXX----------
----tt-------------########---------------------------------------------------------------------------------------------------------------------
-M--tt---------g-g---g-g-tt---------------------------------------------------------------------------------------------------------------------
XXXXXXXXXXXXXXXXXXXXXXXXXXXXXXXX----------------------------------------------------------------------------------------------------------------
XXXXXXXXXXXXXXXXXXXXXXXXXXXXXXXX----------------------------------------------------------------------------------------------------------------
