-------------------------------------------------------------------------------------------------------------------------------------------------------------
-------------------------------------------------------------------------------------------------------------------------------------------------------------
-------------------------------------------------------------------------------------------------------------------------------------------------------------
-----------------------------------------------------------------------------------!-------------------------------------------------------------------------
-------------------------------------------------------------------------------------------------------------------------------------------------------------
-------------------------------------------------------------------------------------------------------------------------------------------------------------
----------------------------------#--------------------------------------------------------------#-----------------------------------------------------------
----------------------------------##--------!------------------------------------S@S!S-------!---##--------!-------------------------------------------------
----------------------------------###------------------------------------------------------------###---------------------------------------------------------
----------------------------------####-----------------------------------------------------------####--------------------------------------------------------
------------#--#----------##--#----#####---------------##--#---------@---------@----#####---------#####---------------##--#----------##--#----------##--#----
-----------##--##--------###--##--######--S@S!S-------###--##----------------------######--S@S!--######--S@S!S-------###--##--------###--##--------###--##---
-----tt---###--###------####--##-#######-------------####--###--------------------#######-------#######-------------####--###------####--###------####--###--
-M---tt#-####--####----#####--##########------------#####--####------------------########------########------------#####--####----#####--####----#####--####-
XXXXXXXXXXXXXXXXXXXXXXXXXXX--XXXXXXXXXXXXX-XXXXXXXXXXXXX--XXXXXXXXXXXXXXXXXXXXXXXXXXXXXXXXX-XXXXXXXXXXXXX-XXXXXXXXXXXXX--XXXXXXXXXXXXX--------#####----------
XXXXXXXXXXXXXXXXXXXXXXXXXXX--XXXXXXXXXXXXX-XXXXXXXXXXXXX--XXXXXXXXXXXXXXXXXXXXXXXXXXXXXXXXX-XXXXXXXXXXXXX-XXXXXXXXXXXXX--XXXXXXXXXXXXX-------######----------
