-----------------------------------------------------------------###--##--------------------------------------------------------------------------------------------
----------------------------------------------------------------####--###-------------t---------------------------t-------------------------------------------t-----
------------------##--#----------------------------------------#####--####------------t---------------------------t--tt----------------------------tt---------t-----
-----------------###--##----------#-------##--#-------------#####----g------tt--------t-gg----------t-g-----------t--tt#M---------g-g---gg---------tt#--------tM----
----------------####--###--------##------###--##--------#--######---XXXXXXXXXXXXXXXXXXXXXXXXXXXX---XXXXXXXXXXXXXXXXXXXXXXXXXXXXXXXXXXXXXXXXXXXXXXXXXXXXXXXXXXXXXXXXX
---------------#####--####------###-----####--###------##-#######---XXXXXXXXXXXXXXXXXXXXXXXXXXXX---XXXXXXXXXXXXXXXXXXXXXXXXXXXXXXXXXXXXXXXXXXXXXXXXXXXXXXXXXXXXXXXXX
------------#####---########---####----#####--####----###########---------------------------------------------------------------------------------------------------
-----------######---XXXXXXXXXXXXX---#####-------########---g-g-tt---------------------------------------------------------------------------------------------------
----------#######---XXXXXXXXXXXXX--######-------XXXXXXXXXXXXXXXXXXXXXX----------------------------------------------------------------------------------------------
---------########-----------------#######-------XXXXXXXXXXXXXXXXXXXXXX----------------------------------------------------------------------------------------------
--------SU----!------------------########--------F------------------------------------------------------------------------------------------------------------------
----------------------------g-g--########--------#------------------------------------------------------------------------------------------------------------------
-----tt--------------F-XXXXXXXXXXXXXXXXXXXXXXXXXXXXX----------------------------------------------------------------------------------------------------------------
-M---tt#------k------#-XXXXXXXXXXXXXXXXXXXXXXXXXXXXX----------------------------------------------------------------------------------------------------------------
XXXXXXXXXXXXXXXXXXXXXXXX--------------------------------------------------------------------------------------------------------------------------------------------
XXXXXXXXXXXXXXXXXXXXXXXX--------------------------------------------------------------------------------------------------------------------------------------------
