-------------------------------------------------------------------------------------------------------------------------------------------------------------------
-------------------------------------------------------------------------------------------------------------------------------------------------------------------
-------------------------------------------------------------------------------------------------------------------------------------------------------------------
-----------------------------------------------------------------------------------------------------------------------------------------------------#-------------
----------------------------------------------------------------------------------------------------------------------tt-----------------------------##------------
----------------------------------------------------------------------------------------------------------------------tt-----------------------------###-----------
-----------------------------@-----------------------------------------------------------------##--#----------##------tt-----------------------------####----------
---------------------------------------!------------------------------------------------------###--##--------#SU----!-----------------------------SU----!----------
---------------------------------------------------------------------------------------------####--###------##---------------t-------------------------------------
--------------------------------------------------------------------------------------------#####--####----###---------------t--tt-------------tt------------------
----------------------#--#----#####---------------##--#----------##--#----------##--#----#####----------tt----------k--------t--tt#-----g-g----tt#------k########--
-----------t---------##--##--######--S@S!S-------###--##--------###--##--------###--##--######---------XXXXXXXXXXXXXXXXXXXXXXXXXXXXXXXXXXXXXXXXXXXXXXXXXXXXXXXXXXXX
-----------t--------###--##-#######-------------####--###------####--###------####--##-#######---------XXXXXXXXXXXXXXXXXXXXXXXXXXXXXXXXXXXXXXXXXXXXXXXXXXXXXXXXXXXX
-M---------tt-g----####--##########------------#####--####----#####--####----#####--##########--------F------------------------------------------------------------
XXXXXXXXXXXXXXXXXXXXXXXXXXXXXXXXXXXXX-XXXXXXXXXXXXX-tXXXXXXXXXXXXX-----########----XXXXXXXXXXXXX------#------------------------------------------------------------
XXXXXXXXXXXXXXXXXXXXXXXXXXXXXXXXXXXXX-XXXXXXXXXXXXX-XXXXXXXXXXXXXX-----XXXXXXXXXX--XXXXXXXXXXXXXXXXXXXXXX----------------------------------------------------------
