----------------------------------------------------------------------------------------------------------------------------------------------------------
---------------------------------------------------------------------------------------------------------------------------@--------------------@---------
--------------------------------------------------------------------------------@-------------------------------------------------------------------------
---------------------------------------tt---------------------S@S!S--------------------------------------------------------------------t------------------
---------------------------------------tt----------------------------------------------------------------------------------------------t------------------
----------@----------------------------tt-----------------------------------------------------------------------------###t-g-----------------SU----!--!---
--------------------------------tt-SU----!-------------------SU----!---------SU----!------------##---------------tt--####XXXXXXXXXXX--------t-------------
--------------------------------tt----------------t--------------------------------------------###---------------tt-#####XXXXXXXXXXX--------t-------------
----------------tt--------------tt----------------t-------------------------------------------####---------------tt########-----------------t------k------
-----###t-g-----tt#------########--------k--------t-gg-------------k---------------k-------g------tt-----g-g--t-g----g-g-tt---------XXXXXXXXXXXXXXXXXXXXXX
----####XXXXXXXXXXXXXXXXXXXXXXXXXXXXXXXXXXXXXXXXXXXXXXXXXXXXXXXXXXXXXXXXX---XXXXXXXXXXXXXXXXXXXXXXXXXXXXXXXXXXXXXXXXXXXXXXXXXXXX----XXXXXXXXXXXXXXXXXXXXXX
---#####XXXXXXXXXXXXXXXXXXXXXXXXXXXXXXXXXXXXXXXXXXXXXXXXXXXXXXXXXXXXXXXXX---XXXXXXXXXXXXXXXXXXXXXXXXXXXXXXXXXXXXXXXXXXXXXXXXXXXX--------------------------
--########------------------------------------------------------------------------------------------------------------------------------------------------
-M--g-g-tt------------------------------------------------------------------------------------------------------------------------------------------------
XXXXXXXXXXXXXXX-------------------------------------------------------------------------------------------------------------------------------------------
XXXXXXXXXXXXXXX-------------------------------------------------------------------------------------------------------------------------------------------
