-------------------------------------------------------------------------------------------------------------------------------------------------------------
---------------------------------------------------------------------!---------------------------------------------------------------------------------------
-------------------------------------------------------------------------------------------------------------------------------------------------------------
-------------------------------------------------------------------------------------------------------------------------------------------------------------
-----------------------------------------------------------##--#-------------------------------@-----------------------#-------------------------------------
-----------------##--#---------@--------------SS----------###--##--S@S!S-------------!-----------------tt---!---SU-----##------------------------------------
----------------###--##----------------------------------####--###-------------------------------------tt--------------###-----------------------------------
---------------####--###---------------------g----------#####--####------------------------------------tt--------------####-------------------------------tt-
--------------#####--####----------------------------#####---t-g---########---------------tt-----g------tt------------k-tt-----g------tt------########----tt#
-----------#####----XXXXXXXXX--!--!--------S@S------######---XXXXXXXXXXXXXXXXXXXXXXXXXXXXXXXXXXXXXXXXXXXXXXXXXXXXXXXXXXXXXXXXXXXXXXXXXXXXXXXXXXXXXXXXXXXXXXXX
----------######----XXXXXXXXX----------------------#######---XXXXXXXXXXXXXXXXXXXXXXXXXXXXXXXXXXXXXXXXXXXXXXXXXXXXXXXXXXXXXXXXXXXXXXXXXXXXXXXXXXXXXXXXXXXXXXXX
---------#######----------------------------------########---------------------------------------------------------------------------------------------------
--------########----------------------gg--g------tt-g-g-tt---------------------------------------------------------------------------------------------------
-M--------g-g-tt---XXXXXXXXXXXXXXXXXXXXXXXXXXXXXXXXXXXXXXXXXXXX----------------------------------------------------------------------------------------------
XXXXXXXXXXXXXXXXX--XXXXXXXXXXXXXXXXXXXXXXXXXXXXXXXXXXXXXXXXXXXX----------------------------------------------------------------------------------------------
XXXXXXXXXXXXXXXXXXXXX----------------------------------------------------------------------------------------------------------------------------------------
