----------------------------------------------------------------------------------------------------------------------------------------------------------------------------------------------
----------------------------------------------------------------------------------------------------------------------------------------------------------------------------------------------
----------------------------------------------------------------------------------------------------------------------------------------------------------------------------------------------
------------------------------SS--------------------------------------------------------------------------------------------------------------------------------------------------------------
----------------------------------------------------------------------------------------------------------------------------------------------------------------------------------------------
-----------------------------g----------------------------------------------------------------------------------------------------------------------------------------------------------------
----------------------------------------------------------------------------------------------------------------------------------------------------------------------------------------g-----
---------------------------S@S-----------------------------------------------------------------------------------tt-------------------------------------------------------------------SSSSSSSS
-----------------------------------------------------------------------------------------------------------------tt---------------------------------------------------------------------------
------------------#####------------------------------------------------------------------------------------------tt------@-----------------------------------------------------------g--------
---SU----!-------######----!--!-------------------------------------!------------------------------------SU--SU----!-----------------#-------##--#----------##--#----------##--#--------------
----------------#######------------------t-------------t------------------------t---------------------------------------------------##------###--##--------###--##--------###--#---S@S--------
------------tt-########------------------t--tt---------t------------------------t--------------------------------------------------###-----####--###------####--###------####--#--------------
-M-------k--tt#-g------tt----------------t--tt#--------t-----g-g----------------t-----g-g--M-----------------------k----g------tt-####----#####--####----#####--####----#####--#--------------
XXXXXXXXXXXXXXXXXXXXXXXXXXXXXXXXXXXXXXXXXXXXXXXXXXXXXXXXXXXXXXXXXXXXXXXXXXXXXXXXXXXXXXXXXXXXXXXXXXXXX---XXXXXXXXXXXXXXXXXXXXXXXXXXXX########----XXXXXXXXXXXXX--XXXXXXXXXXXXX--XXXXXXXXXXXXX---
XXXXXXXXXXXXXXXXXXXXXXXXXXXXXXXXXXXXXXXXXXXXXXXXXXXXXXXXXXXXXXXXXXXXXXXXXXXXXXXXXXXXXXXXXXXXXXXXXXXXX---XXXXXXXXXXXXXXXXXXXXXXXXXXXXXXXXXXXXXX--XXXXXXXXXXXXX--XXXXXXXXXXXXX--XXXXXXXXXXXXX---
