------------------------------------------------------------------------####-----------------------------------
----------------------------------------------###t-g----tt-------------#####-----------------------------------
---------------------------------------------####XXXXXXXXXXXXX--------######------------S@S!S-------!----------
--------------------------------------------#####XXXXXXXXXXXXX-------#######-----------------------------------
-------------------------------------------########--------------tt-########---------tt------------------------
----------------------------------@--------########---g------tt--tt#---tt------------tt#---#####---------------
-------------------------------------------XXXXXXXXXXXXXXXXXXXXXXXXX--XXXXXXXXXXXXXXXXXX--######--S@S!S--------
-------------------------------------------XXXXXXXXXXXXXXXXXXXXXXXXX--XXXXXXXXXXXXXXXXXX-#######---------------
----------------------------------------------------------------------------------------########---------------
-------------------@---------###---#####------------------------------@------------------------------#####-----
----------------------------####--######--S@S!S------------------------------------!--!-------------######-----
---------------------------#####-#######-----------------------------------------------------------#######-----
--------------------------##############----------------------------------------------------------########-----
-M----------M-----g------tt-g-g--g------tt########-------g-g--########------------------------g-g---g-g-tt-----
XXXXXXXX---XXXXXXXXXXXXXXXXXXXXXXXXXXXXXXXXXXXXXXXXXXXXXXXXXXXXXXXXXXXXXXXXXX---XXXXXXXXXXXXXXXXXXXXXXXXXXXXXXX
XXXXXXXX---XXXXXXXXXXXXXXXXXXXXXXXXXXXXXXXXXXXXXXXXXXXXXXXXXXXXXXXXXXXXXXXXXX---XXXXXXXXXXXXXXXXXXXXXXXXXXXXXXX
