----------------------------------------------------------------------------------------------------------------------------SSSSSSSS-
-------------------------------------------------------------------------------------------------------------------------------------
------------------------------------------------------------------##--#----------##----------------------------------------g---------
-----------------------------------------------------------------###--##--------###--------------------------------------------------
----------------------------------------------------------------####--###------------------------------------------------S@S---------
---------------------------------------------------------------#####--####-----------------------------------------------------------
-------------------------------##--#----------##--#---------#####------#####-------#-------------------------------------------------
------------------------------###--##-------------##-------######-----######------##----------#-------#--------------------#####-----
-----------------------------####--###---------t--###-----#######----#######-----###---------##------##-------------------######-----
------------#---------------#####--####--------t--####---########---########----####--------###-----###------------------#######-----
-----------##----#--#----#####-----------------t########---g-g-tt---t-g---########---------####----####---------------tt########-----
----------###---##--##--######---XXXXXXXXXXXXXXXXXXXXXXXXXXXXXXXXXXXXXXXXXXXXXXXXXXXXXXXXXXXX########---gg------------tt#-g-g-tt-----
---------####--###--##-#######---XXXXXXXXXXXXXXXXXXXXXXXXXXXXXXXXXXXXXXXXXXXXXXXXXXXXXXXXXXXXXXXXXXXXXXXXXXXXXXX---XXXXXXXXXXXXXXXXXX
-M--g------tt-####--##########--------F------------------------------------------------------XXXXXXXXXXXXXXXXXXX---XXXXXXXXXXXXXXXXXX
XXXXXXXXXXXXXXXXXXXXXXXXXXXXXXXX------#----------------------------------------------------------------------------------------------
XXXXXXXXXXXXXXXXXXXXXXXXXXXXXXXXXXXXXXXXX--------------------------------------------------------------------------------------------
