--------------------------------------------------------------------------------------------------------g-----------------g------------------------
---------------------------------------------------------------@-----------------S@S--------C-----------------------------------!------------------
------------------------------------------------------------------------------------------------------S@S---------------S@S------------------------
-----------------------------------------tt--------------------------------------------------------------------------------------------------------
-----------------------------------------tt----------------------------------------#####-----------------------------------------------------------
------------------------------@----------tt---------------###--!--!----!----------######--------------!--!-----tt-------!--!--S@S!S------------!---
-----------------SS---------------------!--!-------------####--------------------#####-------------------------tt----------------------------------
--------------------------------------------------------#####----------------tt-######-------------------------tt-------------------------tt-------
----------------g------------------------------------tt######------------------------------g-g---gg----------g------tt---------g------tt--tt#------
-----#-------------------###########----------M------tt#-g-g-XXXXXXXXXXXXX--XXXXXXXXXXXXXXXXXXXXXXXXXXXXXXXXXXXXXXXXXXXXXXXXXXXXXXXXXXXXXXXXXXXXXXX
-----##-------S@S-------####XXXXXXXXXXXXXXXXXXXXXXXXXXXXXXXXXXXXXXXXXXXXXX--XXXXXXXXXXXXXXXXXXXXXXXXXXXXXXXXXXXXXXXXXXXXXXXXXXXXXXXXXXXXXXXXXXXXXXX
-----###---------------#####XXXXXXXXXXXXXXXXXXXXXXXXXXXXXXXXXXXXXXXX-------------------------------------------------------------------------------
-----####-------------########---------------------------------------------------------------------------------------------------------------------
-M-########---g------tt-g-g-tt---------------------------------------------------------------------------------------------------------------------
XXXXXXXXXXXXXXXXXXXXXXXXXXXXXXXXXXX----------------------------------------------------------------------------------------------------------------
XXXXXXXXXXXXXXXXXXXXXXXXXXXXXXXXXXX----------------------------------------------------------------------------------------------------------------
