-------------------------------------------------------------------------------------------------------------------------------------------------------------------------------
-------------------------------------------------------------------------------------------------------------------------------------------------------------------------------
-------------------------------------------------------------@-----------------------------------------------------------------------------------------------------------------
-------------------------------------------------------------------------------------------------------------------------------------------------------------------------------
-------------------------------------------------------------------------------------------------------------------------------------------------------------------------------
----------------------------##--#----------------------------------------------------------------------------------------------------------------------------------------------
---------------------------###--##--------#----tt------------!--!-----------#--#--------------@--------------------------------------------------------------------------------
--------------------------####--###------##----tt--------------------------##--##-----------------------------------------#-------##----------------@--------------------------
-------------------------#####--####----###----tt-------------------------###--###---------------------------------------##------##---------------------!----------------------
----------------------#####-------########--t-g--------------------M-----####--####-------------------------------------###-----###--------t-----------------------------------
-----!--!------------######-------XXXXXXXXXXXXXXXXXXXXX---XXXXXXXXXXXXX--------------------t########--t-g--------g-g---####----####--------t-----------------------------------
--------------------#######-------XXXXXXXXXXXXXXXXXXXXX---XXXXXXXXXXXXX--XXXXXXXXXXXXXXXXXXXXXXXXXXXXXXXXXXXXXXXXXXXXXXXX########----------t-g------tt-----------g-g-----------
-------------tt----########-------F--------------------------------------XXXXXXXXXXXXXXXXXXXXXXXXXXXXXXXXXXXXXXXXXXXXXXXXXXXXXXXXXXXXXXXXXXXXXXXXXXXXXXXXXXXXXXXXXXXXXXXXXX---X
-M-----------tt#M-----tt----------#--------------------------------------------------------------------------------------XXXXXXXXXXXXXXXXXXXXXXXXXXXXXXXXXXXXXXXXXXXXXXXXXX---X
XXXXXXXXXXXXXXXXXXXXXXXXXXXXXXXXXXXXX------------------------------------------------------------------------------------------------------------------------------------------
XXXXXXXXXXXXXXXXXXXXXXXXXXXXXXXXXXXXX------------------------------------------------------------------------------------------------------------------------------------------
