-----------------------------------------------------------------------------------------------------------------------------------------------
------------------------------------------------------------------------------------------------------------------------------g----------------
----------------------------------------------------------------------------------------------------------------------------SSSSSSSS-----------
-----------------------------------------------------------------------------------------------------------------------------------------------
---------------------------------------------------------------------------------------------------------------------------g-------------------
--------------------------@---------@----------------------------------------------------------------------------------------------------------
------------@---------------------------------!-----------------------------------------------------------------!--------S@S-------------------
-----------------------------------------------------------------------------------------------------------------------------------------------
-----------------------------------------------------------------------------------------------------------------------------------------------
---------------------####XXXXXXXXX---#---------------------------------------#---------------------#----------------------#####----------------
-------##------!----#####XXXXXXXXX--##--!---S@S!S---------------tt-----------##--------------!-----##---------S@S!S------######------#--#------
------###----------#######---------###--------------------t-----tt-----------###-------------------###------------------#######-----##--##-----
-----####---------########--------####--------------------t-----tt-----------####------------------####----------------########----###--###----
-M--tt-------------g------tt---------g------t-g-----------t-tt-----gg-M-----g------tt------------t-g-----------t-tt-----g------tt-####--####---
XXXXXXXXXXXXXXXXXXXXXXXXXXXXXXXXXXXXXXXXXXXXXXXXXXXXXXXXXXXXXXXXXXXXXXXXXXXXXXXXXXXXXXXXXXXXXXXXXXXXXXXXXXXXXXXXXXXXXXXXXXXXXXXXXXXXXXX-XXXXXXX
XXXXXXXXXXXXXXXXXXXXXXXXXXXXXXXXXXXXXXXXXXXXXXXXXXXXXXXXXXXXXXXXXXXXXXXXXXXXXXXXXXXXXXXXXXXXXXXXXXXXXXXXXXXXXXXXXXXXXXXXXXXXXXXXXXXXXXX-XXXXXXX
