----------------------------------------------------------------------------------------------------------------------------------------------
----------------------------------------g--------------------------------------------------------------------------------------g--------------
--------------------------------------------------------SS-------------------------------###---#####--------------@---------------------------
--------------------------------------S@S-----------------------------------------------####--######--S@S!S------------------S@S--------------
-------------------------------------------------------g-------------------------------#####-#######------------------------------------------
-------------------------@--------------------------------------------#---------------##############------------------------------------------
-----!-------------------------!---SU----!-----------S@S--------------##-----------tt------!-----------XXXXXXXXX---###--------#####-----------
----------------------------------------------------------------------###----------tt------------------XXXXXXXXX--####-------######-----------
----------------------------------------------------------------------####---------tt-------------F--------------#####------#######-----------
--------------------###t-g---------------k-----g-g---g------tt------########---tt----------k------#-------------######-----########--------F--
---S@S!S-----------####XXXXXXXXXXXXXXXXXXXXXXXXXXXXXXXXXXXXXXXXXXXXXXXXXXXXXXXXXXXXXXXXXXXXXXXXXXXXXX------g-g--t-g---M----########--------#--
------------------#####XXXXXXXXXXXXXXXXXXXXXXXXXXXXXXXXXXXXXXXXXXXXXXXXXXXXXXXXXXXXXXXXXXXXXXXXXXXXXX-XXXXXXXXXXXXXXXXXXXXXXXXXXXXXXXXXXXXXXXX
-----------------########-----------------------------------------------------------------------------XXXXXXXXXXXXXXXXXXXXXXXXXXXXXXXXXXXXXXXX
-M-########--M-----g-g-tt---------------------------------------------------------------------------------------------------------------------
XXXXXXXXXXXXXXXXXXXXXXXXXXXXXX----------------------------------------------------------------------------------------------------------------
XXXXXXXXXXXXXXXXXXXXXXXXXXXXXX----------------------------------------------------------------------------------------------------------------
